DISTRICT CODE,DISTRICT NAME,SCHOOL CODE,SCHOOL NAME,GRADE,AMERICAN INDIAN OR ALASKAN NATIVE,ASIAN OR PACIFIC ISLANDER,BLACK (NOT HISPANIC),HISPANIC,WHITE (NOT HISPANIC),TOTAL,TOTAL Minority,% Minority
0010,MAPLETON 1,0187,MAPLETON EXPEDITIONARY SCHOOL OF THE ARTS,7TH,2,3,2,57,33,97,64,66%
0010,MAPLETON 1,0187,MAPLETON EXPEDITIONARY SCHOOL OF THE ARTS,8TH,3,2,2,52,48,107,59,55%
0010,MAPLETON 1,0187,MAPLETON EXPEDITIONARY SCHOOL OF THE ARTS,9TH,1,6,5,58,38,108,70,65%
0010,MAPLETON 1,0187,MAPLETON EXPEDITIONARY SCHOOL OF THE ARTS,10TH,1,2,5,53,38,99,61,62%
0010,MAPLETON 1,0187,MAPLETON EXPEDITIONARY SCHOOL OF THE ARTS,11TH,2,2,1,42,29,76,47,62%
0010,MAPLETON 1,0187,MAPLETON EXPEDITIONARY SCHOOL OF THE ARTS,12TH,1,2,1,17,13,34,21,62%
0010,MAPLETON 1,0187,MAPLETON EXPEDITIONARY SCHOOL OF THE ARTS,SCHOOL TOTAL,10,17,16,279,199,521,322,62%
0010,MAPLETON 1,0212,MAPLETON EARLY COLLEGE HIGH SCHOOL,9TH,3,0,2,32,16,53,37,70%
0010,MAPLETON 1,0212,MAPLETON EARLY COLLEGE HIGH SCHOOL,10TH,1,1,0,16,22,40,18,45%
0010,MAPLETON 1,0212,MAPLETON EARLY COLLEGE HIGH SCHOOL,11TH,2,2,1,16,14,35,21,60%
0010,MAPLETON 1,0212,MAPLETON EARLY COLLEGE HIGH SCHOOL,12TH,1,1,1,11,6,20,14,70%
0010,MAPLETON 1,0212,MAPLETON EARLY COLLEGE HIGH SCHOOL,SCHOOL TOTAL,7,4,4,75,58,148,90,61%
0010,MAPLETON 1,0221,WELBY NEW TECHNOLOGY,9TH,0,0,0,45,17,62,45,73%
0010,MAPLETON 1,0221,WELBY NEW TECHNOLOGY,10TH,0,1,0,47,18,66,48,73%
0010,MAPLETON 1,0221,WELBY NEW TECHNOLOGY,11TH,1,2,0,30,3,36,33,92%
0010,MAPLETON 1,0221,WELBY NEW TECHNOLOGY,12TH,2,3,1,28,16,50,34,68%
0010,MAPLETON 1,0221,WELBY NEW TECHNOLOGY,SCHOOL TOTAL,3,6,1,150,54,214,160,75%
0010,MAPLETON 1,0263,GLOBAL LEADERSHIP ACADEMY,KINDERGARTEN,0,0,2,15,11,28,17,61%
0010,MAPLETON 1,0263,GLOBAL LEADERSHIP ACADEMY,1ST,0,1,0,20,8,29,21,72%
0010,MAPLETON 1,0263,GLOBAL LEADERSHIP ACADEMY,2ND,1,1,2,23,1,28,27,96%
0010,MAPLETON 1,0263,GLOBAL LEADERSHIP ACADEMY,3RD,1,0,0,21,7,29,22,76%
0010,MAPLETON 1,0263,GLOBAL LEADERSHIP ACADEMY,4TH,0,0,1,24,4,29,25,86%
0010,MAPLETON 1,0263,GLOBAL LEADERSHIP ACADEMY,5TH,0,1,0,21,9,31,22,71%
0010,MAPLETON 1,0263,GLOBAL LEADERSHIP ACADEMY,6TH,0,0,0,22,6,28,22,79%
0010,MAPLETON 1,0263,GLOBAL LEADERSHIP ACADEMY,7TH,0,1,0,42,4,47,43,91%
0010,MAPLETON 1,0263,GLOBAL LEADERSHIP ACADEMY,8TH,1,1,1,37,4,44,40,91%
0010,MAPLETON 1,0263,GLOBAL LEADERSHIP ACADEMY,9TH,0,0,0,34,11,45,34,76%
0010,MAPLETON 1,0263,GLOBAL LEADERSHIP ACADEMY,10TH,0,1,0,25,5,31,26,84%
0010,MAPLETON 1,0263,GLOBAL LEADERSHIP ACADEMY,11TH,0,0,0,26,1,27,26,96%
0010,MAPLETON 1,0263,GLOBAL LEADERSHIP ACADEMY,12TH,1,0,0,15,3,19,16,84%
0010,MAPLETON 1,0263,GLOBAL LEADERSHIP ACADEMY,SCHOOL TOTAL,4,6,6,325,74,415,341,82%
0010,MAPLETON 1,0309,SKYVIEW ACADEMY HIGH SCHOOL,9TH,0,1,4,51,22,78,56,72%
0010,MAPLETON 1,0309,SKYVIEW ACADEMY HIGH SCHOOL,10TH,2,3,2,40,17,64,47,73%
0010,MAPLETON 1,0309,SKYVIEW ACADEMY HIGH SCHOOL,11TH,0,5,1,42,22,70,48,69%
0010,MAPLETON 1,0309,SKYVIEW ACADEMY HIGH SCHOOL,12TH,0,4,3,34,10,51,41,80%
0010,MAPLETON 1,0309,SKYVIEW ACADEMY HIGH SCHOOL,SCHOOL TOTAL,2,13,10,167,71,263,192,73%
0010,MAPLETON 1,0501,MONTEREY COMMUNITY SCHOOL,KINDERGARTEN,0,0,0,38,10,48,38,79%
0010,MAPLETON 1,0501,MONTEREY COMMUNITY SCHOOL,1ST,0,1,1,31,9,42,33,79%
0010,MAPLETON 1,0501,MONTEREY COMMUNITY SCHOOL,2ND,0,0,0,38,5,43,38,88%
0010,MAPLETON 1,0501,MONTEREY COMMUNITY SCHOOL,3RD,0,1,2,34,6,43,37,86%
0010,MAPLETON 1,0501,MONTEREY COMMUNITY SCHOOL,4TH,1,1,0,37,7,46,39,85%
0010,MAPLETON 1,0501,MONTEREY COMMUNITY SCHOOL,5TH,0,0,0,39,13,52,39,75%
0010,MAPLETON 1,0501,MONTEREY COMMUNITY SCHOOL,6TH,1,0,1,30,10,42,32,76%
0010,MAPLETON 1,0501,MONTEREY COMMUNITY SCHOOL,7TH,1,0,0,28,9,38,29,76%
0010,MAPLETON 1,0501,MONTEREY COMMUNITY SCHOOL,8TH,1,0,0,18,9,28,19,68%
0010,MAPLETON 1,0501,MONTEREY COMMUNITY SCHOOL,SCHOOL TOTAL,4,3,4,293,78,382,304,80%
0010,MAPLETON 1,0502,MEADOW COMMUNITY SCHOOL,HALF DAY K,0,4,0,32,23,59,36,61%
0010,MAPLETON 1,0502,MEADOW COMMUNITY SCHOOL,1ST,0,0,0,24,25,49,24,49%
0010,MAPLETON 1,0502,MEADOW COMMUNITY SCHOOL,2ND,0,1,0,36,15,52,37,71%
0010,MAPLETON 1,0502,MEADOW COMMUNITY SCHOOL,3RD,0,4,0,32,14,50,36,72%
0010,MAPLETON 1,0502,MEADOW COMMUNITY SCHOOL,4TH,0,1,1,28,13,43,30,70%
0010,MAPLETON 1,0502,MEADOW COMMUNITY SCHOOL,5TH,0,3,0,19,11,33,22,67%
0010,MAPLETON 1,0502,MEADOW COMMUNITY SCHOOL,6TH,1,3,1,30,13,48,35,73%
0010,MAPLETON 1,0502,MEADOW COMMUNITY SCHOOL,7TH,0,3,0,33,8,44,36,82%
0010,MAPLETON 1,0502,MEADOW COMMUNITY SCHOOL,8TH,1,4,2,24,6,37,31,84%
0010,MAPLETON 1,0502,MEADOW COMMUNITY SCHOOL,SCHOOL TOTAL,2,23,4,258,128,415,287,69%
0010,MAPLETON 1,0503,YORK INTERNATIONAL,KINDERGARTEN,1,1,0,31,21,54,33,61%
0010,MAPLETON 1,0503,YORK INTERNATIONAL,1ST,0,3,1,36,16,56,40,71%
0010,MAPLETON 1,0503,YORK INTERNATIONAL,2ND,0,3,0,39,10,52,42,81%
0010,MAPLETON 1,0503,YORK INTERNATIONAL,3RD,0,3,0,41,12,56,44,79%
0010,MAPLETON 1,0503,YORK INTERNATIONAL,4TH,0,1,4,34,15,54,39,72%
0010,MAPLETON 1,0503,YORK INTERNATIONAL,5TH,0,4,2,40,14,60,46,77%
0010,MAPLETON 1,0503,YORK INTERNATIONAL,6TH,0,2,1,45,14,62,48,77%
0010,MAPLETON 1,0503,YORK INTERNATIONAL,7TH,0,1,1,40,10,52,42,81%
0010,MAPLETON 1,0503,YORK INTERNATIONAL,8TH,1,2,4,34,15,56,41,73%
0010,MAPLETON 1,0503,YORK INTERNATIONAL,9TH,0,1,0,41,9,51,42,82%
0010,MAPLETON 1,0503,YORK INTERNATIONAL,10TH,0,0,0,33,10,43,33,77%
0010,MAPLETON 1,0503,YORK INTERNATIONAL,11TH,0,2,0,35,16,53,37,70%
0010,MAPLETON 1,0503,YORK INTERNATIONAL,12TH,0,0,0,1,8,9,1,11%
0010,MAPLETON 1,0503,YORK INTERNATIONAL,SCHOOL TOTAL,2,23,13,450,170,658,488,74%
0010,MAPLETON 1,0504,HIGHLAND MONTESSORI SCHOOL,PK,1,4,2,25,13,45,32,71%
0010,MAPLETON 1,0504,HIGHLAND MONTESSORI SCHOOL,HALF DAY K,1,2,2,28,16,49,33,67%
0010,MAPLETON 1,0504,HIGHLAND MONTESSORI SCHOOL,1ST,0,3,0,22,15,40,25,63%
0010,MAPLETON 1,0504,HIGHLAND MONTESSORI SCHOOL,2ND,1,2,0,23,11,37,26,70%
0010,MAPLETON 1,0504,HIGHLAND MONTESSORI SCHOOL,3RD,0,1,1,9,12,23,11,48%
0010,MAPLETON 1,0504,HIGHLAND MONTESSORI SCHOOL,4TH,1,0,0,14,8,23,15,65%
0010,MAPLETON 1,0504,HIGHLAND MONTESSORI SCHOOL,5TH,0,1,0,12,9,22,13,59%
0010,MAPLETON 1,0504,HIGHLAND MONTESSORI SCHOOL,SCHOOL TOTAL,4,13,5,133,84,239,155,65%
0010,MAPLETON 1,0505,ACHIEVE ACADEMY,HALF DAY K,0,0,0,15,6,21,15,71%
0010,MAPLETON 1,0505,ACHIEVE ACADEMY,KINDERGARTEN,0,0,0,21,4,25,21,84%
0010,MAPLETON 1,0505,ACHIEVE ACADEMY,1ST,0,0,0,25,26,51,25,49%
0010,MAPLETON 1,0505,ACHIEVE ACADEMY,2ND,0,0,1,37,7,45,38,84%
0010,MAPLETON 1,0505,ACHIEVE ACADEMY,3RD,0,1,1,36,15,53,38,72%
0010,MAPLETON 1,0505,ACHIEVE ACADEMY,4TH,0,3,3,26,9,41,32,78%
0010,MAPLETON 1,0505,ACHIEVE ACADEMY,5TH,2,0,1,43,12,58,46,79%
0010,MAPLETON 1,0505,ACHIEVE ACADEMY,6TH,0,1,0,39,6,46,40,87%
0010,MAPLETON 1,0505,ACHIEVE ACADEMY,7TH,1,2,0,32,11,46,35,76%
0010,MAPLETON 1,0505,ACHIEVE ACADEMY,8TH,1,1,0,40,14,56,42,75%
0010,MAPLETON 1,0505,ACHIEVE ACADEMY,SCHOOL TOTAL,4,8,6,314,110,442,332,75%
0010,MAPLETON 1,0506,EXPLORE ELEMENTARY,HALF DAY K,0,0,0,10,15,25,10,40%
0010,MAPLETON 1,0506,EXPLORE ELEMENTARY,KINDERGARTEN,0,0,0,10,17,27,10,37%
0010,MAPLETON 1,0506,EXPLORE ELEMENTARY,1ST,0,0,1,22,25,48,23,48%
0010,MAPLETON 1,0506,EXPLORE ELEMENTARY,2ND,0,1,0,19,29,49,20,41%
0010,MAPLETON 1,0506,EXPLORE ELEMENTARY,3RD,0,0,1,30,20,51,31,61%
0010,MAPLETON 1,0506,EXPLORE ELEMENTARY,4TH,0,0,0,18,23,41,18,44%
0010,MAPLETON 1,0506,EXPLORE ELEMENTARY,5TH,1,0,0,24,27,52,25,48%
0010,MAPLETON 1,0506,EXPLORE ELEMENTARY,6TH,0,0,0,25,21,46,25,54%
0010,MAPLETON 1,0506,EXPLORE ELEMENTARY,SCHOOL TOTAL,1,1,2,158,177,339,162,48%
0010,MAPLETON 1,0507,ADVENTURE ELEMENTARY,HALF DAY K,0,0,0,16,4,20,16,80%
0010,MAPLETON 1,0507,ADVENTURE ELEMENTARY,KINDERGARTEN,0,0,1,16,8,25,17,68%
0010,MAPLETON 1,0507,ADVENTURE ELEMENTARY,1ST,0,0,1,27,17,45,28,62%
0010,MAPLETON 1,0507,ADVENTURE ELEMENTARY,2ND,0,0,0,31,11,42,31,74%
0010,MAPLETON 1,0507,ADVENTURE ELEMENTARY,3RD,0,0,1,34,8,43,35,81%
0010,MAPLETON 1,0507,ADVENTURE ELEMENTARY,4TH,0,0,1,18,6,25,19,76%
0010,MAPLETON 1,0507,ADVENTURE ELEMENTARY,5TH,0,0,0,35,3,38,35,92%
0010,MAPLETON 1,0507,ADVENTURE ELEMENTARY,6TH,0,0,0,32,9,41,32,78%
0010,MAPLETON 1,0507,ADVENTURE ELEMENTARY,SCHOOL TOTAL,0,0,4,209,66,279,213,76%
0010,MAPLETON 1,0508,ENRICHMENT ACADEMY,HALF DAY K,0,0,0,7,6,13,7,54%
0010,MAPLETON 1,0508,ENRICHMENT ACADEMY,KINDERGARTEN,0,1,0,21,3,25,22,88%
0010,MAPLETON 1,0508,ENRICHMENT ACADEMY,1ST,0,1,0,16,18,35,17,49%
0010,MAPLETON 1,0508,ENRICHMENT ACADEMY,2ND,0,0,0,28,3,31,28,90%
0010,MAPLETON 1,0508,ENRICHMENT ACADEMY,3RD,0,1,0,19,8,28,20,71%
0010,MAPLETON 1,0508,ENRICHMENT ACADEMY,4TH,1,0,0,19,2,22,20,91%
0010,MAPLETON 1,0508,ENRICHMENT ACADEMY,5TH,0,0,0,22,1,23,22,96%
0010,MAPLETON 1,0508,ENRICHMENT ACADEMY,6TH,0,0,0,23,3,26,23,88%
0010,MAPLETON 1,0508,ENRICHMENT ACADEMY,SCHOOL TOTAL,1,3,0,155,44,203,159,78%
0010,MAPLETON 1,0509,CLAYTON PARTNERSHIP SCHOOL,HALF DAY K,0,2,0,26,17,45,28,62%
0010,MAPLETON 1,0509,CLAYTON PARTNERSHIP SCHOOL,1ST,2,2,3,26,22,55,33,60%
0010,MAPLETON 1,0509,CLAYTON PARTNERSHIP SCHOOL,2ND,0,3,2,37,10,52,42,81%
0010,MAPLETON 1,0509,CLAYTON PARTNERSHIP SCHOOL,3RD,1,1,0,32,19,53,34,64%
0010,MAPLETON 1,0509,CLAYTON PARTNERSHIP SCHOOL,4TH,0,2,2,24,6,34,28,82%
0010,MAPLETON 1,0509,CLAYTON PARTNERSHIP SCHOOL,5TH,0,0,0,30,13,43,30,70%
0010,MAPLETON 1,0509,CLAYTON PARTNERSHIP SCHOOL,6TH,2,0,2,30,18,52,34,65%
0010,MAPLETON 1,0509,CLAYTON PARTNERSHIP SCHOOL,7TH,1,0,0,25,18,44,26,59%
0010,MAPLETON 1,0509,CLAYTON PARTNERSHIP SCHOOL,8TH,0,1,0,27,11,39,28,72%
0010,MAPLETON 1,0509,CLAYTON PARTNERSHIP SCHOOL,SCHOOL TOTAL,6,11,9,257,134,417,283,68%
0010,MAPLETON 1,5539,MAPLETON EARLY LEARNING CENTER,PK,2,3,1,95,228,329,101,31%
0010,MAPLETON 1,5539,MAPLETON EARLY LEARNING CENTER,SCHOOL TOTAL,2,3,1,95,228,329,101,31%
0010,MAPLETON 1,6315,NORTH VALLEY SCHOOL FOR YOUNG ADULTS,12TH,0,0,2,35,20,57,37,65%
0010,MAPLETON 1,6315,NORTH VALLEY SCHOOL FOR YOUNG ADULTS,SCHOOL TOTAL,0,0,2,35,20,57,37,65%
0010,MAPLETON 1,9036,VALLEY VIEW K-8,HALF DAY K,1,1,0,24,16,42,26,62%
0010,MAPLETON 1,9036,VALLEY VIEW K-8,1ST,3,1,0,25,20,49,29,59%
0010,MAPLETON 1,9036,VALLEY VIEW K-8,2ND,4,1,0,32,18,55,37,67%
0010,MAPLETON 1,9036,VALLEY VIEW K-8,3RD,2,1,0,24,16,43,27,63%
0010,MAPLETON 1,9036,VALLEY VIEW K-8,4TH,1,3,1,34,16,55,39,71%
0010,MAPLETON 1,9036,VALLEY VIEW K-8,5TH,0,4,1,37,12,54,42,78%
0010,MAPLETON 1,9036,VALLEY VIEW K-8,6TH,1,1,0,34,18,54,36,67%
0010,MAPLETON 1,9036,VALLEY VIEW K-8,7TH,2,4,0,33,15,54,39,72%
0010,MAPLETON 1,9036,VALLEY VIEW K-8,8TH,1,1,0,28,18,48,30,63%
0010,MAPLETON 1,9036,VALLEY VIEW K-8,SCHOOL TOTAL,15,17,2,271,149,454,305,67%
0010,MAPLETON 1,,DISTRICT TOTAL,,67,151,89,3624,1844,5775,3931,68%
0020,ADAMS 12 FIVE STAR SCHOOLS,0014,GLACIER PEAK ELEMENTARY SCHOOL,HALF DAY K,0,7,1,31,56,95,39,41%
0020,ADAMS 12 FIVE STAR SCHOOLS,0014,GLACIER PEAK ELEMENTARY SCHOOL,1ST,0,5,2,25,42,74,32,43%
0020,ADAMS 12 FIVE STAR SCHOOLS,0014,GLACIER PEAK ELEMENTARY SCHOOL,2ND,1,5,2,35,57,100,43,43%
0020,ADAMS 12 FIVE STAR SCHOOLS,0014,GLACIER PEAK ELEMENTARY SCHOOL,3RD,1,7,0,30,58,96,38,40%
0020,ADAMS 12 FIVE STAR SCHOOLS,0014,GLACIER PEAK ELEMENTARY SCHOOL,4TH,1,4,2,35,46,88,42,48%
0020,ADAMS 12 FIVE STAR SCHOOLS,0014,GLACIER PEAK ELEMENTARY SCHOOL,5TH,0,5,1,32,73,111,38,34%
0020,ADAMS 12 FIVE STAR SCHOOLS,0014,GLACIER PEAK ELEMENTARY SCHOOL,SCHOOL TOTAL,3,33,8,188,332,564,232,41%
0020,ADAMS 12 FIVE STAR SCHOOLS,0015,ACADEMY OF CHARTER SCHOOLS,HALF DAY K,0,0,0,7,19,26,7,27%
0020,ADAMS 12 FIVE STAR SCHOOLS,0015,ACADEMY OF CHARTER SCHOOLS,KINDERGARTEN,0,0,0,10,42,52,10,19%
0020,ADAMS 12 FIVE STAR SCHOOLS,0015,ACADEMY OF CHARTER SCHOOLS,1ST,0,7,2,21,57,87,30,34%
0020,ADAMS 12 FIVE STAR SCHOOLS,0015,ACADEMY OF CHARTER SCHOOLS,2ND,0,7,1,22,57,87,30,34%
0020,ADAMS 12 FIVE STAR SCHOOLS,0015,ACADEMY OF CHARTER SCHOOLS,3RD,2,3,0,24,59,88,29,33%
0020,ADAMS 12 FIVE STAR SCHOOLS,0015,ACADEMY OF CHARTER SCHOOLS,4TH,0,4,2,17,64,87,23,26%
0020,ADAMS 12 FIVE STAR SCHOOLS,0015,ACADEMY OF CHARTER SCHOOLS,5TH,1,8,0,23,54,86,32,37%
0020,ADAMS 12 FIVE STAR SCHOOLS,0015,ACADEMY OF CHARTER SCHOOLS,6TH,1,5,3,19,59,87,28,32%
0020,ADAMS 12 FIVE STAR SCHOOLS,0015,ACADEMY OF CHARTER SCHOOLS,7TH,0,8,5,27,73,113,40,35%
0020,ADAMS 12 FIVE STAR SCHOOLS,0015,ACADEMY OF CHARTER SCHOOLS,8TH,0,4,3,32,74,113,39,35%
0020,ADAMS 12 FIVE STAR SCHOOLS,0015,ACADEMY OF CHARTER SCHOOLS,9TH,1,5,6,32,80,124,44,35%
0020,ADAMS 12 FIVE STAR SCHOOLS,0015,ACADEMY OF CHARTER SCHOOLS,10TH,0,7,3,22,65,97,32,33%
0020,ADAMS 12 FIVE STAR SCHOOLS,0015,ACADEMY OF CHARTER SCHOOLS,11TH,0,4,2,17,72,95,23,24%
0020,ADAMS 12 FIVE STAR SCHOOLS,0015,ACADEMY OF CHARTER SCHOOLS,12TH,0,2,3,18,56,79,23,29%
0020,ADAMS 12 FIVE STAR SCHOOLS,0015,ACADEMY OF CHARTER SCHOOLS,SCHOOL TOTAL,5,64,30,291,831,1221,390,32%
0020,ADAMS 12 FIVE STAR SCHOOLS,0057,ROCKY TOP MIDDLE SCHOOL,6TH,1,29,6,45,299,380,81,21%
0020,ADAMS 12 FIVE STAR SCHOOLS,0057,ROCKY TOP MIDDLE SCHOOL,7TH,1,20,6,75,253,355,102,29%
0020,ADAMS 12 FIVE STAR SCHOOLS,0057,ROCKY TOP MIDDLE SCHOOL,8TH,2,21,5,60,274,362,88,24%
0020,ADAMS 12 FIVE STAR SCHOOLS,0057,ROCKY TOP MIDDLE SCHOOL,SCHOOL TOTAL,4,70,17,180,826,1097,271,25%
0020,ADAMS 12 FIVE STAR SCHOOLS,0059,MERIDIAN ELEMENTARY SCHOOL,HALF DAY K,0,2,0,3,43,48,5,10%
0020,ADAMS 12 FIVE STAR SCHOOLS,0059,MERIDIAN ELEMENTARY SCHOOL,KINDERGARTEN,0,4,1,5,38,48,10,21%
0020,ADAMS 12 FIVE STAR SCHOOLS,0059,MERIDIAN ELEMENTARY SCHOOL,1ST,1,11,1,7,78,98,20,20%
0020,ADAMS 12 FIVE STAR SCHOOLS,0059,MERIDIAN ELEMENTARY SCHOOL,2ND,0,6,1,6,102,115,13,11%
0020,ADAMS 12 FIVE STAR SCHOOLS,0059,MERIDIAN ELEMENTARY SCHOOL,3RD,0,8,1,6,94,109,15,14%
0020,ADAMS 12 FIVE STAR SCHOOLS,0059,MERIDIAN ELEMENTARY SCHOOL,4TH,0,9,3,9,88,109,21,19%
0020,ADAMS 12 FIVE STAR SCHOOLS,0059,MERIDIAN ELEMENTARY SCHOOL,5TH,0,5,1,7,100,113,13,12%
0020,ADAMS 12 FIVE STAR SCHOOLS,0059,MERIDIAN ELEMENTARY SCHOOL,SCHOOL TOTAL,1,45,8,43,543,640,97,15%
0020,ADAMS 12 FIVE STAR SCHOOLS,0070,ADAMS12 FIVE STAR PRESCHOOL,PK,4,59,37,243,415,758,343,45%
0020,ADAMS 12 FIVE STAR SCHOOLS,0070,ADAMS12 FIVE STAR PRESCHOOL,SCHOOL TOTAL,4,59,37,243,415,758,343,45%
0020,ADAMS 12 FIVE STAR SCHOOLS,0210,VANTAGE POINT,9TH,0,1,2,11,25,39,14,36%
0020,ADAMS 12 FIVE STAR SCHOOLS,0210,VANTAGE POINT,10TH,0,1,4,34,35,74,39,53%
0020,ADAMS 12 FIVE STAR SCHOOLS,0210,VANTAGE POINT,11TH,0,1,1,40,70,112,42,38%
0020,ADAMS 12 FIVE STAR SCHOOLS,0210,VANTAGE POINT,12TH,2,1,2,32,63,100,37,37%
0020,ADAMS 12 FIVE STAR SCHOOLS,0210,VANTAGE POINT,SCHOOL TOTAL,2,4,9,117,193,325,132,41%
0020,ADAMS 12 FIVE STAR SCHOOLS,0301,ARAPAHOE RIDGE ELEMENTARY SCHOOL,HALF DAY K,0,4,1,18,40,63,23,37%
0020,ADAMS 12 FIVE STAR SCHOOLS,0301,ARAPAHOE RIDGE ELEMENTARY SCHOOL,KINDERGARTEN,0,1,0,6,16,23,7,30%
0020,ADAMS 12 FIVE STAR SCHOOLS,0301,ARAPAHOE RIDGE ELEMENTARY SCHOOL,1ST,0,5,1,16,91,113,22,19%
0020,ADAMS 12 FIVE STAR SCHOOLS,0301,ARAPAHOE RIDGE ELEMENTARY SCHOOL,2ND,2,6,4,15,86,113,27,24%
0020,ADAMS 12 FIVE STAR SCHOOLS,0301,ARAPAHOE RIDGE ELEMENTARY SCHOOL,3RD,1,8,3,19,83,114,31,27%
0020,ADAMS 12 FIVE STAR SCHOOLS,0301,ARAPAHOE RIDGE ELEMENTARY SCHOOL,4TH,0,4,6,21,72,103,31,30%
0020,ADAMS 12 FIVE STAR SCHOOLS,0301,ARAPAHOE RIDGE ELEMENTARY SCHOOL,5TH,1,11,0,25,78,115,37,32%
0020,ADAMS 12 FIVE STAR SCHOOLS,0301,ARAPAHOE RIDGE ELEMENTARY SCHOOL,SCHOOL TOTAL,4,39,15,120,466,644,178,28%
0020,ADAMS 12 FIVE STAR SCHOOLS,1020,BRIGHT HORIZONS PRE-KINDERGARTEN SCHOOL,PK,0,0,0,2,19,21,2,10%
0020,ADAMS 12 FIVE STAR SCHOOLS,1020,BRIGHT HORIZONS PRE-KINDERGARTEN SCHOOL,SCHOOL TOTAL,0,0,0,2,19,21,2,10%
0020,ADAMS 12 FIVE STAR SCHOOLS,1388,CENTENNIAL ELEMENTARY SCHOOL,HALF DAY K,0,2,1,24,26,53,27,51%
0020,ADAMS 12 FIVE STAR SCHOOLS,1388,CENTENNIAL ELEMENTARY SCHOOL,KINDERGARTEN,0,2,0,1,16,19,3,16%
0020,ADAMS 12 FIVE STAR SCHOOLS,1388,CENTENNIAL ELEMENTARY SCHOOL,1ST,0,2,0,37,51,90,39,43%
0020,ADAMS 12 FIVE STAR SCHOOLS,1388,CENTENNIAL ELEMENTARY SCHOOL,2ND,0,4,1,28,47,80,33,41%
0020,ADAMS 12 FIVE STAR SCHOOLS,1388,CENTENNIAL ELEMENTARY SCHOOL,3RD,1,6,2,25,44,78,34,44%
0020,ADAMS 12 FIVE STAR SCHOOLS,1388,CENTENNIAL ELEMENTARY SCHOOL,4TH,0,4,1,28,58,91,33,36%
0020,ADAMS 12 FIVE STAR SCHOOLS,1388,CENTENNIAL ELEMENTARY SCHOOL,5TH,0,2,1,24,59,86,27,31%
0020,ADAMS 12 FIVE STAR SCHOOLS,1388,CENTENNIAL ELEMENTARY SCHOOL,SCHOOL TOTAL,1,22,6,167,301,497,196,39%
0020,ADAMS 12 FIVE STAR SCHOOLS,1480,CENTURY MIDDLE SCHOOL,6TH,0,19,12,74,250,355,105,30%
0020,ADAMS 12 FIVE STAR SCHOOLS,1480,CENTURY MIDDLE SCHOOL,7TH,3,15,10,55,267,350,83,24%
0020,ADAMS 12 FIVE STAR SCHOOLS,1480,CENTURY MIDDLE SCHOOL,8TH,1,21,8,62,256,348,92,26%
0020,ADAMS 12 FIVE STAR SCHOOLS,1480,CENTURY MIDDLE SCHOOL,SCHOOL TOTAL,4,55,30,191,773,1053,280,27%
0020,ADAMS 12 FIVE STAR SCHOOLS,1519,STARGATE CHARTER SCHOOL,HALF DAY K,0,2,0,0,2,4,2,50%
0020,ADAMS 12 FIVE STAR SCHOOLS,1519,STARGATE CHARTER SCHOOL,KINDERGARTEN,0,16,1,1,43,61,18,30%
0020,ADAMS 12 FIVE STAR SCHOOLS,1519,STARGATE CHARTER SCHOOL,1ST,0,17,0,7,50,74,24,32%
0020,ADAMS 12 FIVE STAR SCHOOLS,1519,STARGATE CHARTER SCHOOL,2ND,0,17,1,5,47,70,23,33%
0020,ADAMS 12 FIVE STAR SCHOOLS,1519,STARGATE CHARTER SCHOOL,3RD,0,11,0,8,54,73,19,26%
0020,ADAMS 12 FIVE STAR SCHOOLS,1519,STARGATE CHARTER SCHOOL,4TH,0,9,1,3,58,71,13,18%
0020,ADAMS 12 FIVE STAR SCHOOLS,1519,STARGATE CHARTER SCHOOL,5TH,0,15,2,5,57,79,22,28%
0020,ADAMS 12 FIVE STAR SCHOOLS,1519,STARGATE CHARTER SCHOOL,6TH,0,11,2,7,50,70,20,29%
0020,ADAMS 12 FIVE STAR SCHOOLS,1519,STARGATE CHARTER SCHOOL,7TH,0,11,0,5,55,71,16,23%
0020,ADAMS 12 FIVE STAR SCHOOLS,1519,STARGATE CHARTER SCHOOL,8TH,0,10,2,3,42,57,15,26%
0020,ADAMS 12 FIVE STAR SCHOOLS,1519,STARGATE CHARTER SCHOOL,SCHOOL TOTAL,0,119,9,44,458,630,172,27%
0020,ADAMS 12 FIVE STAR SCHOOLS,1752,COLORADO VIRTUAL ACADEMY (COVA),HALF DAY K,3,10,13,28,272,326,54,17%
0020,ADAMS 12 FIVE STAR SCHOOLS,1752,COLORADO VIRTUAL ACADEMY (COVA),1ST,2,11,12,26,285,336,51,15%
0020,ADAMS 12 FIVE STAR SCHOOLS,1752,COLORADO VIRTUAL ACADEMY (COVA),2ND,3,6,8,37,277,331,54,16%
0020,ADAMS 12 FIVE STAR SCHOOLS,1752,COLORADO VIRTUAL ACADEMY (COVA),3RD,4,9,7,34,305,359,54,15%
0020,ADAMS 12 FIVE STAR SCHOOLS,1752,COLORADO VIRTUAL ACADEMY (COVA),4TH,7,9,15,27,324,382,58,15%
0020,ADAMS 12 FIVE STAR SCHOOLS,1752,COLORADO VIRTUAL ACADEMY (COVA),5TH,7,7,5,34,355,408,53,13%
0020,ADAMS 12 FIVE STAR SCHOOLS,1752,COLORADO VIRTUAL ACADEMY (COVA),6TH,7,4,12,45,359,427,68,16%
0020,ADAMS 12 FIVE STAR SCHOOLS,1752,COLORADO VIRTUAL ACADEMY (COVA),7TH,11,12,14,47,416,500,84,17%
0020,ADAMS 12 FIVE STAR SCHOOLS,1752,COLORADO VIRTUAL ACADEMY (COVA),8TH,11,7,17,63,460,558,98,18%
0020,ADAMS 12 FIVE STAR SCHOOLS,1752,COLORADO VIRTUAL ACADEMY (COVA),9TH,15,6,27,54,323,425,102,24%
0020,ADAMS 12 FIVE STAR SCHOOLS,1752,COLORADO VIRTUAL ACADEMY (COVA),10TH,11,8,16,64,379,478,99,21%
0020,ADAMS 12 FIVE STAR SCHOOLS,1752,COLORADO VIRTUAL ACADEMY (COVA),11TH,4,5,14,35,270,328,58,18%
0020,ADAMS 12 FIVE STAR SCHOOLS,1752,COLORADO VIRTUAL ACADEMY (COVA),12TH,1,2,9,18,118,148,30,20%
0020,ADAMS 12 FIVE STAR SCHOOLS,1752,COLORADO VIRTUAL ACADEMY (COVA),SCHOOL TOTAL,86,96,169,512,4143,5006,863,17%
0020,ADAMS 12 FIVE STAR SCHOOLS,1878,CORONADO HILLS ELEMENTARY SCHOOL,KINDERGARTEN,1,0,1,59,15,76,61,80%
0020,ADAMS 12 FIVE STAR SCHOOLS,1878,CORONADO HILLS ELEMENTARY SCHOOL,1ST,0,0,1,60,12,73,61,84%
0020,ADAMS 12 FIVE STAR SCHOOLS,1878,CORONADO HILLS ELEMENTARY SCHOOL,2ND,0,2,1,70,13,86,73,85%
0020,ADAMS 12 FIVE STAR SCHOOLS,1878,CORONADO HILLS ELEMENTARY SCHOOL,3RD,0,1,4,66,10,81,71,88%
0020,ADAMS 12 FIVE STAR SCHOOLS,1878,CORONADO HILLS ELEMENTARY SCHOOL,4TH,0,1,2,60,14,77,63,82%
0020,ADAMS 12 FIVE STAR SCHOOLS,1878,CORONADO HILLS ELEMENTARY SCHOOL,5TH,0,0,1,60,15,76,61,80%
0020,ADAMS 12 FIVE STAR SCHOOLS,1878,CORONADO HILLS ELEMENTARY SCHOOL,SCHOOL TOTAL,1,4,10,375,79,469,390,83%
0020,ADAMS 12 FIVE STAR SCHOOLS,1914,COTTON CREEK ELEMENTARY SCHOOL,HALF DAY K,0,2,0,14,44,60,16,27%
0020,ADAMS 12 FIVE STAR SCHOOLS,1914,COTTON CREEK ELEMENTARY SCHOOL,KINDERGARTEN,0,1,2,5,40,48,8,17%
0020,ADAMS 12 FIVE STAR SCHOOLS,1914,COTTON CREEK ELEMENTARY SCHOOL,1ST,2,10,1,10,66,89,23,26%
0020,ADAMS 12 FIVE STAR SCHOOLS,1914,COTTON CREEK ELEMENTARY SCHOOL,2ND,0,13,2,18,74,107,33,31%
0020,ADAMS 12 FIVE STAR SCHOOLS,1914,COTTON CREEK ELEMENTARY SCHOOL,3RD,1,14,3,15,74,107,33,31%
0020,ADAMS 12 FIVE STAR SCHOOLS,1914,COTTON CREEK ELEMENTARY SCHOOL,4TH,2,10,1,15,86,114,28,25%
0020,ADAMS 12 FIVE STAR SCHOOLS,1914,COTTON CREEK ELEMENTARY SCHOOL,5TH,2,10,1,13,69,95,26,27%
0020,ADAMS 12 FIVE STAR SCHOOLS,1914,COTTON CREEK ELEMENTARY SCHOOL,SCHOOL TOTAL,7,60,10,90,453,620,167,27%
0020,ADAMS 12 FIVE STAR SCHOOLS,1937,COYOTE RIDGE ELEMENTARY SCHOOL,HALF DAY K,0,6,1,8,79,94,15,16%
0020,ADAMS 12 FIVE STAR SCHOOLS,1937,COYOTE RIDGE ELEMENTARY SCHOOL,1ST,1,12,0,3,86,102,16,16%
0020,ADAMS 12 FIVE STAR SCHOOLS,1937,COYOTE RIDGE ELEMENTARY SCHOOL,2ND,0,16,0,10,75,101,26,26%
0020,ADAMS 12 FIVE STAR SCHOOLS,1937,COYOTE RIDGE ELEMENTARY SCHOOL,3RD,0,9,0,2,86,97,11,11%
0020,ADAMS 12 FIVE STAR SCHOOLS,1937,COYOTE RIDGE ELEMENTARY SCHOOL,4TH,0,11,0,6,66,83,17,20%
0020,ADAMS 12 FIVE STAR SCHOOLS,1937,COYOTE RIDGE ELEMENTARY SCHOOL,5TH,0,11,1,7,63,82,19,23%
0020,ADAMS 12 FIVE STAR SCHOOLS,1937,COYOTE RIDGE ELEMENTARY SCHOOL,SCHOOL TOTAL,1,65,2,36,455,559,104,19%
0020,ADAMS 12 FIVE STAR SCHOOLS,2031,CROSSROAD ALTERNATIVE SCHOOL,3RD,0,0,0,0,1,1,0,0%
0020,ADAMS 12 FIVE STAR SCHOOLS,2031,CROSSROAD ALTERNATIVE SCHOOL,4TH,0,0,1,1,2,4,2,50%
0020,ADAMS 12 FIVE STAR SCHOOLS,2031,CROSSROAD ALTERNATIVE SCHOOL,5TH,0,0,0,0,3,3,0,0%
0020,ADAMS 12 FIVE STAR SCHOOLS,2031,CROSSROAD ALTERNATIVE SCHOOL,6TH,0,0,1,5,5,11,6,55%
0020,ADAMS 12 FIVE STAR SCHOOLS,2031,CROSSROAD ALTERNATIVE SCHOOL,7TH,2,0,1,1,9,13,4,31%
0020,ADAMS 12 FIVE STAR SCHOOLS,2031,CROSSROAD ALTERNATIVE SCHOOL,8TH,1,1,2,13,23,40,17,43%
0020,ADAMS 12 FIVE STAR SCHOOLS,2031,CROSSROAD ALTERNATIVE SCHOOL,SCHOOL TOTAL,3,1,5,20,43,72,29,40%
0020,ADAMS 12 FIVE STAR SCHOOLS,2361,EAGLEVIEW ELEMENTARY SCHOOL,HALF DAY K,0,3,1,11,31,46,15,33%
0020,ADAMS 12 FIVE STAR SCHOOLS,2361,EAGLEVIEW ELEMENTARY SCHOOL,KINDERGARTEN,1,1,0,6,34,42,8,19%
0020,ADAMS 12 FIVE STAR SCHOOLS,2361,EAGLEVIEW ELEMENTARY SCHOOL,1ST,1,5,3,18,68,95,27,28%
0020,ADAMS 12 FIVE STAR SCHOOLS,2361,EAGLEVIEW ELEMENTARY SCHOOL,2ND,0,6,3,27,68,104,36,35%
0020,ADAMS 12 FIVE STAR SCHOOLS,2361,EAGLEVIEW ELEMENTARY SCHOOL,3RD,1,1,4,16,74,96,22,23%
0020,ADAMS 12 FIVE STAR SCHOOLS,2361,EAGLEVIEW ELEMENTARY SCHOOL,4TH,3,4,3,28,66,104,38,37%
0020,ADAMS 12 FIVE STAR SCHOOLS,2361,EAGLEVIEW ELEMENTARY SCHOOL,5TH,1,5,4,19,91,120,29,24%
0020,ADAMS 12 FIVE STAR SCHOOLS,2361,EAGLEVIEW ELEMENTARY SCHOOL,SCHOOL TOTAL,7,25,18,125,432,607,175,29%
0020,ADAMS 12 FIVE STAR SCHOOLS,2410,TARVER ELEMENTARY SCHOOL,HALF DAY K,1,7,1,8,24,41,17,41%
0020,ADAMS 12 FIVE STAR SCHOOLS,2410,TARVER ELEMENTARY SCHOOL,KINDERGARTEN,0,2,1,0,21,24,3,13%
0020,ADAMS 12 FIVE STAR SCHOOLS,2410,TARVER ELEMENTARY SCHOOL,1ST,0,1,2,17,54,74,20,27%
0020,ADAMS 12 FIVE STAR SCHOOLS,2410,TARVER ELEMENTARY SCHOOL,2ND,0,2,2,13,72,89,17,19%
0020,ADAMS 12 FIVE STAR SCHOOLS,2410,TARVER ELEMENTARY SCHOOL,3RD,0,4,0,12,69,85,16,19%
0020,ADAMS 12 FIVE STAR SCHOOLS,2410,TARVER ELEMENTARY SCHOOL,4TH,0,4,3,9,76,92,16,17%
0020,ADAMS 12 FIVE STAR SCHOOLS,2410,TARVER ELEMENTARY SCHOOL,5TH,1,5,0,16,80,102,22,22%
0020,ADAMS 12 FIVE STAR SCHOOLS,2410,TARVER ELEMENTARY SCHOOL,SCHOOL TOTAL,2,25,9,75,396,507,111,22%
0020,ADAMS 12 FIVE STAR SCHOOLS,2576,CHERRY DRIVE ELEMENTARY SCHOOL,HALF DAY K,0,5,1,15,33,54,21,39%
0020,ADAMS 12 FIVE STAR SCHOOLS,2576,CHERRY DRIVE ELEMENTARY SCHOOL,KINDERGARTEN,0,0,2,6,17,25,8,32%
0020,ADAMS 12 FIVE STAR SCHOOLS,2576,CHERRY DRIVE ELEMENTARY SCHOOL,1ST,1,1,3,31,56,92,36,39%
0020,ADAMS 12 FIVE STAR SCHOOLS,2576,CHERRY DRIVE ELEMENTARY SCHOOL,2ND,2,3,3,23,63,94,31,33%
0020,ADAMS 12 FIVE STAR SCHOOLS,2576,CHERRY DRIVE ELEMENTARY SCHOOL,3RD,1,3,2,35,38,79,41,52%
0020,ADAMS 12 FIVE STAR SCHOOLS,2576,CHERRY DRIVE ELEMENTARY SCHOOL,4TH,1,7,5,31,57,101,44,44%
0020,ADAMS 12 FIVE STAR SCHOOLS,2576,CHERRY DRIVE ELEMENTARY SCHOOL,5TH,1,6,4,38,52,101,49,49%
0020,ADAMS 12 FIVE STAR SCHOOLS,2576,CHERRY DRIVE ELEMENTARY SCHOOL,SCHOOL TOTAL,6,25,20,179,316,546,230,42%
0020,ADAMS 12 FIVE STAR SCHOOLS,2578,SKYVIEW ELEMENTARY SCHOOL,HALF DAY K,0,4,4,18,52,78,26,33%
0020,ADAMS 12 FIVE STAR SCHOOLS,2578,SKYVIEW ELEMENTARY SCHOOL,1ST,0,4,0,29,55,88,33,38%
0020,ADAMS 12 FIVE STAR SCHOOLS,2578,SKYVIEW ELEMENTARY SCHOOL,2ND,0,4,4,24,57,89,32,36%
0020,ADAMS 12 FIVE STAR SCHOOLS,2578,SKYVIEW ELEMENTARY SCHOOL,3RD,0,2,3,28,54,87,33,38%
0020,ADAMS 12 FIVE STAR SCHOOLS,2578,SKYVIEW ELEMENTARY SCHOOL,4TH,0,0,4,23,69,96,27,28%
0020,ADAMS 12 FIVE STAR SCHOOLS,2578,SKYVIEW ELEMENTARY SCHOOL,5TH,1,6,1,29,44,81,37,46%
0020,ADAMS 12 FIVE STAR SCHOOLS,2578,SKYVIEW ELEMENTARY SCHOOL,SCHOOL TOTAL,1,20,16,151,331,519,188,36%
0020,ADAMS 12 FIVE STAR SCHOOLS,2580,HUNTERS GLEN ELEMENTARY SCHOOL,HALF DAY K,1,2,0,14,25,42,17,40%
0020,ADAMS 12 FIVE STAR SCHOOLS,2580,HUNTERS GLEN ELEMENTARY SCHOOL,KINDERGARTEN,1,1,0,5,40,47,7,15%
0020,ADAMS 12 FIVE STAR SCHOOLS,2580,HUNTERS GLEN ELEMENTARY SCHOOL,1ST,1,9,3,22,89,124,35,28%
0020,ADAMS 12 FIVE STAR SCHOOLS,2580,HUNTERS GLEN ELEMENTARY SCHOOL,2ND,3,8,9,24,89,133,44,33%
0020,ADAMS 12 FIVE STAR SCHOOLS,2580,HUNTERS GLEN ELEMENTARY SCHOOL,3RD,1,10,6,10,100,127,27,21%
0020,ADAMS 12 FIVE STAR SCHOOLS,2580,HUNTERS GLEN ELEMENTARY SCHOOL,4TH,1,8,4,15,81,109,28,26%
0020,ADAMS 12 FIVE STAR SCHOOLS,2580,HUNTERS GLEN ELEMENTARY SCHOOL,5TH,2,9,4,13,102,130,28,22%
0020,ADAMS 12 FIVE STAR SCHOOLS,2580,HUNTERS GLEN ELEMENTARY SCHOOL,SCHOOL TOTAL,10,47,26,103,526,712,186,26%
0020,ADAMS 12 FIVE STAR SCHOOLS,2582,ROCKY MOUNTAIN ELEMENTARY SCHOOL,HALF DAY K,0,3,1,23,14,41,27,66%
0020,ADAMS 12 FIVE STAR SCHOOLS,2582,ROCKY MOUNTAIN ELEMENTARY SCHOOL,KINDERGARTEN,0,1,0,26,5,32,27,84%
0020,ADAMS 12 FIVE STAR SCHOOLS,2582,ROCKY MOUNTAIN ELEMENTARY SCHOOL,1ST,2,5,2,43,25,77,52,68%
0020,ADAMS 12 FIVE STAR SCHOOLS,2582,ROCKY MOUNTAIN ELEMENTARY SCHOOL,2ND,2,2,3,43,25,75,50,67%
0020,ADAMS 12 FIVE STAR SCHOOLS,2582,ROCKY MOUNTAIN ELEMENTARY SCHOOL,3RD,2,2,1,50,46,101,55,54%
0020,ADAMS 12 FIVE STAR SCHOOLS,2582,ROCKY MOUNTAIN ELEMENTARY SCHOOL,4TH,1,2,1,40,30,74,44,59%
0020,ADAMS 12 FIVE STAR SCHOOLS,2582,ROCKY MOUNTAIN ELEMENTARY SCHOOL,5TH,1,1,2,43,31,78,47,60%
0020,ADAMS 12 FIVE STAR SCHOOLS,2582,ROCKY MOUNTAIN ELEMENTARY SCHOOL,SCHOOL TOTAL,8,16,10,268,176,478,302,63%
0020,ADAMS 12 FIVE STAR SCHOOLS,2584,RIVERDALE ELEMENTARY SCHOOL,HALF DAY K,1,4,3,23,37,68,31,46%
0020,ADAMS 12 FIVE STAR SCHOOLS,2584,RIVERDALE ELEMENTARY SCHOOL,1ST,0,4,0,13,51,68,17,25%
0020,ADAMS 12 FIVE STAR SCHOOLS,2584,RIVERDALE ELEMENTARY SCHOOL,2ND,0,6,1,23,58,88,30,34%
0020,ADAMS 12 FIVE STAR SCHOOLS,2584,RIVERDALE ELEMENTARY SCHOOL,3RD,0,5,4,22,40,71,31,44%
0020,ADAMS 12 FIVE STAR SCHOOLS,2584,RIVERDALE ELEMENTARY SCHOOL,4TH,0,4,1,22,37,64,27,42%
0020,ADAMS 12 FIVE STAR SCHOOLS,2584,RIVERDALE ELEMENTARY SCHOOL,5TH,0,5,1,26,30,62,32,52%
0020,ADAMS 12 FIVE STAR SCHOOLS,2584,RIVERDALE ELEMENTARY SCHOOL,SCHOOL TOTAL,1,28,10,129,253,421,168,40%
0020,ADAMS 12 FIVE STAR SCHOOLS,2918,FEDERAL HEIGHTS ELEMENTARY SCHOOL,HALF DAY K,0,0,0,2,0,2,2,100%
0020,ADAMS 12 FIVE STAR SCHOOLS,2918,FEDERAL HEIGHTS ELEMENTARY SCHOOL,KINDERGARTEN,2,0,0,100,20,122,102,84%
0020,ADAMS 12 FIVE STAR SCHOOLS,2918,FEDERAL HEIGHTS ELEMENTARY SCHOOL,1ST,0,1,0,99,23,123,100,81%
0020,ADAMS 12 FIVE STAR SCHOOLS,2918,FEDERAL HEIGHTS ELEMENTARY SCHOOL,2ND,0,1,0,103,17,121,104,86%
0020,ADAMS 12 FIVE STAR SCHOOLS,2918,FEDERAL HEIGHTS ELEMENTARY SCHOOL,3RD,0,1,0,98,27,126,99,79%
0020,ADAMS 12 FIVE STAR SCHOOLS,2918,FEDERAL HEIGHTS ELEMENTARY SCHOOL,4TH,0,1,1,96,15,113,98,87%
0020,ADAMS 12 FIVE STAR SCHOOLS,2918,FEDERAL HEIGHTS ELEMENTARY SCHOOL,5TH,1,0,2,79,24,106,82,77%
0020,ADAMS 12 FIVE STAR SCHOOLS,2918,FEDERAL HEIGHTS ELEMENTARY SCHOOL,SCHOOL TOTAL,3,4,3,577,126,713,587,82%
0020,ADAMS 12 FIVE STAR SCHOOLS,4000,HILLCREST ELEMENTARY SCHOOL,HALF DAY K,0,11,2,32,26,71,45,63%
0020,ADAMS 12 FIVE STAR SCHOOLS,4000,HILLCREST ELEMENTARY SCHOOL,1ST,0,9,3,48,26,86,60,70%
0020,ADAMS 12 FIVE STAR SCHOOLS,4000,HILLCREST ELEMENTARY SCHOOL,2ND,1,11,2,41,33,88,55,63%
0020,ADAMS 12 FIVE STAR SCHOOLS,4000,HILLCREST ELEMENTARY SCHOOL,3RD,1,3,0,43,25,72,47,65%
0020,ADAMS 12 FIVE STAR SCHOOLS,4000,HILLCREST ELEMENTARY SCHOOL,4TH,0,4,5,41,21,71,50,70%
0020,ADAMS 12 FIVE STAR SCHOOLS,4000,HILLCREST ELEMENTARY SCHOOL,5TH,0,3,5,36,25,69,44,64%
0020,ADAMS 12 FIVE STAR SCHOOLS,4000,HILLCREST ELEMENTARY SCHOOL,SCHOOL TOTAL,2,41,17,241,156,457,301,66%
0020,ADAMS 12 FIVE STAR SCHOOLS,4108,HORIZON HIGH SCHOOL,9TH,5,24,10,116,359,514,155,30%
0020,ADAMS 12 FIVE STAR SCHOOLS,4108,HORIZON HIGH SCHOOL,10TH,8,22,10,107,316,463,147,32%
0020,ADAMS 12 FIVE STAR SCHOOLS,4108,HORIZON HIGH SCHOOL,11TH,9,18,11,103,294,435,141,32%
0020,ADAMS 12 FIVE STAR SCHOOLS,4108,HORIZON HIGH SCHOOL,12TH,2,24,12,107,324,469,145,31%
0020,ADAMS 12 FIVE STAR SCHOOLS,4108,HORIZON HIGH SCHOOL,SCHOOL TOTAL,24,88,43,433,1293,1881,588,31%
0020,ADAMS 12 FIVE STAR SCHOOLS,4172,HULSTROM OPTIONS K-8 SCHOOL,HALF DAY K,0,13,1,4,30,48,18,38%
0020,ADAMS 12 FIVE STAR SCHOOLS,4172,HULSTROM OPTIONS K-8 SCHOOL,KINDERGARTEN,0,13,1,3,33,50,17,34%
0020,ADAMS 12 FIVE STAR SCHOOLS,4172,HULSTROM OPTIONS K-8 SCHOOL,1ST,0,15,1,7,77,100,23,23%
0020,ADAMS 12 FIVE STAR SCHOOLS,4172,HULSTROM OPTIONS K-8 SCHOOL,2ND,0,18,1,7,74,100,26,26%
0020,ADAMS 12 FIVE STAR SCHOOLS,4172,HULSTROM OPTIONS K-8 SCHOOL,3RD,1,12,3,8,51,75,24,32%
0020,ADAMS 12 FIVE STAR SCHOOLS,4172,HULSTROM OPTIONS K-8 SCHOOL,4TH,1,8,0,8,59,76,17,22%
0020,ADAMS 12 FIVE STAR SCHOOLS,4172,HULSTROM OPTIONS K-8 SCHOOL,5TH,1,8,1,10,55,75,20,27%
0020,ADAMS 12 FIVE STAR SCHOOLS,4172,HULSTROM OPTIONS K-8 SCHOOL,6TH,2,13,1,11,45,72,27,38%
0020,ADAMS 12 FIVE STAR SCHOOLS,4172,HULSTROM OPTIONS K-8 SCHOOL,7TH,3,7,1,7,49,67,18,27%
0020,ADAMS 12 FIVE STAR SCHOOLS,4172,HULSTROM OPTIONS K-8 SCHOOL,8TH,1,6,0,9,38,54,16,30%
0020,ADAMS 12 FIVE STAR SCHOOLS,4172,HULSTROM OPTIONS K-8 SCHOOL,SCHOOL TOTAL,9,113,10,74,511,717,206,29%
0020,ADAMS 12 FIVE STAR SCHOOLS,4187,SILVER HILLS MIDDLE SCHOOL,6TH,3,21,10,112,220,366,146,40%
0020,ADAMS 12 FIVE STAR SCHOOLS,4187,SILVER HILLS MIDDLE SCHOOL,7TH,1,29,9,105,190,334,144,43%
0020,ADAMS 12 FIVE STAR SCHOOLS,4187,SILVER HILLS MIDDLE SCHOOL,8TH,4,23,13,88,222,350,128,37%
0020,ADAMS 12 FIVE STAR SCHOOLS,4187,SILVER HILLS MIDDLE SCHOOL,SCHOOL TOTAL,8,73,32,305,632,1050,418,40%
0020,ADAMS 12 FIVE STAR SCHOOLS,5043,LEGACY HIGH SCHOOL,9TH,3,52,5,77,424,561,137,24%
0020,ADAMS 12 FIVE STAR SCHOOLS,5043,LEGACY HIGH SCHOOL,10TH,3,40,9,80,384,516,132,26%
0020,ADAMS 12 FIVE STAR SCHOOLS,5043,LEGACY HIGH SCHOOL,11TH,2,36,11,68,346,463,117,25%
0020,ADAMS 12 FIVE STAR SCHOOLS,5043,LEGACY HIGH SCHOOL,12TH,0,43,10,58,329,440,111,25%
0020,ADAMS 12 FIVE STAR SCHOOLS,5043,LEGACY HIGH SCHOOL,SCHOOL TOTAL,8,171,35,283,1483,1980,497,25%
0020,ADAMS 12 FIVE STAR SCHOOLS,5058,LEROY DRIVE ELEMENTARY SCHOOL,HALF DAY K,0,0,0,1,0,1,1,100%
0020,ADAMS 12 FIVE STAR SCHOOLS,5058,LEROY DRIVE ELEMENTARY SCHOOL,KINDERGARTEN,0,2,3,27,20,52,32,62%
0020,ADAMS 12 FIVE STAR SCHOOLS,5058,LEROY DRIVE ELEMENTARY SCHOOL,1ST,0,1,1,27,31,60,29,48%
0020,ADAMS 12 FIVE STAR SCHOOLS,5058,LEROY DRIVE ELEMENTARY SCHOOL,2ND,1,5,2,32,30,70,40,57%
0020,ADAMS 12 FIVE STAR SCHOOLS,5058,LEROY DRIVE ELEMENTARY SCHOOL,3RD,0,1,5,29,29,64,35,55%
0020,ADAMS 12 FIVE STAR SCHOOLS,5058,LEROY DRIVE ELEMENTARY SCHOOL,4TH,3,2,2,31,33,71,38,54%
0020,ADAMS 12 FIVE STAR SCHOOLS,5058,LEROY DRIVE ELEMENTARY SCHOOL,5TH,2,1,1,31,32,67,35,52%
0020,ADAMS 12 FIVE STAR SCHOOLS,5058,LEROY DRIVE ELEMENTARY SCHOOL,SCHOOL TOTAL,6,12,14,178,175,385,210,55%
0020,ADAMS 12 FIVE STAR SCHOOLS,5418,MALLEY DRIVE ELEMENTARY SCHOOL,HALF DAY K,2,3,0,43,34,82,48,59%
0020,ADAMS 12 FIVE STAR SCHOOLS,5418,MALLEY DRIVE ELEMENTARY SCHOOL,1ST,1,1,5,29,36,72,36,50%
0020,ADAMS 12 FIVE STAR SCHOOLS,5418,MALLEY DRIVE ELEMENTARY SCHOOL,2ND,0,4,0,46,30,80,50,63%
0020,ADAMS 12 FIVE STAR SCHOOLS,5418,MALLEY DRIVE ELEMENTARY SCHOOL,3RD,1,2,2,36,41,82,41,50%
0020,ADAMS 12 FIVE STAR SCHOOLS,5418,MALLEY DRIVE ELEMENTARY SCHOOL,4TH,0,5,2,32,34,73,39,53%
0020,ADAMS 12 FIVE STAR SCHOOLS,5418,MALLEY DRIVE ELEMENTARY SCHOOL,5TH,0,1,3,28,44,76,32,42%
0020,ADAMS 12 FIVE STAR SCHOOLS,5418,MALLEY DRIVE ELEMENTARY SCHOOL,SCHOOL TOTAL,4,16,12,214,219,465,246,53%
0020,ADAMS 12 FIVE STAR SCHOOLS,5706,MC ELWAIN ELEMENTARY SCHOOL,KINDERGARTEN,1,0,3,71,7,82,75,91%
0020,ADAMS 12 FIVE STAR SCHOOLS,5706,MC ELWAIN ELEMENTARY SCHOOL,1ST,2,1,5,71,11,90,79,88%
0020,ADAMS 12 FIVE STAR SCHOOLS,5706,MC ELWAIN ELEMENTARY SCHOOL,2ND,0,1,7,82,14,104,90,87%
0020,ADAMS 12 FIVE STAR SCHOOLS,5706,MC ELWAIN ELEMENTARY SCHOOL,3RD,0,1,1,64,3,69,66,96%
0020,ADAMS 12 FIVE STAR SCHOOLS,5706,MC ELWAIN ELEMENTARY SCHOOL,4TH,1,0,5,65,5,76,71,93%
0020,ADAMS 12 FIVE STAR SCHOOLS,5706,MC ELWAIN ELEMENTARY SCHOOL,5TH,0,0,3,52,14,69,55,80%
0020,ADAMS 12 FIVE STAR SCHOOLS,5706,MC ELWAIN ELEMENTARY SCHOOL,SCHOOL TOTAL,4,3,24,405,54,490,436,89%
0020,ADAMS 12 FIVE STAR SCHOOLS,5814,THORNTON MIDDLE SCHOOL,6TH,0,4,8,158,40,210,170,81%
0020,ADAMS 12 FIVE STAR SCHOOLS,5814,THORNTON MIDDLE SCHOOL,7TH,0,9,5,159,40,213,173,81%
0020,ADAMS 12 FIVE STAR SCHOOLS,5814,THORNTON MIDDLE SCHOOL,8TH,2,15,8,174,57,256,199,78%
0020,ADAMS 12 FIVE STAR SCHOOLS,5814,THORNTON MIDDLE SCHOOL,SCHOOL TOTAL,2,28,21,491,137,679,542,80%
0020,ADAMS 12 FIVE STAR SCHOOLS,5816,THORNTON HIGH SCHOOL,9TH,3,33,19,319,146,520,374,72%
0020,ADAMS 12 FIVE STAR SCHOOLS,5816,THORNTON HIGH SCHOOL,10TH,2,34,15,276,142,469,327,70%
0020,ADAMS 12 FIVE STAR SCHOOLS,5816,THORNTON HIGH SCHOOL,11TH,4,32,11,211,138,396,258,65%
0020,ADAMS 12 FIVE STAR SCHOOLS,5816,THORNTON HIGH SCHOOL,12TH,0,26,16,174,134,350,216,62%
0020,ADAMS 12 FIVE STAR SCHOOLS,5816,THORNTON HIGH SCHOOL,SCHOOL TOTAL,9,125,61,980,560,1735,1175,68%
0020,ADAMS 12 FIVE STAR SCHOOLS,6060,MOUNTAIN RANGE HIGH SCHOOL,9TH,7,21,15,144,336,523,187,36%
0020,ADAMS 12 FIVE STAR SCHOOLS,6060,MOUNTAIN RANGE HIGH SCHOOL,10TH,6,22,15,134,342,519,177,34%
0020,ADAMS 12 FIVE STAR SCHOOLS,6060,MOUNTAIN RANGE HIGH SCHOOL,11TH,14,24,16,121,356,531,175,33%
0020,ADAMS 12 FIVE STAR SCHOOLS,6060,MOUNTAIN RANGE HIGH SCHOOL,12TH,6,29,8,83,349,475,126,27%
0020,ADAMS 12 FIVE STAR SCHOOLS,6060,MOUNTAIN RANGE HIGH SCHOOL,SCHOOL TOTAL,33,96,54,482,1383,2048,665,32%
0020,ADAMS 12 FIVE STAR SCHOOLS,6150,MOUNTAIN VIEW ELEMENTARY SCHOOL,HALF DAY K,0,7,2,9,38,56,18,32%
0020,ADAMS 12 FIVE STAR SCHOOLS,6150,MOUNTAIN VIEW ELEMENTARY SCHOOL,KINDERGARTEN,1,1,1,7,42,52,10,19%
0020,ADAMS 12 FIVE STAR SCHOOLS,6150,MOUNTAIN VIEW ELEMENTARY SCHOOL,1ST,1,13,1,12,85,112,27,24%
0020,ADAMS 12 FIVE STAR SCHOOLS,6150,MOUNTAIN VIEW ELEMENTARY SCHOOL,2ND,1,10,4,16,80,111,31,28%
0020,ADAMS 12 FIVE STAR SCHOOLS,6150,MOUNTAIN VIEW ELEMENTARY SCHOOL,3RD,2,11,4,14,71,102,31,30%
0020,ADAMS 12 FIVE STAR SCHOOLS,6150,MOUNTAIN VIEW ELEMENTARY SCHOOL,4TH,1,11,6,13,75,106,31,29%
0020,ADAMS 12 FIVE STAR SCHOOLS,6150,MOUNTAIN VIEW ELEMENTARY SCHOOL,5TH,0,3,4,19,69,95,26,27%
0020,ADAMS 12 FIVE STAR SCHOOLS,6150,MOUNTAIN VIEW ELEMENTARY SCHOOL,SCHOOL TOTAL,6,56,22,90,460,634,174,27%
0020,ADAMS 12 FIVE STAR SCHOOLS,6261,NEW AMERICA SCHOOL,9TH,1,1,0,32,2,36,34,94%
0020,ADAMS 12 FIVE STAR SCHOOLS,6261,NEW AMERICA SCHOOL,10TH,1,0,0,53,19,73,54,74%
0020,ADAMS 12 FIVE STAR SCHOOLS,6261,NEW AMERICA SCHOOL,11TH,2,0,1,77,16,96,80,83%
0020,ADAMS 12 FIVE STAR SCHOOLS,6261,NEW AMERICA SCHOOL,12TH,1,4,2,198,66,271,205,76%
0020,ADAMS 12 FIVE STAR SCHOOLS,6261,NEW AMERICA SCHOOL,SCHOOL TOTAL,5,5,3,360,103,476,373,78%
0020,ADAMS 12 FIVE STAR SCHOOLS,6342,SHADOW RIDGE MIDDLE SCHOOL,6TH,4,7,13,100,231,355,124,35%
0020,ADAMS 12 FIVE STAR SCHOOLS,6342,SHADOW RIDGE MIDDLE SCHOOL,7TH,2,12,12,101,214,341,127,37%
0020,ADAMS 12 FIVE STAR SCHOOLS,6342,SHADOW RIDGE MIDDLE SCHOOL,8TH,2,11,3,116,207,339,132,39%
0020,ADAMS 12 FIVE STAR SCHOOLS,6342,SHADOW RIDGE MIDDLE SCHOOL,SCHOOL TOTAL,8,30,28,317,652,1035,383,37%
0020,ADAMS 12 FIVE STAR SCHOOLS,6355,NORTH MOR ELEMENTARY SCHOOL,KINDERGARTEN,1,2,2,36,23,64,41,64%
0020,ADAMS 12 FIVE STAR SCHOOLS,6355,NORTH MOR ELEMENTARY SCHOOL,1ST,0,1,2,42,28,73,45,62%
0020,ADAMS 12 FIVE STAR SCHOOLS,6355,NORTH MOR ELEMENTARY SCHOOL,2ND,0,3,4,40,30,77,47,61%
0020,ADAMS 12 FIVE STAR SCHOOLS,6355,NORTH MOR ELEMENTARY SCHOOL,3RD,1,1,2,43,23,70,47,67%
0020,ADAMS 12 FIVE STAR SCHOOLS,6355,NORTH MOR ELEMENTARY SCHOOL,4TH,0,3,3,49,30,85,55,65%
0020,ADAMS 12 FIVE STAR SCHOOLS,6355,NORTH MOR ELEMENTARY SCHOOL,5TH,2,1,7,37,27,74,47,64%
0020,ADAMS 12 FIVE STAR SCHOOLS,6355,NORTH MOR ELEMENTARY SCHOOL,SCHOOL TOTAL,4,11,20,247,161,443,282,64%
0020,ADAMS 12 FIVE STAR SCHOOLS,6376,NORTH STAR ELEMENTARY SCHOOL,KINDERGARTEN,0,0,4,68,11,83,72,87%
0020,ADAMS 12 FIVE STAR SCHOOLS,6376,NORTH STAR ELEMENTARY SCHOOL,1ST,0,1,5,71,11,88,77,88%
0020,ADAMS 12 FIVE STAR SCHOOLS,6376,NORTH STAR ELEMENTARY SCHOOL,2ND,1,1,4,55,12,73,61,84%
0020,ADAMS 12 FIVE STAR SCHOOLS,6376,NORTH STAR ELEMENTARY SCHOOL,3RD,1,0,0,55,12,68,56,82%
0020,ADAMS 12 FIVE STAR SCHOOLS,6376,NORTH STAR ELEMENTARY SCHOOL,4TH,3,0,3,52,13,71,58,82%
0020,ADAMS 12 FIVE STAR SCHOOLS,6376,NORTH STAR ELEMENTARY SCHOOL,5TH,2,3,3,68,12,88,76,86%
0020,ADAMS 12 FIVE STAR SCHOOLS,6376,NORTH STAR ELEMENTARY SCHOOL,SCHOOL TOTAL,7,5,19,369,71,471,400,85%
0020,ADAMS 12 FIVE STAR SCHOOLS,6398,NORTHGLENN MIDDLE SCHOOL,6TH,1,8,10,130,107,256,149,58%
0020,ADAMS 12 FIVE STAR SCHOOLS,6398,NORTHGLENN MIDDLE SCHOOL,7TH,2,12,9,115,118,256,138,54%
0020,ADAMS 12 FIVE STAR SCHOOLS,6398,NORTHGLENN MIDDLE SCHOOL,8TH,2,4,8,104,107,225,118,52%
0020,ADAMS 12 FIVE STAR SCHOOLS,6398,NORTHGLENN MIDDLE SCHOOL,SCHOOL TOTAL,5,24,27,349,332,737,405,55%
0020,ADAMS 12 FIVE STAR SCHOOLS,6402,NORTHGLENN HIGH SCHOOL,9TH,4,28,20,251,185,488,303,62%
0020,ADAMS 12 FIVE STAR SCHOOLS,6402,NORTHGLENN HIGH SCHOOL,10TH,6,14,14,249,187,470,283,60%
0020,ADAMS 12 FIVE STAR SCHOOLS,6402,NORTHGLENN HIGH SCHOOL,11TH,5,20,16,212,193,446,253,57%
0020,ADAMS 12 FIVE STAR SCHOOLS,6402,NORTHGLENN HIGH SCHOOL,12TH,7,23,13,166,206,415,209,50%
0020,ADAMS 12 FIVE STAR SCHOOLS,6402,NORTHGLENN HIGH SCHOOL,SCHOOL TOTAL,22,85,63,878,771,1819,1048,58%
0020,ADAMS 12 FIVE STAR SCHOOLS,6830,NIVER CREEK MIDDLE SCHOOL,6TH,1,9,3,169,54,236,182,77%
0020,ADAMS 12 FIVE STAR SCHOOLS,6830,NIVER CREEK MIDDLE SCHOOL,7TH,0,7,7,188,58,260,202,78%
0020,ADAMS 12 FIVE STAR SCHOOLS,6830,NIVER CREEK MIDDLE SCHOOL,8TH,1,4,5,191,48,249,201,81%
0020,ADAMS 12 FIVE STAR SCHOOLS,6830,NIVER CREEK MIDDLE SCHOOL,SCHOOL TOTAL,2,20,15,548,160,745,585,79%
0020,ADAMS 12 FIVE STAR SCHOOLS,7155,PRAIRIE HILLS ELEMENTARY SCHOOL,HALF DAY K,0,2,1,1,21,25,4,16%
0020,ADAMS 12 FIVE STAR SCHOOLS,7155,PRAIRIE HILLS ELEMENTARY SCHOOL,KINDERGARTEN,0,5,0,13,38,56,18,32%
0020,ADAMS 12 FIVE STAR SCHOOLS,7155,PRAIRIE HILLS ELEMENTARY SCHOOL,1ST,0,8,4,17,76,105,29,28%
0020,ADAMS 12 FIVE STAR SCHOOLS,7155,PRAIRIE HILLS ELEMENTARY SCHOOL,2ND,0,11,2,13,73,99,26,26%
0020,ADAMS 12 FIVE STAR SCHOOLS,7155,PRAIRIE HILLS ELEMENTARY SCHOOL,3RD,0,5,0,12,77,94,17,18%
0020,ADAMS 12 FIVE STAR SCHOOLS,7155,PRAIRIE HILLS ELEMENTARY SCHOOL,4TH,1,10,2,21,57,91,34,37%
0020,ADAMS 12 FIVE STAR SCHOOLS,7155,PRAIRIE HILLS ELEMENTARY SCHOOL,5TH,0,8,0,16,48,72,24,33%
0020,ADAMS 12 FIVE STAR SCHOOLS,7155,PRAIRIE HILLS ELEMENTARY SCHOOL,SCHOOL TOTAL,1,49,9,93,390,542,152,28%
0020,ADAMS 12 FIVE STAR SCHOOLS,7795,SILVER CREEK ELEMENTARY,HALF DAY K,0,8,2,12,67,89,22,25%
0020,ADAMS 12 FIVE STAR SCHOOLS,7795,SILVER CREEK ELEMENTARY,KINDERGARTEN,0,0,0,4,42,46,4,9%
0020,ADAMS 12 FIVE STAR SCHOOLS,7795,SILVER CREEK ELEMENTARY,1ST,1,13,0,8,104,126,22,17%
0020,ADAMS 12 FIVE STAR SCHOOLS,7795,SILVER CREEK ELEMENTARY,2ND,0,10,2,14,102,128,26,20%
0020,ADAMS 12 FIVE STAR SCHOOLS,7795,SILVER CREEK ELEMENTARY,3RD,0,8,1,15,86,110,24,22%
0020,ADAMS 12 FIVE STAR SCHOOLS,7795,SILVER CREEK ELEMENTARY,4TH,0,22,1,12,93,128,35,27%
0020,ADAMS 12 FIVE STAR SCHOOLS,7795,SILVER CREEK ELEMENTARY,5TH,0,9,2,14,85,110,25,23%
0020,ADAMS 12 FIVE STAR SCHOOLS,7795,SILVER CREEK ELEMENTARY,SCHOOL TOTAL,1,70,8,79,579,737,158,21%
0020,ADAMS 12 FIVE STAR SCHOOLS,8211,THE STUDIO SCHOOL,KINDERGARTEN,0,3,0,13,34,50,16,32%
0020,ADAMS 12 FIVE STAR SCHOOLS,8211,THE STUDIO SCHOOL,1ST,0,1,1,20,30,52,22,42%
0020,ADAMS 12 FIVE STAR SCHOOLS,8211,THE STUDIO SCHOOL,2ND,1,6,1,14,27,49,22,45%
0020,ADAMS 12 FIVE STAR SCHOOLS,8211,THE STUDIO SCHOOL,3RD,1,1,4,13,28,47,19,40%
0020,ADAMS 12 FIVE STAR SCHOOLS,8211,THE STUDIO SCHOOL,SCHOOL TOTAL,2,11,6,60,119,198,79,40%
0020,ADAMS 12 FIVE STAR SCHOOLS,8225,STELLAR ELEMENTARY SCHOOL,HALF DAY K,1,8,1,19,44,73,29,40%
0020,ADAMS 12 FIVE STAR SCHOOLS,8225,STELLAR ELEMENTARY SCHOOL,KINDERGARTEN,1,1,0,9,14,25,11,44%
0020,ADAMS 12 FIVE STAR SCHOOLS,8225,STELLAR ELEMENTARY SCHOOL,1ST,0,11,8,38,66,123,57,46%
0020,ADAMS 12 FIVE STAR SCHOOLS,8225,STELLAR ELEMENTARY SCHOOL,2ND,1,4,3,37,62,107,45,42%
0020,ADAMS 12 FIVE STAR SCHOOLS,8225,STELLAR ELEMENTARY SCHOOL,3RD,0,7,2,24,69,102,33,32%
0020,ADAMS 12 FIVE STAR SCHOOLS,8225,STELLAR ELEMENTARY SCHOOL,4TH,1,9,8,37,52,107,55,51%
0020,ADAMS 12 FIVE STAR SCHOOLS,8225,STELLAR ELEMENTARY SCHOOL,5TH,1,4,8,31,59,103,44,43%
0020,ADAMS 12 FIVE STAR SCHOOLS,8225,STELLAR ELEMENTARY SCHOOL,SCHOOL TOTAL,5,44,30,195,366,640,274,43%
0020,ADAMS 12 FIVE STAR SCHOOLS,8361,STUKEY ELEMENTARY SCHOOL,HALF DAY K,2,2,2,28,24,58,34,59%
0020,ADAMS 12 FIVE STAR SCHOOLS,8361,STUKEY ELEMENTARY SCHOOL,KINDERGARTEN,0,0,1,9,6,16,10,63%
0020,ADAMS 12 FIVE STAR SCHOOLS,8361,STUKEY ELEMENTARY SCHOOL,1ST,1,4,6,47,32,90,58,64%
0020,ADAMS 12 FIVE STAR SCHOOLS,8361,STUKEY ELEMENTARY SCHOOL,2ND,1,1,4,34,28,68,40,59%
0020,ADAMS 12 FIVE STAR SCHOOLS,8361,STUKEY ELEMENTARY SCHOOL,3RD,0,2,4,31,29,66,37,56%
0020,ADAMS 12 FIVE STAR SCHOOLS,8361,STUKEY ELEMENTARY SCHOOL,4TH,2,2,5,35,43,87,44,51%
0020,ADAMS 12 FIVE STAR SCHOOLS,8361,STUKEY ELEMENTARY SCHOOL,5TH,0,3,4,34,26,67,41,61%
0020,ADAMS 12 FIVE STAR SCHOOLS,8361,STUKEY ELEMENTARY SCHOOL,SCHOOL TOTAL,6,14,26,218,188,452,264,58%
0020,ADAMS 12 FIVE STAR SCHOOLS,8842,THORNTON ELEMENTARY SCHOOL,KINDERGARTEN,2,6,2,47,13,70,57,81%
0020,ADAMS 12 FIVE STAR SCHOOLS,8842,THORNTON ELEMENTARY SCHOOL,1ST,1,3,1,64,18,87,69,79%
0020,ADAMS 12 FIVE STAR SCHOOLS,8842,THORNTON ELEMENTARY SCHOOL,2ND,0,6,2,56,18,82,64,78%
0020,ADAMS 12 FIVE STAR SCHOOLS,8842,THORNTON ELEMENTARY SCHOOL,3RD,1,6,3,57,16,83,67,81%
0020,ADAMS 12 FIVE STAR SCHOOLS,8842,THORNTON ELEMENTARY SCHOOL,4TH,0,3,4,59,21,87,66,76%
0020,ADAMS 12 FIVE STAR SCHOOLS,8842,THORNTON ELEMENTARY SCHOOL,5TH,1,5,1,58,10,75,65,87%
0020,ADAMS 12 FIVE STAR SCHOOLS,8842,THORNTON ELEMENTARY SCHOOL,SCHOOL TOTAL,5,29,13,341,96,484,388,80%
0020,ADAMS 12 FIVE STAR SCHOOLS,9431,WESTGATE CHARTER,HALF DAY K,0,3,0,2,10,15,5,33%
0020,ADAMS 12 FIVE STAR SCHOOLS,9431,WESTGATE CHARTER,KINDERGARTEN,0,0,0,0,1,1,0,0%
0020,ADAMS 12 FIVE STAR SCHOOLS,9431,WESTGATE CHARTER,1ST,0,1,0,0,15,16,1,6%
0020,ADAMS 12 FIVE STAR SCHOOLS,9431,WESTGATE CHARTER,2ND,0,3,2,1,18,24,6,25%
0020,ADAMS 12 FIVE STAR SCHOOLS,9431,WESTGATE CHARTER,3RD,0,0,0,2,21,23,2,9%
0020,ADAMS 12 FIVE STAR SCHOOLS,9431,WESTGATE CHARTER,4TH,0,2,0,1,18,21,3,14%
0020,ADAMS 12 FIVE STAR SCHOOLS,9431,WESTGATE CHARTER,5TH,0,0,0,2,21,23,2,9%
0020,ADAMS 12 FIVE STAR SCHOOLS,9431,WESTGATE CHARTER,6TH,0,0,0,1,18,19,1,5%
0020,ADAMS 12 FIVE STAR SCHOOLS,9431,WESTGATE CHARTER,SCHOOL TOTAL,0,9,2,9,122,142,20,14%
0020,ADAMS 12 FIVE STAR SCHOOLS,9444,WESTLAKE MIDDLE SCHOOL,6TH,2,33,4,53,239,331,92,28%
0020,ADAMS 12 FIVE STAR SCHOOLS,9444,WESTLAKE MIDDLE SCHOOL,7TH,2,35,10,50,193,290,97,33%
0020,ADAMS 12 FIVE STAR SCHOOLS,9444,WESTLAKE MIDDLE SCHOOL,8TH,0,7,4,51,234,296,62,21%
0020,ADAMS 12 FIVE STAR SCHOOLS,9444,WESTLAKE MIDDLE SCHOOL,SCHOOL TOTAL,4,75,18,154,666,917,251,27%
0020,ADAMS 12 FIVE STAR SCHOOLS,9494,WESTVIEW ELEMENTARY SCHOOL,HALF DAY K,2,2,3,20,23,50,27,54%
0020,ADAMS 12 FIVE STAR SCHOOLS,9494,WESTVIEW ELEMENTARY SCHOOL,KINDERGARTEN,0,2,1,5,16,24,8,33%
0020,ADAMS 12 FIVE STAR SCHOOLS,9494,WESTVIEW ELEMENTARY SCHOOL,1ST,0,4,2,30,40,76,36,47%
0020,ADAMS 12 FIVE STAR SCHOOLS,9494,WESTVIEW ELEMENTARY SCHOOL,2ND,0,7,2,27,44,80,36,45%
0020,ADAMS 12 FIVE STAR SCHOOLS,9494,WESTVIEW ELEMENTARY SCHOOL,3RD,0,8,4,29,37,78,41,53%
0020,ADAMS 12 FIVE STAR SCHOOLS,9494,WESTVIEW ELEMENTARY SCHOOL,4TH,0,7,4,34,54,99,45,45%
0020,ADAMS 12 FIVE STAR SCHOOLS,9494,WESTVIEW ELEMENTARY SCHOOL,5TH,1,6,4,25,39,75,36,48%
0020,ADAMS 12 FIVE STAR SCHOOLS,9494,WESTVIEW ELEMENTARY SCHOOL,SCHOOL TOTAL,3,36,20,170,253,482,229,48%
0020,ADAMS 12 FIVE STAR SCHOOLS,9682,WOODGLEN ELEMENTARY SCHOOL,HALF DAY K,0,0,0,19,42,61,19,31%
0020,ADAMS 12 FIVE STAR SCHOOLS,9682,WOODGLEN ELEMENTARY SCHOOL,1ST,0,2,3,16,44,65,21,32%
0020,ADAMS 12 FIVE STAR SCHOOLS,9682,WOODGLEN ELEMENTARY SCHOOL,2ND,1,5,2,20,41,69,28,41%
0020,ADAMS 12 FIVE STAR SCHOOLS,9682,WOODGLEN ELEMENTARY SCHOOL,3RD,0,3,4,20,55,82,27,33%
0020,ADAMS 12 FIVE STAR SCHOOLS,9682,WOODGLEN ELEMENTARY SCHOOL,4TH,1,2,1,22,41,67,26,39%
0020,ADAMS 12 FIVE STAR SCHOOLS,9682,WOODGLEN ELEMENTARY SCHOOL,5TH,0,3,1,33,48,85,37,44%
0020,ADAMS 12 FIVE STAR SCHOOLS,9682,WOODGLEN ELEMENTARY SCHOOL,SCHOOL TOTAL,2,15,11,130,271,429,158,37%
0020,ADAMS 12 FIVE STAR SCHOOLS,,DISTRICT TOTAL,,361,2280,1140,12919,25249,41949,16700,40%
0030,ADAMS COUNTY 14,0020,ADAMS CITY MIDDLE SCHOOL,6TH,2,0,8,185,42,237,195,82%
0030,ADAMS COUNTY 14,0020,ADAMS CITY MIDDLE SCHOOL,7TH,1,2,5,193,47,248,201,81%
0030,ADAMS COUNTY 14,0020,ADAMS CITY MIDDLE SCHOOL,8TH,4,0,2,151,49,206,157,76%
0030,ADAMS COUNTY 14,0020,ADAMS CITY MIDDLE SCHOOL,SCHOOL TOTAL,7,2,15,529,138,691,553,80%
0030,ADAMS COUNTY 14,0022,LESTER R ARNOLD HIGH SCHOOL,9TH,0,0,0,0,1,1,0,0%
0030,ADAMS COUNTY 14,0022,LESTER R ARNOLD HIGH SCHOOL,10TH,1,0,0,13,6,20,14,70%
0030,ADAMS COUNTY 14,0022,LESTER R ARNOLD HIGH SCHOOL,11TH,0,1,2,32,7,42,35,83%
0030,ADAMS COUNTY 14,0022,LESTER R ARNOLD HIGH SCHOOL,12TH,3,1,3,107,26,140,114,81%
0030,ADAMS COUNTY 14,0022,LESTER R ARNOLD HIGH SCHOOL,SCHOOL TOTAL,4,2,5,152,40,203,163,80%
0030,ADAMS COUNTY 14,0024,ADAMS CITY HIGH SCHOOL,9TH,8,0,12,413,69,502,433,86%
0030,ADAMS COUNTY 14,0024,ADAMS CITY HIGH SCHOOL,10TH,3,2,8,375,64,452,388,86%
0030,ADAMS COUNTY 14,0024,ADAMS CITY HIGH SCHOOL,11TH,5,4,12,337,63,421,358,85%
0030,ADAMS COUNTY 14,0024,ADAMS CITY HIGH SCHOOL,12TH,7,3,13,213,54,290,236,81%
0030,ADAMS COUNTY 14,0024,ADAMS CITY HIGH SCHOOL,SCHOOL TOTAL,23,9,45,1338,250,1665,1415,85%
0030,ADAMS COUNTY 14,0124,ACSD 14 CHILD CARE CENTER,PK,2,0,1,85,22,110,88,80%
0030,ADAMS COUNTY 14,0124,ACSD 14 CHILD CARE CENTER,SCHOOL TOTAL,2,0,1,85,22,110,88,80%
0030,ADAMS COUNTY 14,0186,ALSUP ELEMENTARY SCHOOL,PK,0,0,1,26,5,32,27,84%
0030,ADAMS COUNTY 14,0186,ALSUP ELEMENTARY SCHOOL,KINDERGARTEN,1,1,2,66,24,94,70,74%
0030,ADAMS COUNTY 14,0186,ALSUP ELEMENTARY SCHOOL,1ST,3,0,2,78,18,101,83,82%
0030,ADAMS COUNTY 14,0186,ALSUP ELEMENTARY SCHOOL,2ND,1,0,3,87,16,107,91,85%
0030,ADAMS COUNTY 14,0186,ALSUP ELEMENTARY SCHOOL,3RD,0,0,0,66,18,84,66,79%
0030,ADAMS COUNTY 14,0186,ALSUP ELEMENTARY SCHOOL,4TH,1,0,2,72,9,84,75,89%
0030,ADAMS COUNTY 14,0186,ALSUP ELEMENTARY SCHOOL,5TH,2,1,3,64,19,89,70,79%
0030,ADAMS COUNTY 14,0186,ALSUP ELEMENTARY SCHOOL,SCHOOL TOTAL,8,2,13,459,109,591,482,82%
0030,ADAMS COUNTY 14,1426,CENTRAL ELEMENTARY SCHOOL,PK,0,0,0,56,3,59,56,95%
0030,ADAMS COUNTY 14,1426,CENTRAL ELEMENTARY SCHOOL,KINDERGARTEN,1,0,2,90,15,108,93,86%
0030,ADAMS COUNTY 14,1426,CENTRAL ELEMENTARY SCHOOL,1ST,0,0,5,74,21,100,79,79%
0030,ADAMS COUNTY 14,1426,CENTRAL ELEMENTARY SCHOOL,2ND,0,0,5,76,15,96,81,84%
0030,ADAMS COUNTY 14,1426,CENTRAL ELEMENTARY SCHOOL,3RD,1,0,7,81,14,103,89,86%
0030,ADAMS COUNTY 14,1426,CENTRAL ELEMENTARY SCHOOL,4TH,1,0,2,83,10,96,86,90%
0030,ADAMS COUNTY 14,1426,CENTRAL ELEMENTARY SCHOOL,5TH,0,0,6,61,9,76,67,88%
0030,ADAMS COUNTY 14,1426,CENTRAL ELEMENTARY SCHOOL,SCHOOL TOTAL,3,0,27,521,87,638,551,86%
0030,ADAMS COUNTY 14,1882,COMMUNITY LEADERSHIP ACADEMY,KINDERGARTEN,0,0,0,48,8,56,48,86%
0030,ADAMS COUNTY 14,1882,COMMUNITY LEADERSHIP ACADEMY,1ST,0,0,0,55,3,58,55,95%
0030,ADAMS COUNTY 14,1882,COMMUNITY LEADERSHIP ACADEMY,2ND,0,0,1,51,5,57,52,91%
0030,ADAMS COUNTY 14,1882,COMMUNITY LEADERSHIP ACADEMY,3RD,0,1,0,52,6,59,53,90%
0030,ADAMS COUNTY 14,1882,COMMUNITY LEADERSHIP ACADEMY,4TH,0,1,0,48,6,55,49,89%
0030,ADAMS COUNTY 14,1882,COMMUNITY LEADERSHIP ACADEMY,5TH,0,0,1,48,7,56,49,88%
0030,ADAMS COUNTY 14,1882,COMMUNITY LEADERSHIP ACADEMY,6TH,1,0,0,45,5,51,46,90%
0030,ADAMS COUNTY 14,1882,COMMUNITY LEADERSHIP ACADEMY,7TH,0,0,0,46,2,48,46,96%
0030,ADAMS COUNTY 14,1882,COMMUNITY LEADERSHIP ACADEMY,8TH,0,0,0,31,1,32,31,97%
0030,ADAMS COUNTY 14,1882,COMMUNITY LEADERSHIP ACADEMY,SCHOOL TOTAL,1,2,2,424,43,472,429,91%
0030,ADAMS COUNTY 14,2308,DUPONT ELEMENTARY SCHOOL,PK,0,0,0,29,3,32,29,91%
0030,ADAMS COUNTY 14,2308,DUPONT ELEMENTARY SCHOOL,KINDERGARTEN,0,0,3,66,13,82,69,84%
0030,ADAMS COUNTY 14,2308,DUPONT ELEMENTARY SCHOOL,1ST,1,0,1,83,13,98,85,87%
0030,ADAMS COUNTY 14,2308,DUPONT ELEMENTARY SCHOOL,2ND,0,0,1,68,14,83,69,83%
0030,ADAMS COUNTY 14,2308,DUPONT ELEMENTARY SCHOOL,3RD,1,1,4,81,12,99,87,88%
0030,ADAMS COUNTY 14,2308,DUPONT ELEMENTARY SCHOOL,4TH,3,1,1,79,10,94,84,89%
0030,ADAMS COUNTY 14,2308,DUPONT ELEMENTARY SCHOOL,5TH,0,0,1,63,20,84,64,76%
0030,ADAMS COUNTY 14,2308,DUPONT ELEMENTARY SCHOOL,SCHOOL TOTAL,5,2,11,469,85,572,487,85%
0030,ADAMS COUNTY 14,4516,KEARNEY MIDDLE SCHOOL,6TH,0,1,16,149,26,192,166,86%
0030,ADAMS COUNTY 14,4516,KEARNEY MIDDLE SCHOOL,7TH,3,1,7,117,26,154,128,83%
0030,ADAMS COUNTY 14,4516,KEARNEY MIDDLE SCHOOL,8TH,3,0,12,143,21,179,158,88%
0030,ADAMS COUNTY 14,4516,KEARNEY MIDDLE SCHOOL,SCHOOL TOTAL,6,2,35,409,73,525,452,86%
0030,ADAMS COUNTY 14,4536,KEMP ELEMENTARY SCHOOL,PK,0,0,0,54,8,62,54,87%
0030,ADAMS COUNTY 14,4536,KEMP ELEMENTARY SCHOOL,KINDERGARTEN,1,0,1,58,9,69,60,87%
0030,ADAMS COUNTY 14,4536,KEMP ELEMENTARY SCHOOL,1ST,0,0,1,54,8,63,55,87%
0030,ADAMS COUNTY 14,4536,KEMP ELEMENTARY SCHOOL,2ND,0,0,1,58,9,68,59,87%
0030,ADAMS COUNTY 14,4536,KEMP ELEMENTARY SCHOOL,3RD,1,0,2,49,8,60,52,87%
0030,ADAMS COUNTY 14,4536,KEMP ELEMENTARY SCHOOL,4TH,0,0,1,44,7,52,45,87%
0030,ADAMS COUNTY 14,4536,KEMP ELEMENTARY SCHOOL,5TH,2,0,1,44,11,58,47,81%
0030,ADAMS COUNTY 14,4536,KEMP ELEMENTARY SCHOOL,SCHOOL TOTAL,4,0,7,361,60,432,372,86%
0030,ADAMS COUNTY 14,5880,MILDRED L SANVILLE PRESCHOOL,PK,0,0,1,81,10,92,82,89%
0030,ADAMS COUNTY 14,5880,MILDRED L SANVILLE PRESCHOOL,SCHOOL TOTAL,0,0,1,81,10,92,82,89%
0030,ADAMS COUNTY 14,5982,MONACO ELEMENTARY SCHOOL,PK,0,0,1,48,10,59,49,83%
0030,ADAMS COUNTY 14,5982,MONACO ELEMENTARY SCHOOL,KINDERGARTEN,0,0,4,70,16,90,74,82%
0030,ADAMS COUNTY 14,5982,MONACO ELEMENTARY SCHOOL,1ST,0,0,0,66,10,76,66,87%
0030,ADAMS COUNTY 14,5982,MONACO ELEMENTARY SCHOOL,2ND,0,0,1,55,9,65,56,86%
0030,ADAMS COUNTY 14,5982,MONACO ELEMENTARY SCHOOL,3RD,0,0,1,62,3,66,63,95%
0030,ADAMS COUNTY 14,5982,MONACO ELEMENTARY SCHOOL,4TH,0,0,1,57,11,69,58,84%
0030,ADAMS COUNTY 14,5982,MONACO ELEMENTARY SCHOOL,5TH,0,0,0,57,12,69,57,83%
0030,ADAMS COUNTY 14,5982,MONACO ELEMENTARY SCHOOL,SCHOOL TOTAL,0,0,8,415,71,494,423,86%
0030,ADAMS COUNTY 14,6534,HANSON ELEMENTARY SCHOOL,PK,0,0,0,28,4,32,28,88%
0030,ADAMS COUNTY 14,6534,HANSON ELEMENTARY SCHOOL,KINDERGARTEN,1,0,1,50,5,57,52,91%
0030,ADAMS COUNTY 14,6534,HANSON ELEMENTARY SCHOOL,1ST,0,0,3,54,5,62,57,92%
0030,ADAMS COUNTY 14,6534,HANSON ELEMENTARY SCHOOL,2ND,1,0,1,62,8,72,64,89%
0030,ADAMS COUNTY 14,6534,HANSON ELEMENTARY SCHOOL,3RD,1,0,0,43,5,49,44,90%
0030,ADAMS COUNTY 14,6534,HANSON ELEMENTARY SCHOOL,4TH,2,0,1,44,3,50,47,94%
0030,ADAMS COUNTY 14,6534,HANSON ELEMENTARY SCHOOL,5TH,0,0,0,44,4,48,44,92%
0030,ADAMS COUNTY 14,6534,HANSON ELEMENTARY SCHOOL,6TH,0,1,0,51,5,57,52,91%
0030,ADAMS COUNTY 14,6534,HANSON ELEMENTARY SCHOOL,7TH,0,1,0,40,4,45,41,91%
0030,ADAMS COUNTY 14,6534,HANSON ELEMENTARY SCHOOL,8TH,0,2,1,35,3,41,38,93%
0030,ADAMS COUNTY 14,6534,HANSON ELEMENTARY SCHOOL,SCHOOL TOTAL,5,4,7,451,46,513,467,91%
0030,ADAMS COUNTY 14,7500,ROSE HILL ELEMENTARY SCHOOL,PK,0,0,0,22,8,30,22,73%
0030,ADAMS COUNTY 14,7500,ROSE HILL ELEMENTARY SCHOOL,KINDERGARTEN,1,0,1,57,11,70,59,84%
0030,ADAMS COUNTY 14,7500,ROSE HILL ELEMENTARY SCHOOL,1ST,1,0,2,62,9,74,65,88%
0030,ADAMS COUNTY 14,7500,ROSE HILL ELEMENTARY SCHOOL,2ND,0,0,2,63,10,75,65,87%
0030,ADAMS COUNTY 14,7500,ROSE HILL ELEMENTARY SCHOOL,3RD,1,1,1,58,6,67,61,91%
0030,ADAMS COUNTY 14,7500,ROSE HILL ELEMENTARY SCHOOL,4TH,1,0,2,34,3,40,37,93%
0030,ADAMS COUNTY 14,7500,ROSE HILL ELEMENTARY SCHOOL,5TH,0,0,2,59,7,68,61,90%
0030,ADAMS COUNTY 14,7500,ROSE HILL ELEMENTARY SCHOOL,SCHOOL TOTAL,4,1,10,355,54,424,370,87%
0030,ADAMS COUNTY 14,,DISTRICT TOTAL,,72,26,187,6049,1088,7422,6334,85%
0040,BRIGHTON 27J,0700,BELLE CREEK CHARTER SCHOOL,KINDERGARTEN,1,0,2,21,55,79,24,30%
0040,BRIGHTON 27J,0700,BELLE CREEK CHARTER SCHOOL,1ST,3,4,3,44,51,105,54,51%
0040,BRIGHTON 27J,0700,BELLE CREEK CHARTER SCHOOL,2ND,2,4,4,41,46,97,51,53%
0040,BRIGHTON 27J,0700,BELLE CREEK CHARTER SCHOOL,3RD,1,2,4,30,42,79,37,47%
0040,BRIGHTON 27J,0700,BELLE CREEK CHARTER SCHOOL,4TH,3,3,5,36,42,89,47,53%
0040,BRIGHTON 27J,0700,BELLE CREEK CHARTER SCHOOL,5TH,1,1,4,28,42,76,34,45%
0040,BRIGHTON 27J,0700,BELLE CREEK CHARTER SCHOOL,6TH,0,2,3,28,34,67,33,49%
0040,BRIGHTON 27J,0700,BELLE CREEK CHARTER SCHOOL,7TH,1,1,2,18,19,41,22,54%
0040,BRIGHTON 27J,0700,BELLE CREEK CHARTER SCHOOL,8TH,2,0,2,19,19,42,23,55%
0040,BRIGHTON 27J,0700,BELLE CREEK CHARTER SCHOOL,SCHOOL TOTAL,14,17,29,265,350,675,325,48%
0040,BRIGHTON 27J,1021,BRIGHTON HERITAGE ACADEMY,6TH,0,0,0,1,0,1,1,100%
0040,BRIGHTON 27J,1021,BRIGHTON HERITAGE ACADEMY,7TH,0,0,0,2,2,4,2,50%
0040,BRIGHTON 27J,1021,BRIGHTON HERITAGE ACADEMY,8TH,0,0,0,11,2,13,11,85%
0040,BRIGHTON 27J,1021,BRIGHTON HERITAGE ACADEMY,9TH,3,2,3,48,25,81,56,69%
0040,BRIGHTON 27J,1021,BRIGHTON HERITAGE ACADEMY,10TH,0,0,1,32,12,45,33,73%
0040,BRIGHTON 27J,1021,BRIGHTON HERITAGE ACADEMY,11TH,0,2,2,17,14,35,21,60%
0040,BRIGHTON 27J,1021,BRIGHTON HERITAGE ACADEMY,12TH,0,3,2,12,9,26,17,65%
0040,BRIGHTON 27J,1021,BRIGHTON HERITAGE ACADEMY,SCHOOL TOTAL,3,7,8,123,64,205,141,69%
0040,BRIGHTON 27J,1022,BRIGHTON HIGH SCHOOL,9TH,6,12,7,241,222,488,266,55%
0040,BRIGHTON 27J,1022,BRIGHTON HIGH SCHOOL,10TH,5,5,5,177,173,365,192,53%
0040,BRIGHTON 27J,1022,BRIGHTON HIGH SCHOOL,11TH,0,7,2,153,187,349,162,46%
0040,BRIGHTON 27J,1022,BRIGHTON HIGH SCHOOL,12TH,0,4,6,128,192,330,138,42%
0040,BRIGHTON 27J,1022,BRIGHTON HIGH SCHOOL,SCHOOL TOTAL,11,28,20,699,774,1532,758,49%
0040,BRIGHTON 27J,1027,BRIGHTON COLLEGIATE HIGH SCHOOL,9TH,2,5,1,20,63,91,28,31%
0040,BRIGHTON 27J,1027,BRIGHTON COLLEGIATE HIGH SCHOOL,10TH,0,1,0,20,26,47,21,45%
0040,BRIGHTON 27J,1027,BRIGHTON COLLEGIATE HIGH SCHOOL,11TH,0,0,0,19,43,62,19,31%
0040,BRIGHTON 27J,1027,BRIGHTON COLLEGIATE HIGH SCHOOL,12TH,0,3,3,27,30,63,33,52%
0040,BRIGHTON 27J,1027,BRIGHTON COLLEGIATE HIGH SCHOOL,SCHOOL TOTAL,2,9,4,86,162,263,101,38%
0040,BRIGHTON 27J,1052,BROMLEY EAST CHARTER SCHOOL,HALF DAY K,1,0,2,16,25,44,19,43%
0040,BRIGHTON 27J,1052,BROMLEY EAST CHARTER SCHOOL,KINDERGARTEN,0,1,1,11,53,66,13,20%
0040,BRIGHTON 27J,1052,BROMLEY EAST CHARTER SCHOOL,1ST,0,5,2,30,59,96,37,39%
0040,BRIGHTON 27J,1052,BROMLEY EAST CHARTER SCHOOL,2ND,2,5,1,18,82,108,26,24%
0040,BRIGHTON 27J,1052,BROMLEY EAST CHARTER SCHOOL,3RD,2,5,1,20,67,95,28,29%
0040,BRIGHTON 27J,1052,BROMLEY EAST CHARTER SCHOOL,4TH,0,3,0,23,60,86,26,30%
0040,BRIGHTON 27J,1052,BROMLEY EAST CHARTER SCHOOL,5TH,0,8,2,30,53,93,40,43%
0040,BRIGHTON 27J,1052,BROMLEY EAST CHARTER SCHOOL,6TH,2,5,1,22,53,83,30,36%
0040,BRIGHTON 27J,1052,BROMLEY EAST CHARTER SCHOOL,7TH,1,2,1,21,42,67,25,37%
0040,BRIGHTON 27J,1052,BROMLEY EAST CHARTER SCHOOL,8TH,0,5,0,25,52,82,30,37%
0040,BRIGHTON 27J,1052,BROMLEY EAST CHARTER SCHOOL,SCHOOL TOTAL,8,39,11,216,546,820,274,33%
0040,BRIGHTON 27J,3900,HENDERSON ELEMENTARY SCHOOL,PK,3,5,4,65,102,179,77,43%
0040,BRIGHTON 27J,3900,HENDERSON ELEMENTARY SCHOOL,HALF DAY K,0,2,0,24,33,59,26,44%
0040,BRIGHTON 27J,3900,HENDERSON ELEMENTARY SCHOOL,1ST,1,0,1,26,41,69,28,41%
0040,BRIGHTON 27J,3900,HENDERSON ELEMENTARY SCHOOL,2ND,0,2,2,21,26,51,25,49%
0040,BRIGHTON 27J,3900,HENDERSON ELEMENTARY SCHOOL,3RD,1,3,0,19,28,51,23,45%
0040,BRIGHTON 27J,3900,HENDERSON ELEMENTARY SCHOOL,4TH,1,1,4,31,26,63,37,59%
0040,BRIGHTON 27J,3900,HENDERSON ELEMENTARY SCHOOL,5TH,1,0,0,15,24,40,16,40%
0040,BRIGHTON 27J,3900,HENDERSON ELEMENTARY SCHOOL,SCHOOL TOTAL,7,13,11,201,280,512,232,45%
0040,BRIGHTON 27J,4950,LANDMARK ACADEMY AT REUNION,HALF DAY K,0,1,1,5,36,43,7,16%
0040,BRIGHTON 27J,4950,LANDMARK ACADEMY AT REUNION,KINDERGARTEN,1,1,0,8,32,42,10,24%
0040,BRIGHTON 27J,4950,LANDMARK ACADEMY AT REUNION,1ST,0,3,8,8,62,81,19,23%
0040,BRIGHTON 27J,4950,LANDMARK ACADEMY AT REUNION,2ND,0,1,3,20,60,84,24,29%
0040,BRIGHTON 27J,4950,LANDMARK ACADEMY AT REUNION,3RD,1,2,3,17,55,78,23,29%
0040,BRIGHTON 27J,4950,LANDMARK ACADEMY AT REUNION,4TH,0,1,4,16,59,80,21,26%
0040,BRIGHTON 27J,4950,LANDMARK ACADEMY AT REUNION,5TH,0,4,3,21,47,75,28,37%
0040,BRIGHTON 27J,4950,LANDMARK ACADEMY AT REUNION,6TH,0,1,3,18,55,77,22,29%
0040,BRIGHTON 27J,4950,LANDMARK ACADEMY AT REUNION,7TH,1,1,1,13,38,54,16,30%
0040,BRIGHTON 27J,4950,LANDMARK ACADEMY AT REUNION,SCHOOL TOTAL,3,15,26,126,444,614,170,28%
0040,BRIGHTON 27J,5615,MARY E PENNOCK ELEMENTARY SCHOOL,HALF DAY K,3,1,4,54,78,140,62,44%
0040,BRIGHTON 27J,5615,MARY E PENNOCK ELEMENTARY SCHOOL,1ST,1,2,2,44,76,125,49,39%
0040,BRIGHTON 27J,5615,MARY E PENNOCK ELEMENTARY SCHOOL,2ND,0,7,3,48,82,140,58,41%
0040,BRIGHTON 27J,5615,MARY E PENNOCK ELEMENTARY SCHOOL,3RD,3,6,2,58,86,155,69,45%
0040,BRIGHTON 27J,5615,MARY E PENNOCK ELEMENTARY SCHOOL,4TH,0,7,2,46,65,120,55,46%
0040,BRIGHTON 27J,5615,MARY E PENNOCK ELEMENTARY SCHOOL,5TH,1,4,3,49,70,127,57,45%
0040,BRIGHTON 27J,5615,MARY E PENNOCK ELEMENTARY SCHOOL,SCHOOL TOTAL,8,27,16,299,457,807,350,43%
0040,BRIGHTON 27J,6294,NORTH ELEMENTARY SCHOOL,PK,1,1,1,44,13,60,47,78%
0040,BRIGHTON 27J,6294,NORTH ELEMENTARY SCHOOL,HALF DAY K,0,0,0,24,8,32,24,75%
0040,BRIGHTON 27J,6294,NORTH ELEMENTARY SCHOOL,KINDERGARTEN,0,2,0,32,3,37,34,92%
0040,BRIGHTON 27J,6294,NORTH ELEMENTARY SCHOOL,1ST,2,1,1,51,10,65,55,85%
0040,BRIGHTON 27J,6294,NORTH ELEMENTARY SCHOOL,2ND,2,1,0,47,9,59,50,85%
0040,BRIGHTON 27J,6294,NORTH ELEMENTARY SCHOOL,3RD,1,1,0,44,7,53,46,87%
0040,BRIGHTON 27J,6294,NORTH ELEMENTARY SCHOOL,4TH,1,1,0,48,8,58,50,86%
0040,BRIGHTON 27J,6294,NORTH ELEMENTARY SCHOOL,5TH,0,0,0,49,7,56,49,88%
0040,BRIGHTON 27J,6294,NORTH ELEMENTARY SCHOOL,SCHOOL TOTAL,7,7,2,339,65,420,355,85%
0040,BRIGHTON 27J,6395,NORTHEAST ELEMENTARY SCHOOL,PK,0,0,0,17,12,29,17,59%
0040,BRIGHTON 27J,6395,NORTHEAST ELEMENTARY SCHOOL,HALF DAY K,0,0,2,33,31,66,35,53%
0040,BRIGHTON 27J,6395,NORTHEAST ELEMENTARY SCHOOL,KINDERGARTEN,0,0,0,10,5,15,10,67%
0040,BRIGHTON 27J,6395,NORTHEAST ELEMENTARY SCHOOL,1ST,1,0,0,55,40,96,56,58%
0040,BRIGHTON 27J,6395,NORTHEAST ELEMENTARY SCHOOL,2ND,1,1,3,61,31,97,66,68%
0040,BRIGHTON 27J,6395,NORTHEAST ELEMENTARY SCHOOL,3RD,1,0,3,55,47,106,59,56%
0040,BRIGHTON 27J,6395,NORTHEAST ELEMENTARY SCHOOL,4TH,0,0,2,69,45,116,71,61%
0040,BRIGHTON 27J,6395,NORTHEAST ELEMENTARY SCHOOL,5TH,2,0,1,55,41,99,58,59%
0040,BRIGHTON 27J,6395,NORTHEAST ELEMENTARY SCHOOL,SCHOOL TOTAL,5,1,11,355,252,624,372,60%
0040,BRIGHTON 27J,6638,OVERLAND TRAIL MIDDLE SCHOOL,6TH,8,5,1,119,108,241,133,55%
0040,BRIGHTON 27J,6638,OVERLAND TRAIL MIDDLE SCHOOL,7TH,3,3,0,110,92,208,116,56%
0040,BRIGHTON 27J,6638,OVERLAND TRAIL MIDDLE SCHOOL,8TH,2,7,3,114,107,233,126,54%
0040,BRIGHTON 27J,6638,OVERLAND TRAIL MIDDLE SCHOOL,SCHOOL TOTAL,13,15,4,343,307,682,375,55%
0040,BRIGHTON 27J,6702,OTHO E STUART MIDDLE SCHOOL,6TH,1,14,10,64,88,177,89,50%
0040,BRIGHTON 27J,6702,OTHO E STUART MIDDLE SCHOOL,7TH,6,12,9,59,78,164,86,52%
0040,BRIGHTON 27J,6702,OTHO E STUART MIDDLE SCHOOL,8TH,2,5,11,68,62,148,86,58%
0040,BRIGHTON 27J,6702,OTHO E STUART MIDDLE SCHOOL,SCHOOL TOTAL,9,31,30,191,228,489,261,53%
0040,BRIGHTON 27J,7129,PRAIRIE VIEW HIGH SCHOOL,9TH,2,30,21,177,241,471,230,49%
0040,BRIGHTON 27J,7129,PRAIRIE VIEW HIGH SCHOOL,10TH,2,17,26,154,190,389,199,51%
0040,BRIGHTON 27J,7129,PRAIRIE VIEW HIGH SCHOOL,11TH,4,25,20,119,144,312,168,54%
0040,BRIGHTON 27J,7129,PRAIRIE VIEW HIGH SCHOOL,12TH,5,15,16,107,140,283,143,51%
0040,BRIGHTON 27J,7129,PRAIRIE VIEW HIGH SCHOOL,SCHOOL TOTAL,13,87,83,557,715,1455,740,51%
0040,BRIGHTON 27J,7131,PRAIRIE VIEW MIDDLE SCHOOL,6TH,4,13,6,104,124,251,127,51%
0040,BRIGHTON 27J,7131,PRAIRIE VIEW MIDDLE SCHOOL,7TH,3,17,4,96,132,252,120,48%
0040,BRIGHTON 27J,7131,PRAIRIE VIEW MIDDLE SCHOOL,8TH,2,11,9,100,151,273,122,45%
0040,BRIGHTON 27J,7131,PRAIRIE VIEW MIDDLE SCHOOL,SCHOOL TOTAL,9,41,19,300,407,776,369,48%
0040,BRIGHTON 27J,7714,SECOND CREEK ELEMENTARY SCHOOL,HALF DAY K,0,7,5,27,54,93,39,42%
0040,BRIGHTON 27J,7714,SECOND CREEK ELEMENTARY SCHOOL,1ST,0,7,4,33,55,99,44,44%
0040,BRIGHTON 27J,7714,SECOND CREEK ELEMENTARY SCHOOL,2ND,1,10,7,28,50,96,46,48%
0040,BRIGHTON 27J,7714,SECOND CREEK ELEMENTARY SCHOOL,3RD,1,4,5,32,52,94,42,45%
0040,BRIGHTON 27J,7714,SECOND CREEK ELEMENTARY SCHOOL,4TH,1,2,10,38,49,100,51,51%
0040,BRIGHTON 27J,7714,SECOND CREEK ELEMENTARY SCHOOL,5TH,2,5,7,42,41,97,56,58%
0040,BRIGHTON 27J,7714,SECOND CREEK ELEMENTARY SCHOOL,SCHOOL TOTAL,5,35,38,200,301,579,278,48%
0040,BRIGHTON 27J,7725,SD 27J PRESCHOOL AT THE BRIGHTON LRC,PK,1,0,2,67,46,116,70,60%
0040,BRIGHTON 27J,7725,SD 27J PRESCHOOL AT THE BRIGHTON LRC,SCHOOL TOTAL,1,0,2,67,46,116,70,60%
0040,BRIGHTON 27J,8032,JOHN W THIMMIG ELEMENTARY SCHOOL,HALF DAY K,0,5,1,38,51,95,44,46%
0040,BRIGHTON 27J,8032,JOHN W THIMMIG ELEMENTARY SCHOOL,1ST,2,3,1,39,54,99,45,45%
0040,BRIGHTON 27J,8032,JOHN W THIMMIG ELEMENTARY SCHOOL,2ND,1,4,3,42,56,106,50,47%
0040,BRIGHTON 27J,8032,JOHN W THIMMIG ELEMENTARY SCHOOL,3RD,2,3,1,49,50,105,55,52%
0040,BRIGHTON 27J,8032,JOHN W THIMMIG ELEMENTARY SCHOOL,4TH,0,1,0,55,41,97,56,58%
0040,BRIGHTON 27J,8032,JOHN W THIMMIG ELEMENTARY SCHOOL,5TH,0,3,1,41,47,92,45,49%
0040,BRIGHTON 27J,8032,JOHN W THIMMIG ELEMENTARY SCHOOL,SCHOOL TOTAL,5,19,7,264,299,594,295,50%
0040,BRIGHTON 27J,8060,SOUTH ELEMENTARY SCHOOL,HALF DAY K,0,0,1,51,27,79,52,66%
0040,BRIGHTON 27J,8060,SOUTH ELEMENTARY SCHOOL,KINDERGARTEN,0,0,0,25,0,25,25,100%
0040,BRIGHTON 27J,8060,SOUTH ELEMENTARY SCHOOL,1ST,0,1,0,82,31,114,83,73%
0040,BRIGHTON 27J,8060,SOUTH ELEMENTARY SCHOOL,2ND,0,1,2,61,20,84,64,76%
0040,BRIGHTON 27J,8060,SOUTH ELEMENTARY SCHOOL,3RD,1,2,1,69,27,100,73,73%
0040,BRIGHTON 27J,8060,SOUTH ELEMENTARY SCHOOL,4TH,1,0,0,59,33,93,60,65%
0040,BRIGHTON 27J,8060,SOUTH ELEMENTARY SCHOOL,5TH,1,1,0,82,21,105,84,80%
0040,BRIGHTON 27J,8060,SOUTH ELEMENTARY SCHOOL,SCHOOL TOTAL,3,5,4,429,159,600,441,74%
0040,BRIGHTON 27J,8130,SOUTHEAST ELEMENTARY SCHOOL,PK,0,2,2,27,25,56,31,55%
0040,BRIGHTON 27J,8130,SOUTHEAST ELEMENTARY SCHOOL,HALF DAY K,0,1,4,54,60,119,59,50%
0040,BRIGHTON 27J,8130,SOUTHEAST ELEMENTARY SCHOOL,1ST,3,2,4,55,48,112,64,57%
0040,BRIGHTON 27J,8130,SOUTHEAST ELEMENTARY SCHOOL,2ND,2,3,4,52,57,118,61,52%
0040,BRIGHTON 27J,8130,SOUTHEAST ELEMENTARY SCHOOL,3RD,0,2,3,43,65,113,48,42%
0040,BRIGHTON 27J,8130,SOUTHEAST ELEMENTARY SCHOOL,4TH,0,0,4,62,49,115,66,57%
0040,BRIGHTON 27J,8130,SOUTHEAST ELEMENTARY SCHOOL,5TH,0,0,0,50,56,106,50,47%
0040,BRIGHTON 27J,8130,SOUTHEAST ELEMENTARY SCHOOL,SCHOOL TOTAL,5,10,21,343,360,739,379,51%
0040,BRIGHTON 27J,8820,TURNBERRY ELEMENTARY,PK,0,0,4,20,35,59,24,41%
0040,BRIGHTON 27J,8820,TURNBERRY ELEMENTARY,HALF DAY K,1,3,11,34,77,126,49,39%
0040,BRIGHTON 27J,8820,TURNBERRY ELEMENTARY,1ST,4,10,8,35,70,127,57,45%
0040,BRIGHTON 27J,8820,TURNBERRY ELEMENTARY,2ND,5,5,8,35,48,101,53,52%
0040,BRIGHTON 27J,8820,TURNBERRY ELEMENTARY,3RD,3,2,7,30,56,98,42,43%
0040,BRIGHTON 27J,8820,TURNBERRY ELEMENTARY,4TH,3,6,5,25,35,74,39,53%
0040,BRIGHTON 27J,8820,TURNBERRY ELEMENTARY,5TH,2,2,5,21,48,78,30,38%
0040,BRIGHTON 27J,8820,TURNBERRY ELEMENTARY,SCHOOL TOTAL,18,28,48,200,369,663,294,44%
0040,BRIGHTON 27J,9230,VIKAN MIDDLE SCHOOL,6TH,2,2,4,112,76,196,120,61%
0040,BRIGHTON 27J,9230,VIKAN MIDDLE SCHOOL,7TH,1,1,4,121,79,206,127,62%
0040,BRIGHTON 27J,9230,VIKAN MIDDLE SCHOOL,8TH,2,1,2,101,84,190,106,56%
0040,BRIGHTON 27J,9230,VIKAN MIDDLE SCHOOL,SCHOOL TOTAL,5,4,10,334,239,592,353,60%
0040,BRIGHTON 27J,9426,WEST RIDGE ELEMENTARY,PK,1,9,3,12,33,58,25,43%
0040,BRIGHTON 27J,9426,WEST RIDGE ELEMENTARY,HALF DAY K,5,8,2,33,95,143,48,34%
0040,BRIGHTON 27J,9426,WEST RIDGE ELEMENTARY,1ST,1,17,5,17,90,130,40,31%
0040,BRIGHTON 27J,9426,WEST RIDGE ELEMENTARY,2ND,1,16,3,21,71,112,41,37%
0040,BRIGHTON 27J,9426,WEST RIDGE ELEMENTARY,3RD,0,15,1,18,58,92,34,37%
0040,BRIGHTON 27J,9426,WEST RIDGE ELEMENTARY,4TH,0,3,3,17,57,80,23,29%
0040,BRIGHTON 27J,9426,WEST RIDGE ELEMENTARY,5TH,0,13,4,26,54,97,43,44%
0040,BRIGHTON 27J,9426,WEST RIDGE ELEMENTARY,SCHOOL TOTAL,8,81,21,144,458,712,254,36%
0040,BRIGHTON 27J,,DISTRICT TOTAL,,162,519,425,6081,7282,14469,7187,50%
0050,BENNETT 29J,0763,BENNETT PRESCHOOL,PK,1,1,0,12,45,59,14,24%
0050,BENNETT 29J,0763,BENNETT PRESCHOOL,SCHOOL TOTAL,1,1,0,12,45,59,14,24%
0050,BENNETT 29J,0770,BENNETT ELEMENTARY SCHOOL,HALF DAY K,0,0,1,7,52,60,8,13%
0050,BENNETT 29J,0770,BENNETT ELEMENTARY SCHOOL,1ST,0,1,0,11,57,69,12,17%
0050,BENNETT 29J,0770,BENNETT ELEMENTARY SCHOOL,2ND,0,0,0,8,77,85,8,9%
0050,BENNETT 29J,0770,BENNETT ELEMENTARY SCHOOL,3RD,1,0,0,10,45,56,11,20%
0050,BENNETT 29J,0770,BENNETT ELEMENTARY SCHOOL,4TH,0,1,0,20,60,81,21,26%
0050,BENNETT 29J,0770,BENNETT ELEMENTARY SCHOOL,5TH,0,1,2,10,57,70,13,19%
0050,BENNETT 29J,0770,BENNETT ELEMENTARY SCHOOL,SCHOOL TOTAL,1,3,3,66,348,421,73,17%
0050,BENNETT 29J,0774,BENNETT MIDDLE SCHOOL,6TH,2,2,1,13,48,66,18,27%
0050,BENNETT 29J,0774,BENNETT MIDDLE SCHOOL,7TH,0,1,0,12,50,63,13,21%
0050,BENNETT 29J,0774,BENNETT MIDDLE SCHOOL,8TH,2,0,0,11,50,63,13,21%
0050,BENNETT 29J,0774,BENNETT MIDDLE SCHOOL,SCHOOL TOTAL,4,3,1,36,148,192,44,23%
0050,BENNETT 29J,0775,BENNETT HIGH SCHOOL,9TH,0,0,1,16,65,82,17,21%
0050,BENNETT 29J,0775,BENNETT HIGH SCHOOL,10TH,2,1,0,12,76,91,15,16%
0050,BENNETT 29J,0775,BENNETT HIGH SCHOOL,11TH,1,0,1,16,73,91,18,20%
0050,BENNETT 29J,0775,BENNETT HIGH SCHOOL,12TH,1,0,0,9,66,76,10,13%
0050,BENNETT 29J,0775,BENNETT HIGH SCHOOL,SCHOOL TOTAL,4,1,2,53,280,340,60,18%
0050,BENNETT 29J,1889,CORRIDOR COMMUNITY ACADEMY,HALF DAY K,1,0,0,2,15,18,3,17%
0050,BENNETT 29J,1889,CORRIDOR COMMUNITY ACADEMY,1ST,0,0,0,2,15,17,2,12%
0050,BENNETT 29J,1889,CORRIDOR COMMUNITY ACADEMY,2ND,0,0,0,0,15,15,0,0%
0050,BENNETT 29J,1889,CORRIDOR COMMUNITY ACADEMY,3RD,1,0,0,0,17,18,1,6%
0050,BENNETT 29J,1889,CORRIDOR COMMUNITY ACADEMY,4TH,1,0,0,0,16,17,1,6%
0050,BENNETT 29J,1889,CORRIDOR COMMUNITY ACADEMY,5TH,1,0,0,0,11,12,1,8%
0050,BENNETT 29J,1889,CORRIDOR COMMUNITY ACADEMY,6TH,0,0,0,0,6,6,0,0%
0050,BENNETT 29J,1889,CORRIDOR COMMUNITY ACADEMY,7TH,0,0,0,0,11,11,0,0%
0050,BENNETT 29J,1889,CORRIDOR COMMUNITY ACADEMY,8TH,0,0,0,0,1,1,0,0%
0050,BENNETT 29J,1889,CORRIDOR COMMUNITY ACADEMY,SCHOOL TOTAL,4,0,0,4,107,115,8,7%
0050,BENNETT 29J,,DISTRICT TOTAL,,14,8,6,171,928,1127,199,18%
0060,STRASBURG 31J,7133,PRAIRIE CREEKS CHARTER SCHOOL,11TH,0,0,0,0,1,1,0,0%
0060,STRASBURG 31J,7133,PRAIRIE CREEKS CHARTER SCHOOL,12TH,0,0,0,0,3,3,0,0%
0060,STRASBURG 31J,7133,PRAIRIE CREEKS CHARTER SCHOOL,SCHOOL TOTAL,0,0,0,0,4,4,0,0%
0060,STRASBURG 31J,8328,STRASBURG ELEMENTARY SCHOOL,PK,1,1,0,8,65,75,10,13%
0060,STRASBURG 31J,8328,STRASBURG ELEMENTARY SCHOOL,KINDERGARTEN,2,0,1,5,48,56,8,14%
0060,STRASBURG 31J,8328,STRASBURG ELEMENTARY SCHOOL,1ST,0,1,1,10,56,68,12,18%
0060,STRASBURG 31J,8328,STRASBURG ELEMENTARY SCHOOL,2ND,0,0,1,5,60,66,6,9%
0060,STRASBURG 31J,8328,STRASBURG ELEMENTARY SCHOOL,3RD,1,0,1,8,60,70,10,14%
0060,STRASBURG 31J,8328,STRASBURG ELEMENTARY SCHOOL,4TH,0,1,2,5,56,64,8,13%
0060,STRASBURG 31J,8328,STRASBURG ELEMENTARY SCHOOL,5TH,0,1,0,5,70,76,6,8%
0060,STRASBURG 31J,8328,STRASBURG ELEMENTARY SCHOOL,SCHOOL TOTAL,4,4,6,46,415,475,60,13%
0060,STRASBURG 31J,8332,HEMPHILL MIDDLE SCHOOL,6TH,0,3,3,10,71,87,16,18%
0060,STRASBURG 31J,8332,HEMPHILL MIDDLE SCHOOL,7TH,0,2,0,12,70,84,14,17%
0060,STRASBURG 31J,8332,HEMPHILL MIDDLE SCHOOL,8TH,1,1,4,7,71,84,13,15%
0060,STRASBURG 31J,8332,HEMPHILL MIDDLE SCHOOL,SCHOOL TOTAL,1,6,7,29,212,255,43,17%
0060,STRASBURG 31J,8334,STRASBURG HIGH SCHOOL,9TH,0,2,0,6,57,65,8,12%
0060,STRASBURG 31J,8334,STRASBURG HIGH SCHOOL,10TH,1,2,3,6,82,94,12,13%
0060,STRASBURG 31J,8334,STRASBURG HIGH SCHOOL,11TH,0,3,1,5,71,80,9,11%
0060,STRASBURG 31J,8334,STRASBURG HIGH SCHOOL,12TH,0,1,0,7,60,68,8,12%
0060,STRASBURG 31J,8334,STRASBURG HIGH SCHOOL,SCHOOL TOTAL,1,8,4,24,270,307,37,12%
0060,STRASBURG 31J,,DISTRICT TOTAL,,6,18,17,99,901,1041,140,13%
0070,WESTMINSTER 50,0000,NOT IN A SCHOOL,8TH,0,0,0,1,0,1,1,100%
0070,WESTMINSTER 50,0000,NOT IN A SCHOOL,11TH,0,1,0,0,0,1,1,100%
0070,WESTMINSTER 50,0000,NOT IN A SCHOOL,SCHOOL TOTAL,0,1,0,1,0,2,2,100%
0070,WESTMINSTER 50,1622,CLARA E. METZ ELEMENTARY SCHOOL,KINDERGARTEN,0,2,1,57,9,69,60,87%
0070,WESTMINSTER 50,1622,CLARA E. METZ ELEMENTARY SCHOOL,1ST,3,2,3,61,13,82,69,84%
0070,WESTMINSTER 50,1622,CLARA E. METZ ELEMENTARY SCHOOL,2ND,1,2,2,45,8,58,50,86%
0070,WESTMINSTER 50,1622,CLARA E. METZ ELEMENTARY SCHOOL,3RD,1,3,4,63,8,79,71,90%
0070,WESTMINSTER 50,1622,CLARA E. METZ ELEMENTARY SCHOOL,4TH,1,4,2,55,9,71,62,87%
0070,WESTMINSTER 50,1622,CLARA E. METZ ELEMENTARY SCHOOL,5TH,1,1,1,58,10,71,61,86%
0070,WESTMINSTER 50,1622,CLARA E. METZ ELEMENTARY SCHOOL,SCHOOL TOTAL,7,14,13,339,57,430,373,87%
0070,WESTMINSTER 50,1666,CLEAR LAKE MIDDLE SCHOOL,6TH,1,17,8,188,46,260,214,82%
0070,WESTMINSTER 50,1666,CLEAR LAKE MIDDLE SCHOOL,7TH,2,12,6,213,38,271,233,86%
0070,WESTMINSTER 50,1666,CLEAR LAKE MIDDLE SCHOOL,8TH,2,19,5,152,40,218,178,82%
0070,WESTMINSTER 50,1666,CLEAR LAKE MIDDLE SCHOOL,SCHOOL TOTAL,5,48,19,553,124,749,625,83%
0070,WESTMINSTER 50,2035,CROWN POINTE CHARTER ACADEMY,KINDERGARTEN,1,0,1,30,20,52,32,62%
0070,WESTMINSTER 50,2035,CROWN POINTE CHARTER ACADEMY,1ST,0,6,0,25,21,52,31,60%
0070,WESTMINSTER 50,2035,CROWN POINTE CHARTER ACADEMY,2ND,2,1,0,21,28,52,24,46%
0070,WESTMINSTER 50,2035,CROWN POINTE CHARTER ACADEMY,3RD,0,1,1,25,25,52,27,52%
0070,WESTMINSTER 50,2035,CROWN POINTE CHARTER ACADEMY,4TH,0,1,0,13,12,26,14,54%
0070,WESTMINSTER 50,2035,CROWN POINTE CHARTER ACADEMY,5TH,0,0,0,11,15,26,11,42%
0070,WESTMINSTER 50,2035,CROWN POINTE CHARTER ACADEMY,6TH,0,3,0,10,17,30,13,43%
0070,WESTMINSTER 50,2035,CROWN POINTE CHARTER ACADEMY,7TH,0,3,0,6,17,26,9,35%
0070,WESTMINSTER 50,2035,CROWN POINTE CHARTER ACADEMY,8TH,0,0,4,5,14,23,9,39%
0070,WESTMINSTER 50,2035,CROWN POINTE CHARTER ACADEMY,SCHOOL TOTAL,3,15,6,146,169,339,170,50%
0070,WESTMINSTER 50,2876,FAIRVIEW ELEMENTARY SCHOOL,KINDERGARTEN,0,5,1,47,6,59,53,90%
0070,WESTMINSTER 50,2876,FAIRVIEW ELEMENTARY SCHOOL,1ST,0,1,1,54,7,63,56,89%
0070,WESTMINSTER 50,2876,FAIRVIEW ELEMENTARY SCHOOL,2ND,1,2,0,58,7,68,61,90%
0070,WESTMINSTER 50,2876,FAIRVIEW ELEMENTARY SCHOOL,3RD,1,3,0,38,6,48,42,88%
0070,WESTMINSTER 50,2876,FAIRVIEW ELEMENTARY SCHOOL,4TH,0,6,0,39,4,49,45,92%
0070,WESTMINSTER 50,2876,FAIRVIEW ELEMENTARY SCHOOL,5TH,0,4,1,43,8,56,48,86%
0070,WESTMINSTER 50,2876,FAIRVIEW ELEMENTARY SCHOOL,SCHOOL TOTAL,2,21,3,279,38,343,305,89%
0070,WESTMINSTER 50,3144,FRANCIS M. DAY ELEMENTARY SCHOOL,PK,0,1,1,27,1,30,29,97%
0070,WESTMINSTER 50,3144,FRANCIS M. DAY ELEMENTARY SCHOOL,KINDERGARTEN,0,3,0,46,5,54,49,91%
0070,WESTMINSTER 50,3144,FRANCIS M. DAY ELEMENTARY SCHOOL,1ST,0,1,0,57,4,62,58,94%
0070,WESTMINSTER 50,3144,FRANCIS M. DAY ELEMENTARY SCHOOL,2ND,0,3,0,43,4,50,46,92%
0070,WESTMINSTER 50,3144,FRANCIS M. DAY ELEMENTARY SCHOOL,3RD,0,4,1,44,2,51,49,96%
0070,WESTMINSTER 50,3144,FRANCIS M. DAY ELEMENTARY SCHOOL,4TH,0,1,1,55,6,63,57,90%
0070,WESTMINSTER 50,3144,FRANCIS M. DAY ELEMENTARY SCHOOL,5TH,0,1,0,25,5,31,26,84%
0070,WESTMINSTER 50,3144,FRANCIS M. DAY ELEMENTARY SCHOOL,SCHOOL TOTAL,0,14,3,297,27,341,314,92%
0070,WESTMINSTER 50,3649,GREGORY HILL PRESCHOOL,PK,1,17,6,253,64,341,277,81%
0070,WESTMINSTER 50,3649,GREGORY HILL PRESCHOOL,SCHOOL TOTAL,1,17,6,253,64,341,277,81%
0070,WESTMINSTER 50,3792,HARRIS PARK ELEMENTARY SCHOOL,KINDERGARTEN,2,3,3,45,18,71,53,75%
0070,WESTMINSTER 50,3792,HARRIS PARK ELEMENTARY SCHOOL,1ST,1,6,1,37,23,68,45,66%
0070,WESTMINSTER 50,3792,HARRIS PARK ELEMENTARY SCHOOL,2ND,0,6,3,34,18,61,43,70%
0070,WESTMINSTER 50,3792,HARRIS PARK ELEMENTARY SCHOOL,3RD,0,5,0,49,10,64,54,84%
0070,WESTMINSTER 50,3792,HARRIS PARK ELEMENTARY SCHOOL,4TH,1,6,2,44,24,77,53,69%
0070,WESTMINSTER 50,3792,HARRIS PARK ELEMENTARY SCHOOL,5TH,2,2,1,42,11,58,47,81%
0070,WESTMINSTER 50,3792,HARRIS PARK ELEMENTARY SCHOOL,SCHOOL TOTAL,6,28,10,251,104,399,295,74%
0070,WESTMINSTER 50,3931,HIDDEN LAKE HIGH SCHOOL,9TH,1,2,0,44,8,55,47,85%
0070,WESTMINSTER 50,3931,HIDDEN LAKE HIGH SCHOOL,10TH,2,1,1,56,28,88,60,68%
0070,WESTMINSTER 50,3931,HIDDEN LAKE HIGH SCHOOL,11TH,1,1,0,42,26,70,44,63%
0070,WESTMINSTER 50,3931,HIDDEN LAKE HIGH SCHOOL,12TH,1,6,1,50,30,88,58,66%
0070,WESTMINSTER 50,3931,HIDDEN LAKE HIGH SCHOOL,SCHOOL TOTAL,5,10,2,192,92,301,209,69%
0070,WESTMINSTER 50,4326,IVER C. RANUM HIGH SCHOOL,12TH,1,16,5,110,68,200,132,66%
0070,WESTMINSTER 50,4326,IVER C. RANUM HIGH SCHOOL,SCHOOL TOTAL,1,16,5,110,68,200,132,66%
0070,WESTMINSTER 50,4465,JOSEPHINE HODGKINS ELEMENTARY SCHOOL,PK,1,2,0,76,10,89,79,89%
0070,WESTMINSTER 50,4465,JOSEPHINE HODGKINS ELEMENTARY SCHOOL,KINDERGARTEN,1,6,4,92,23,126,103,82%
0070,WESTMINSTER 50,4465,JOSEPHINE HODGKINS ELEMENTARY SCHOOL,1ST,0,2,1,96,15,114,99,87%
0070,WESTMINSTER 50,4465,JOSEPHINE HODGKINS ELEMENTARY SCHOOL,2ND,0,1,0,84,11,96,85,89%
0070,WESTMINSTER 50,4465,JOSEPHINE HODGKINS ELEMENTARY SCHOOL,3RD,1,3,3,100,15,122,107,88%
0070,WESTMINSTER 50,4465,JOSEPHINE HODGKINS ELEMENTARY SCHOOL,4TH,2,1,2,85,10,100,90,90%
0070,WESTMINSTER 50,4465,JOSEPHINE HODGKINS ELEMENTARY SCHOOL,5TH,0,2,2,81,11,96,85,89%
0070,WESTMINSTER 50,4465,JOSEPHINE HODGKINS ELEMENTARY SCHOOL,SCHOOL TOTAL,5,17,12,614,95,743,648,87%
0070,WESTMINSTER 50,5388,M. SCOTT CARPENTER MIDDLE SCHOOL,6TH,5,6,1,165,26,203,177,87%
0070,WESTMINSTER 50,5388,M. SCOTT CARPENTER MIDDLE SCHOOL,7TH,2,8,2,153,16,181,165,91%
0070,WESTMINSTER 50,5388,M. SCOTT CARPENTER MIDDLE SCHOOL,8TH,1,1,6,181,20,209,189,90%
0070,WESTMINSTER 50,5388,M. SCOTT CARPENTER MIDDLE SCHOOL,SCHOOL TOTAL,8,15,9,499,62,593,531,90%
0070,WESTMINSTER 50,5834,MESA ELEMENTARY SCHOOL,KINDERGARTEN,1,9,2,37,12,61,49,80%
0070,WESTMINSTER 50,5834,MESA ELEMENTARY SCHOOL,1ST,1,8,4,45,17,75,58,77%
0070,WESTMINSTER 50,5834,MESA ELEMENTARY SCHOOL,2ND,0,5,0,44,19,68,49,72%
0070,WESTMINSTER 50,5834,MESA ELEMENTARY SCHOOL,3RD,0,5,2,44,19,70,51,73%
0070,WESTMINSTER 50,5834,MESA ELEMENTARY SCHOOL,4TH,0,9,3,44,20,76,56,74%
0070,WESTMINSTER 50,5834,MESA ELEMENTARY SCHOOL,5TH,0,4,1,36,24,65,41,63%
0070,WESTMINSTER 50,5834,MESA ELEMENTARY SCHOOL,SCHOOL TOTAL,2,40,12,250,111,415,304,73%
0070,WESTMINSTER 50,7810,FLYNN ELEMENTARY SCHOOL,HALF DAY K,0,5,0,23,10,38,28,74%
0070,WESTMINSTER 50,7810,FLYNN ELEMENTARY SCHOOL,KINDERGARTEN,0,1,0,15,9,25,16,64%
0070,WESTMINSTER 50,7810,FLYNN ELEMENTARY SCHOOL,1ST,0,3,1,33,18,55,37,67%
0070,WESTMINSTER 50,7810,FLYNN ELEMENTARY SCHOOL,2ND,0,4,1,34,23,62,39,63%
0070,WESTMINSTER 50,7810,FLYNN ELEMENTARY SCHOOL,3RD,0,5,1,46,28,80,52,65%
0070,WESTMINSTER 50,7810,FLYNN ELEMENTARY SCHOOL,4TH,0,4,1,34,27,66,39,59%
0070,WESTMINSTER 50,7810,FLYNN ELEMENTARY SCHOOL,5TH,0,6,3,39,33,81,48,59%
0070,WESTMINSTER 50,7810,FLYNN ELEMENTARY SCHOOL,SCHOOL TOTAL,0,28,7,224,148,407,259,64%
0070,WESTMINSTER 50,7812,SHAW HEIGHTS MIDDLE SCHOOL,6TH,4,13,5,132,68,222,154,69%
0070,WESTMINSTER 50,7812,SHAW HEIGHTS MIDDLE SCHOOL,7TH,6,14,0,130,75,225,150,67%
0070,WESTMINSTER 50,7812,SHAW HEIGHTS MIDDLE SCHOOL,8TH,3,13,5,120,86,227,141,62%
0070,WESTMINSTER 50,7812,SHAW HEIGHTS MIDDLE SCHOOL,SCHOOL TOTAL,13,40,10,382,229,674,445,66%
0070,WESTMINSTER 50,7860,SHERRELWOOD ELEMENTARY SCHOOL,KINDERGARTEN,0,3,0,44,5,52,47,90%
0070,WESTMINSTER 50,7860,SHERRELWOOD ELEMENTARY SCHOOL,1ST,0,2,0,29,10,41,31,76%
0070,WESTMINSTER 50,7860,SHERRELWOOD ELEMENTARY SCHOOL,2ND,0,1,0,39,6,46,40,87%
0070,WESTMINSTER 50,7860,SHERRELWOOD ELEMENTARY SCHOOL,3RD,0,0,0,38,6,44,38,86%
0070,WESTMINSTER 50,7860,SHERRELWOOD ELEMENTARY SCHOOL,4TH,0,0,0,44,9,53,44,83%
0070,WESTMINSTER 50,7860,SHERRELWOOD ELEMENTARY SCHOOL,5TH,1,1,3,34,6,45,39,87%
0070,WESTMINSTER 50,7860,SHERRELWOOD ELEMENTARY SCHOOL,SCHOOL TOTAL,1,7,3,228,42,281,239,85%
0070,WESTMINSTER 50,7952,SKYLINE VISTA ELEMENTARY SCHOOL,PK,0,4,0,26,1,31,30,97%
0070,WESTMINSTER 50,7952,SKYLINE VISTA ELEMENTARY SCHOOL,KINDERGARTEN,1,6,0,59,8,74,66,89%
0070,WESTMINSTER 50,7952,SKYLINE VISTA ELEMENTARY SCHOOL,1ST,1,5,0,45,6,57,51,89%
0070,WESTMINSTER 50,7952,SKYLINE VISTA ELEMENTARY SCHOOL,2ND,0,3,0,57,9,69,60,87%
0070,WESTMINSTER 50,7952,SKYLINE VISTA ELEMENTARY SCHOOL,3RD,1,4,0,38,4,47,43,91%
0070,WESTMINSTER 50,7952,SKYLINE VISTA ELEMENTARY SCHOOL,4TH,0,2,0,51,6,59,53,90%
0070,WESTMINSTER 50,7952,SKYLINE VISTA ELEMENTARY SCHOOL,5TH,1,2,0,42,7,52,45,87%
0070,WESTMINSTER 50,7952,SKYLINE VISTA ELEMENTARY SCHOOL,SCHOOL TOTAL,4,26,0,318,41,389,348,89%
0070,WESTMINSTER 50,8406,SUNSET RIDGE ELEMENTARY SCHOOL,HALF DAY K,0,1,1,24,16,42,26,62%
0070,WESTMINSTER 50,8406,SUNSET RIDGE ELEMENTARY SCHOOL,KINDERGARTEN,0,0,0,21,6,27,21,78%
0070,WESTMINSTER 50,8406,SUNSET RIDGE ELEMENTARY SCHOOL,1ST,1,0,1,41,11,54,43,80%
0070,WESTMINSTER 50,8406,SUNSET RIDGE ELEMENTARY SCHOOL,2ND,0,3,1,37,19,60,41,68%
0070,WESTMINSTER 50,8406,SUNSET RIDGE ELEMENTARY SCHOOL,3RD,5,3,3,29,20,60,40,67%
0070,WESTMINSTER 50,8406,SUNSET RIDGE ELEMENTARY SCHOOL,4TH,1,3,0,41,20,65,45,69%
0070,WESTMINSTER 50,8406,SUNSET RIDGE ELEMENTARY SCHOOL,5TH,0,0,0,43,22,65,43,66%
0070,WESTMINSTER 50,8406,SUNSET RIDGE ELEMENTARY SCHOOL,SCHOOL TOTAL,7,10,6,236,114,373,259,69%
0070,WESTMINSTER 50,8798,TENNYSON KNOLLS ELEMENTARY SCHOOL,KINDERGARTEN,2,10,3,59,14,88,74,84%
0070,WESTMINSTER 50,8798,TENNYSON KNOLLS ELEMENTARY SCHOOL,1ST,1,8,2,40,12,63,51,81%
0070,WESTMINSTER 50,8798,TENNYSON KNOLLS ELEMENTARY SCHOOL,2ND,2,3,3,50,16,74,58,78%
0070,WESTMINSTER 50,8798,TENNYSON KNOLLS ELEMENTARY SCHOOL,3RD,2,4,1,51,9,67,58,87%
0070,WESTMINSTER 50,8798,TENNYSON KNOLLS ELEMENTARY SCHOOL,4TH,3,10,0,47,16,76,60,79%
0070,WESTMINSTER 50,8798,TENNYSON KNOLLS ELEMENTARY SCHOOL,5TH,0,6,3,45,9,63,54,86%
0070,WESTMINSTER 50,8798,TENNYSON KNOLLS ELEMENTARY SCHOOL,SCHOOL TOTAL,10,41,12,292,76,431,355,82%
0070,WESTMINSTER 50,9462,WESTMINSTER ELEMENTARY SCHOOL,KINDERGARTEN,1,0,1,22,4,28,24,86%
0070,WESTMINSTER 50,9462,WESTMINSTER ELEMENTARY SCHOOL,1ST,1,2,0,24,6,33,27,82%
0070,WESTMINSTER 50,9462,WESTMINSTER ELEMENTARY SCHOOL,2ND,0,1,2,24,9,36,27,75%
0070,WESTMINSTER 50,9462,WESTMINSTER ELEMENTARY SCHOOL,3RD,1,0,2,19,7,29,22,76%
0070,WESTMINSTER 50,9462,WESTMINSTER ELEMENTARY SCHOOL,4TH,0,1,1,30,5,37,32,86%
0070,WESTMINSTER 50,9462,WESTMINSTER ELEMENTARY SCHOOL,5TH,2,1,1,31,4,39,35,90%
0070,WESTMINSTER 50,9462,WESTMINSTER ELEMENTARY SCHOOL,SCHOOL TOTAL,5,5,7,150,35,202,167,83%
0070,WESTMINSTER 50,9466,WESTMINSTER HIGH SCHOOL,9TH,7,45,25,587,167,831,664,80%
0070,WESTMINSTER 50,9466,WESTMINSTER HIGH SCHOOL,10TH,8,46,10,286,106,456,350,77%
0070,WESTMINSTER 50,9466,WESTMINSTER HIGH SCHOOL,11TH,5,43,5,259,116,428,312,73%
0070,WESTMINSTER 50,9466,WESTMINSTER HIGH SCHOOL,12TH,2,31,5,91,65,194,129,66%
0070,WESTMINSTER 50,9466,WESTMINSTER HIGH SCHOOL,SCHOOL TOTAL,22,165,45,1223,454,1909,1455,76%
0070,WESTMINSTER 50,,DISTRICT TOTAL,,107,578,190,6837,2150,9862,7712,78%
0100,ALAMOSA RE-11J,0114,ORTEGA MIDDLE SCHOOL,6TH,0,0,1,105,73,179,106,59%
0100,ALAMOSA RE-11J,0114,ORTEGA MIDDLE SCHOOL,7TH,1,0,0,91,47,139,92,66%
0100,ALAMOSA RE-11J,0114,ORTEGA MIDDLE SCHOOL,8TH,2,0,2,87,50,141,91,65%
0100,ALAMOSA RE-11J,0114,ORTEGA MIDDLE SCHOOL,SCHOOL TOTAL,3,0,3,283,170,459,289,63%
0100,ALAMOSA RE-11J,0118,ALAMOSA HIGH SCHOOL,9TH,2,2,1,106,78,189,111,59%
0100,ALAMOSA RE-11J,0118,ALAMOSA HIGH SCHOOL,10TH,0,3,0,90,52,145,93,64%
0100,ALAMOSA RE-11J,0118,ALAMOSA HIGH SCHOOL,11TH,1,3,1,79,61,145,84,58%
0100,ALAMOSA RE-11J,0118,ALAMOSA HIGH SCHOOL,12TH,1,1,0,59,59,120,61,51%
0100,ALAMOSA RE-11J,0118,ALAMOSA HIGH SCHOOL,SCHOOL TOTAL,4,9,2,334,250,599,349,58%
0100,ALAMOSA RE-11J,0119,ALAMOSA OPEN SCHOOL,9TH,0,0,0,9,2,11,9,82%
0100,ALAMOSA RE-11J,0119,ALAMOSA OPEN SCHOOL,10TH,0,0,0,5,2,7,5,71%
0100,ALAMOSA RE-11J,0119,ALAMOSA OPEN SCHOOL,11TH,0,0,0,11,4,15,11,73%
0100,ALAMOSA RE-11J,0119,ALAMOSA OPEN SCHOOL,12TH,0,0,0,5,2,7,5,71%
0100,ALAMOSA RE-11J,0119,ALAMOSA OPEN SCHOOL,SCHOOL TOTAL,0,0,0,30,10,40,30,75%
0100,ALAMOSA RE-11J,0944,BOYD ELEMENTARY SCHOOL,2ND,2,1,0,100,48,151,103,68%
0100,ALAMOSA RE-11J,0944,BOYD ELEMENTARY SCHOOL,3RD,0,3,3,110,65,181,116,64%
0100,ALAMOSA RE-11J,0944,BOYD ELEMENTARY SCHOOL,SCHOOL TOTAL,2,4,3,210,113,332,219,66%
0100,ALAMOSA RE-11J,2402,POLSTON ELEMENTARY SCHOOL,KINDERGARTEN,1,0,0,103,50,154,104,68%
0100,ALAMOSA RE-11J,2402,POLSTON ELEMENTARY SCHOOL,1ST,0,1,2,100,56,159,103,65%
0100,ALAMOSA RE-11J,2402,POLSTON ELEMENTARY SCHOOL,SCHOOL TOTAL,1,1,2,203,106,313,207,66%
0100,ALAMOSA RE-11J,2818,EVANS ELEMENTARY SCHOOL,4TH,1,1,1,98,59,160,101,63%
0100,ALAMOSA RE-11J,2818,EVANS ELEMENTARY SCHOOL,5TH,4,3,0,85,51,143,92,64%
0100,ALAMOSA RE-11J,2818,EVANS ELEMENTARY SCHOOL,SCHOOL TOTAL,5,4,1,183,110,303,193,64%
0100,ALAMOSA RE-11J,,DISTRICT TOTAL,,15,18,11,1243,759,2046,1287,63%
0110,SANGRE DE CRISTO RE-22J,7626,SANGRE DE CRISTO ELEMENTARY SCHOOL,PK,0,0,0,7,12,19,7,37%
0110,SANGRE DE CRISTO RE-22J,7626,SANGRE DE CRISTO ELEMENTARY SCHOOL,KINDERGARTEN,1,0,0,10,19,30,11,37%
0110,SANGRE DE CRISTO RE-22J,7626,SANGRE DE CRISTO ELEMENTARY SCHOOL,1ST,0,0,0,6,5,11,6,55%
0110,SANGRE DE CRISTO RE-22J,7626,SANGRE DE CRISTO ELEMENTARY SCHOOL,2ND,0,0,0,12,19,31,12,39%
0110,SANGRE DE CRISTO RE-22J,7626,SANGRE DE CRISTO ELEMENTARY SCHOOL,3RD,0,0,0,6,17,23,6,26%
0110,SANGRE DE CRISTO RE-22J,7626,SANGRE DE CRISTO ELEMENTARY SCHOOL,4TH,0,0,0,7,15,22,7,32%
0110,SANGRE DE CRISTO RE-22J,7626,SANGRE DE CRISTO ELEMENTARY SCHOOL,5TH,0,0,0,6,16,22,6,27%
0110,SANGRE DE CRISTO RE-22J,7626,SANGRE DE CRISTO ELEMENTARY SCHOOL,6TH,0,1,0,8,18,27,9,33%
0110,SANGRE DE CRISTO RE-22J,7626,SANGRE DE CRISTO ELEMENTARY SCHOOL,SCHOOL TOTAL,1,1,0,62,121,185,64,35%
0110,SANGRE DE CRISTO RE-22J,7630,SANGRE DE CRISTO UNDIVIDED HIGH SCHOOL,7TH,0,1,0,6,15,22,7,32%
0110,SANGRE DE CRISTO RE-22J,7630,SANGRE DE CRISTO UNDIVIDED HIGH SCHOOL,8TH,0,0,0,4,20,24,4,17%
0110,SANGRE DE CRISTO RE-22J,7630,SANGRE DE CRISTO UNDIVIDED HIGH SCHOOL,9TH,0,2,0,5,19,26,7,27%
0110,SANGRE DE CRISTO RE-22J,7630,SANGRE DE CRISTO UNDIVIDED HIGH SCHOOL,10TH,2,1,1,5,22,31,9,29%
0110,SANGRE DE CRISTO RE-22J,7630,SANGRE DE CRISTO UNDIVIDED HIGH SCHOOL,11TH,0,1,0,2,19,22,3,14%
0110,SANGRE DE CRISTO RE-22J,7630,SANGRE DE CRISTO UNDIVIDED HIGH SCHOOL,12TH,0,1,1,2,9,13,4,31%
0110,SANGRE DE CRISTO RE-22J,7630,SANGRE DE CRISTO UNDIVIDED HIGH SCHOOL,SCHOOL TOTAL,2,6,2,24,104,138,34,25%
0110,SANGRE DE CRISTO RE-22J,,DISTRICT TOTAL,,3,7,2,86,225,323,98,30%
0120,ENGLEWOOD 1,0206,COLORADO'S FINEST ALTERNATIVE HIGH SCHOOL,9TH,1,1,4,47,60,113,53,47%
0120,ENGLEWOOD 1,0206,COLORADO'S FINEST ALTERNATIVE HIGH SCHOOL,10TH,4,2,8,52,68,134,66,49%
0120,ENGLEWOOD 1,0206,COLORADO'S FINEST ALTERNATIVE HIGH SCHOOL,11TH,8,3,5,41,67,124,57,46%
0120,ENGLEWOOD 1,0206,COLORADO'S FINEST ALTERNATIVE HIGH SCHOOL,12TH,5,1,3,27,63,99,36,36%
0120,ENGLEWOOD 1,0206,COLORADO'S FINEST ALTERNATIVE HIGH SCHOOL,SCHOOL TOTAL,18,7,20,167,258,470,212,45%
0120,ENGLEWOOD 1,1514,CHARLES HAY ELEMENTARY SCHOOL,KINDERGARTEN,2,1,1,20,35,59,24,41%
0120,ENGLEWOOD 1,1514,CHARLES HAY ELEMENTARY SCHOOL,1ST,1,5,1,7,35,49,14,29%
0120,ENGLEWOOD 1,1514,CHARLES HAY ELEMENTARY SCHOOL,2ND,0,1,0,10,22,33,11,33%
0120,ENGLEWOOD 1,1514,CHARLES HAY ELEMENTARY SCHOOL,3RD,1,1,1,13,33,49,16,33%
0120,ENGLEWOOD 1,1514,CHARLES HAY ELEMENTARY SCHOOL,4TH,2,1,5,10,27,45,18,40%
0120,ENGLEWOOD 1,1514,CHARLES HAY ELEMENTARY SCHOOL,5TH,1,0,3,13,20,37,17,46%
0120,ENGLEWOOD 1,1514,CHARLES HAY ELEMENTARY SCHOOL,SCHOOL TOTAL,7,9,11,73,172,272,100,37%
0120,ENGLEWOOD 1,1556,CHERRELYN ELEMENTARY SCHOOL,KINDERGARTEN,2,1,2,14,30,49,19,39%
0120,ENGLEWOOD 1,1556,CHERRELYN ELEMENTARY SCHOOL,1ST,0,1,2,11,37,51,14,27%
0120,ENGLEWOOD 1,1556,CHERRELYN ELEMENTARY SCHOOL,2ND,1,0,1,11,32,45,13,29%
0120,ENGLEWOOD 1,1556,CHERRELYN ELEMENTARY SCHOOL,3RD,0,2,1,13,27,43,16,37%
0120,ENGLEWOOD 1,1556,CHERRELYN ELEMENTARY SCHOOL,4TH,1,0,2,8,22,33,11,33%
0120,ENGLEWOOD 1,1556,CHERRELYN ELEMENTARY SCHOOL,5TH,3,1,4,20,28,56,28,50%
0120,ENGLEWOOD 1,1556,CHERRELYN ELEMENTARY SCHOOL,SCHOOL TOTAL,7,5,12,77,176,277,101,36%
0120,ENGLEWOOD 1,1652,CLAYTON ELEMENTARY SCHOOL,KINDERGARTEN,0,3,4,36,39,82,43,52%
0120,ENGLEWOOD 1,1652,CLAYTON ELEMENTARY SCHOOL,1ST,0,0,3,31,41,75,34,45%
0120,ENGLEWOOD 1,1652,CLAYTON ELEMENTARY SCHOOL,2ND,2,0,5,19,36,62,26,42%
0120,ENGLEWOOD 1,1652,CLAYTON ELEMENTARY SCHOOL,3RD,1,1,2,28,33,65,32,49%
0120,ENGLEWOOD 1,1652,CLAYTON ELEMENTARY SCHOOL,4TH,4,1,6,38,39,88,49,56%
0120,ENGLEWOOD 1,1652,CLAYTON ELEMENTARY SCHOOL,5TH,1,0,1,27,31,60,29,48%
0120,ENGLEWOOD 1,1652,CLAYTON ELEMENTARY SCHOOL,SCHOOL TOTAL,8,5,21,179,219,432,213,49%
0120,ENGLEWOOD 1,2746,ENGLEWOOD HIGH SCHOOL,9TH,2,0,4,57,98,161,63,39%
0120,ENGLEWOOD 1,2746,ENGLEWOOD HIGH SCHOOL,10TH,2,3,8,41,102,156,54,35%
0120,ENGLEWOOD 1,2746,ENGLEWOOD HIGH SCHOOL,11TH,6,5,7,48,108,174,66,38%
0120,ENGLEWOOD 1,2746,ENGLEWOOD HIGH SCHOOL,12TH,1,3,13,38,103,158,55,35%
0120,ENGLEWOOD 1,2746,ENGLEWOOD HIGH SCHOOL,SCHOOL TOTAL,11,11,32,184,411,649,238,37%
0120,ENGLEWOOD 1,2750,ENGLEWOOD LEADERSHIP ACADEMY,6TH,0,1,1,6,20,28,8,29%
0120,ENGLEWOOD 1,2750,ENGLEWOOD LEADERSHIP ACADEMY,7TH,1,0,0,3,19,23,4,17%
0120,ENGLEWOOD 1,2750,ENGLEWOOD LEADERSHIP ACADEMY,8TH,0,2,1,3,8,14,6,43%
0120,ENGLEWOOD 1,2750,ENGLEWOOD LEADERSHIP ACADEMY,9TH,0,1,0,2,8,11,3,27%
0120,ENGLEWOOD 1,2750,ENGLEWOOD LEADERSHIP ACADEMY,SCHOOL TOTAL,1,4,2,14,55,76,21,28%
0120,ENGLEWOOD 1,2752,ENGLEWOOD MIDDLE SCHOOL,6TH,4,2,10,57,94,167,73,44%
0120,ENGLEWOOD 1,2752,ENGLEWOOD MIDDLE SCHOOL,7TH,3,2,8,57,85,155,70,45%
0120,ENGLEWOOD 1,2752,ENGLEWOOD MIDDLE SCHOOL,8TH,3,3,13,53,85,157,72,46%
0120,ENGLEWOOD 1,2752,ENGLEWOOD MIDDLE SCHOOL,SCHOOL TOTAL,10,7,31,167,264,479,215,45%
0120,ENGLEWOOD 1,5318,ENGLEWOOD EARLY CHILDHOOD EDUCATION CENTER AT MADDOX,PK,1,7,17,92,100,217,117,54%
0120,ENGLEWOOD 1,5318,ENGLEWOOD EARLY CHILDHOOD EDUCATION CENTER AT MADDOX,SCHOOL TOTAL,1,7,17,92,100,217,117,54%
0120,ENGLEWOOD 1,9620,WM E BISHOP ELEMENTARY SCHOOL,KINDERGARTEN,2,2,1,27,10,42,32,76%
0120,ENGLEWOOD 1,9620,WM E BISHOP ELEMENTARY SCHOOL,1ST,1,0,3,32,17,53,36,68%
0120,ENGLEWOOD 1,9620,WM E BISHOP ELEMENTARY SCHOOL,2ND,1,0,2,30,14,47,33,70%
0120,ENGLEWOOD 1,9620,WM E BISHOP ELEMENTARY SCHOOL,3RD,1,1,4,14,14,34,20,59%
0120,ENGLEWOOD 1,9620,WM E BISHOP ELEMENTARY SCHOOL,4TH,0,1,1,25,8,35,27,77%
0120,ENGLEWOOD 1,9620,WM E BISHOP ELEMENTARY SCHOOL,5TH,2,1,3,20,15,41,26,63%
0120,ENGLEWOOD 1,9620,WM E BISHOP ELEMENTARY SCHOOL,SCHOOL TOTAL,7,5,14,148,78,252,174,69%
0120,ENGLEWOOD 1,,DISTRICT TOTAL,,70,60,160,1101,1733,3124,1391,45%
0123,SHERIDAN 2,0138,ALICE TERRY ELEMENTARY SCHOOL,KINDERGARTEN,0,2,5,71,38,116,78,67%
0123,SHERIDAN 2,0138,ALICE TERRY ELEMENTARY SCHOOL,1ST,0,2,8,62,38,110,72,65%
0123,SHERIDAN 2,0138,ALICE TERRY ELEMENTARY SCHOOL,2ND,2,3,4,71,29,109,80,73%
0123,SHERIDAN 2,0138,ALICE TERRY ELEMENTARY SCHOOL,SCHOOL TOTAL,2,7,17,204,105,335,230,69%
0123,SHERIDAN 2,3054,FORT LOGAN ELEMENTARY SCHOOL,3RD,3,3,6,59,31,102,71,70%
0123,SHERIDAN 2,3054,FORT LOGAN ELEMENTARY SCHOOL,4TH,5,2,6,61,29,103,74,72%
0123,SHERIDAN 2,3054,FORT LOGAN ELEMENTARY SCHOOL,5TH,2,1,6,48,22,79,57,72%
0123,SHERIDAN 2,3054,FORT LOGAN ELEMENTARY SCHOOL,SCHOOL TOTAL,10,6,18,168,82,284,202,71%
0123,SHERIDAN 2,7837,SHERIDAN MIDDLE SCHOOL,6TH,1,5,3,58,27,94,67,71%
0123,SHERIDAN 2,7837,SHERIDAN MIDDLE SCHOOL,7TH,4,4,5,84,19,116,97,84%
0123,SHERIDAN 2,7837,SHERIDAN MIDDLE SCHOOL,8TH,2,2,7,85,36,132,96,73%
0123,SHERIDAN 2,7837,SHERIDAN MIDDLE SCHOOL,SCHOOL TOTAL,7,11,15,227,82,342,260,76%
0123,SHERIDAN 2,7842,SHERIDAN HIGH SCHOOL,9TH,2,6,7,61,27,103,76,74%
0123,SHERIDAN 2,7842,SHERIDAN HIGH SCHOOL,10TH,2,3,7,81,24,117,93,79%
0123,SHERIDAN 2,7842,SHERIDAN HIGH SCHOOL,11TH,1,5,5,72,25,108,83,77%
0123,SHERIDAN 2,7842,SHERIDAN HIGH SCHOOL,12TH,3,3,4,95,35,140,105,75%
0123,SHERIDAN 2,7842,SHERIDAN HIGH SCHOOL,SCHOOL TOTAL,8,17,23,309,111,468,357,76%
0123,SHERIDAN 2,7843,EARLY CHILDHOOD EDUCATION CENTER,PK,1,3,8,136,18,166,148,89%
0123,SHERIDAN 2,7843,EARLY CHILDHOOD EDUCATION CENTER,SCHOOL TOTAL,1,3,8,136,18,166,148,89%
0123,SHERIDAN 2,,DISTRICT TOTAL,,28,44,81,1044,398,1595,1197,75%
0130,CHERRY CREEK 5,0000,NOT IN A SCHOOL,PK,0,30,47,79,138,294,156,53%
0130,CHERRY CREEK 5,0000,NOT IN A SCHOOL,7TH,0,0,1,1,0,2,2,100%
0130,CHERRY CREEK 5,0000,NOT IN A SCHOOL,8TH,0,0,1,1,2,4,2,50%
0130,CHERRY CREEK 5,0000,NOT IN A SCHOOL,9TH,0,1,0,2,2,5,3,60%
0130,CHERRY CREEK 5,0000,NOT IN A SCHOOL,10TH,0,0,3,0,0,3,3,100%
0130,CHERRY CREEK 5,0000,NOT IN A SCHOOL,11TH,0,0,4,1,2,7,5,71%
0130,CHERRY CREEK 5,0000,NOT IN A SCHOOL,12TH,0,1,2,0,1,4,3,75%
0130,CHERRY CREEK 5,0000,NOT IN A SCHOOL,SCHOOL TOTAL,0,32,58,84,145,319,174,55%
0130,CHERRY CREEK 5,0016,FOX HOLLOW ELEMENTARY SCHOOL,PK,1,8,1,3,19,32,13,41%
0130,CHERRY CREEK 5,0016,FOX HOLLOW ELEMENTARY SCHOOL,HALF DAY K,2,21,12,6,92,133,41,31%
0130,CHERRY CREEK 5,0016,FOX HOLLOW ELEMENTARY SCHOOL,1ST,0,19,11,9,99,138,39,28%
0130,CHERRY CREEK 5,0016,FOX HOLLOW ELEMENTARY SCHOOL,2ND,0,26,9,15,100,150,50,33%
0130,CHERRY CREEK 5,0016,FOX HOLLOW ELEMENTARY SCHOOL,3RD,0,17,18,6,86,127,41,32%
0130,CHERRY CREEK 5,0016,FOX HOLLOW ELEMENTARY SCHOOL,4TH,1,21,11,11,82,126,44,35%
0130,CHERRY CREEK 5,0016,FOX HOLLOW ELEMENTARY SCHOOL,5TH,1,23,7,10,76,117,41,35%
0130,CHERRY CREEK 5,0016,FOX HOLLOW ELEMENTARY SCHOOL,SCHOOL TOTAL,5,135,69,60,554,823,269,33%
0130,CHERRY CREEK 5,0018,LIBERTY MIDDLE SCHOOL,6TH,0,35,32,37,238,342,104,30%
0130,CHERRY CREEK 5,0018,LIBERTY MIDDLE SCHOOL,7TH,2,39,32,26,236,335,99,30%
0130,CHERRY CREEK 5,0018,LIBERTY MIDDLE SCHOOL,8TH,2,32,31,32,195,292,97,33%
0130,CHERRY CREEK 5,0018,LIBERTY MIDDLE SCHOOL,SCHOOL TOTAL,4,106,95,95,669,969,300,31%
0130,CHERRY CREEK 5,0141,SKY VISTA MIDDLE SCHOOL,6TH,2,19,44,33,188,286,98,34%
0130,CHERRY CREEK 5,0141,SKY VISTA MIDDLE SCHOOL,7TH,1,31,40,31,168,271,103,38%
0130,CHERRY CREEK 5,0141,SKY VISTA MIDDLE SCHOOL,8TH,3,23,44,24,140,234,94,40%
0130,CHERRY CREEK 5,0141,SKY VISTA MIDDLE SCHOOL,SCHOOL TOTAL,6,73,128,88,496,791,295,37%
0130,CHERRY CREEK 5,0242,ANTELOPE RIDGE ELEMENTARY SCHOOL,PK,0,5,2,5,25,37,12,32%
0130,CHERRY CREEK 5,0242,ANTELOPE RIDGE ELEMENTARY SCHOOL,HALF DAY K,1,13,10,15,92,131,39,30%
0130,CHERRY CREEK 5,0242,ANTELOPE RIDGE ELEMENTARY SCHOOL,1ST,0,7,16,15,87,125,38,30%
0130,CHERRY CREEK 5,0242,ANTELOPE RIDGE ELEMENTARY SCHOOL,2ND,3,11,13,9,85,121,36,30%
0130,CHERRY CREEK 5,0242,ANTELOPE RIDGE ELEMENTARY SCHOOL,3RD,0,15,15,18,91,139,48,35%
0130,CHERRY CREEK 5,0242,ANTELOPE RIDGE ELEMENTARY SCHOOL,4TH,0,12,16,25,86,139,53,38%
0130,CHERRY CREEK 5,0242,ANTELOPE RIDGE ELEMENTARY SCHOOL,5TH,1,5,17,17,69,109,40,37%
0130,CHERRY CREEK 5,0242,ANTELOPE RIDGE ELEMENTARY SCHOOL,SCHOOL TOTAL,5,68,89,104,535,801,266,33%
0130,CHERRY CREEK 5,0243,COYOTE HILLS ELEMENTARY SCHOOL,HALF DAY K,0,5,4,7,104,120,16,13%
0130,CHERRY CREEK 5,0243,COYOTE HILLS ELEMENTARY SCHOOL,1ST,0,8,6,6,100,120,20,17%
0130,CHERRY CREEK 5,0243,COYOTE HILLS ELEMENTARY SCHOOL,2ND,0,15,12,7,89,123,34,28%
0130,CHERRY CREEK 5,0243,COYOTE HILLS ELEMENTARY SCHOOL,3RD,1,12,4,3,76,96,20,21%
0130,CHERRY CREEK 5,0243,COYOTE HILLS ELEMENTARY SCHOOL,4TH,1,13,10,4,98,126,28,22%
0130,CHERRY CREEK 5,0243,COYOTE HILLS ELEMENTARY SCHOOL,5TH,0,9,6,11,79,105,26,25%
0130,CHERRY CREEK 5,0243,COYOTE HILLS ELEMENTARY SCHOOL,SCHOOL TOTAL,2,62,42,38,546,690,144,21%
0130,CHERRY CREEK 5,0348,ARROWHEAD ELEMENTARY SCHOOL,HALF DAY K,2,4,15,16,54,91,37,41%
0130,CHERRY CREEK 5,0348,ARROWHEAD ELEMENTARY SCHOOL,1ST,0,10,11,13,63,97,34,35%
0130,CHERRY CREEK 5,0348,ARROWHEAD ELEMENTARY SCHOOL,2ND,1,16,18,18,59,112,53,47%
0130,CHERRY CREEK 5,0348,ARROWHEAD ELEMENTARY SCHOOL,3RD,2,7,12,26,60,107,47,44%
0130,CHERRY CREEK 5,0348,ARROWHEAD ELEMENTARY SCHOOL,4TH,1,6,19,17,65,108,43,40%
0130,CHERRY CREEK 5,0348,ARROWHEAD ELEMENTARY SCHOOL,5TH,0,4,22,28,71,125,54,43%
0130,CHERRY CREEK 5,0348,ARROWHEAD ELEMENTARY SCHOOL,SCHOOL TOTAL,6,47,97,118,372,640,268,42%
0130,CHERRY CREEK 5,0442,ASPEN CROSSING ELEMENTARY SCHOOL,PK,0,1,3,7,22,33,11,33%
0130,CHERRY CREEK 5,0442,ASPEN CROSSING ELEMENTARY SCHOOL,HALF DAY K,0,12,12,12,55,91,36,40%
0130,CHERRY CREEK 5,0442,ASPEN CROSSING ELEMENTARY SCHOOL,1ST,0,6,15,10,66,97,31,32%
0130,CHERRY CREEK 5,0442,ASPEN CROSSING ELEMENTARY SCHOOL,2ND,1,6,12,9,55,83,28,34%
0130,CHERRY CREEK 5,0442,ASPEN CROSSING ELEMENTARY SCHOOL,3RD,0,5,14,10,47,76,29,38%
0130,CHERRY CREEK 5,0442,ASPEN CROSSING ELEMENTARY SCHOOL,4TH,0,13,16,12,42,83,41,49%
0130,CHERRY CREEK 5,0442,ASPEN CROSSING ELEMENTARY SCHOOL,5TH,1,7,15,8,38,69,31,45%
0130,CHERRY CREEK 5,0442,ASPEN CROSSING ELEMENTARY SCHOOL,SCHOOL TOTAL,2,50,87,68,325,532,207,39%
0130,CHERRY CREEK 5,0714,BELLEVIEW ELEMENTARY SCHOOL,HALF DAY K,0,17,5,3,67,92,25,27%
0130,CHERRY CREEK 5,0714,BELLEVIEW ELEMENTARY SCHOOL,1ST,0,27,1,7,61,96,35,36%
0130,CHERRY CREEK 5,0714,BELLEVIEW ELEMENTARY SCHOOL,2ND,0,24,1,5,61,91,30,33%
0130,CHERRY CREEK 5,0714,BELLEVIEW ELEMENTARY SCHOOL,3RD,0,18,4,6,73,101,28,28%
0130,CHERRY CREEK 5,0714,BELLEVIEW ELEMENTARY SCHOOL,4TH,1,22,4,5,72,104,32,31%
0130,CHERRY CREEK 5,0714,BELLEVIEW ELEMENTARY SCHOOL,5TH,0,16,5,6,98,125,27,22%
0130,CHERRY CREEK 5,0714,BELLEVIEW ELEMENTARY SCHOOL,SCHOOL TOTAL,1,124,20,32,432,609,177,29%
0130,CHERRY CREEK 5,1155,BUFFALO TRAIL ELEMENTARY SCHOOL,PK,0,11,10,8,61,90,29,32%
0130,CHERRY CREEK 5,1155,BUFFALO TRAIL ELEMENTARY SCHOOL,HALF DAY K,0,10,10,14,94,128,34,27%
0130,CHERRY CREEK 5,1155,BUFFALO TRAIL ELEMENTARY SCHOOL,1ST,0,17,12,10,98,137,39,28%
0130,CHERRY CREEK 5,1155,BUFFALO TRAIL ELEMENTARY SCHOOL,2ND,0,8,14,7,83,112,29,26%
0130,CHERRY CREEK 5,1155,BUFFALO TRAIL ELEMENTARY SCHOOL,3RD,0,14,16,12,70,112,42,38%
0130,CHERRY CREEK 5,1155,BUFFALO TRAIL ELEMENTARY SCHOOL,4TH,0,6,11,14,66,97,31,32%
0130,CHERRY CREEK 5,1155,BUFFALO TRAIL ELEMENTARY SCHOOL,5TH,0,2,14,10,72,98,26,27%
0130,CHERRY CREEK 5,1155,BUFFALO TRAIL ELEMENTARY SCHOOL,SCHOOL TOTAL,0,68,87,75,544,774,230,30%
0130,CHERRY CREEK 5,1273,CANYON CREEK ELEMENTARY SCHOOL,PK,0,7,2,2,22,33,11,33%
0130,CHERRY CREEK 5,1273,CANYON CREEK ELEMENTARY SCHOOL,HALF DAY K,0,11,13,9,96,129,33,26%
0130,CHERRY CREEK 5,1273,CANYON CREEK ELEMENTARY SCHOOL,1ST,1,7,19,16,92,135,43,32%
0130,CHERRY CREEK 5,1273,CANYON CREEK ELEMENTARY SCHOOL,2ND,1,7,10,12,98,128,30,23%
0130,CHERRY CREEK 5,1273,CANYON CREEK ELEMENTARY SCHOOL,3RD,0,10,17,13,86,126,40,32%
0130,CHERRY CREEK 5,1273,CANYON CREEK ELEMENTARY SCHOOL,4TH,0,13,12,18,71,114,43,38%
0130,CHERRY CREEK 5,1273,CANYON CREEK ELEMENTARY SCHOOL,5TH,0,8,13,16,69,106,37,35%
0130,CHERRY CREEK 5,1273,CANYON CREEK ELEMENTARY SCHOOL,SCHOOL TOTAL,2,63,86,86,534,771,237,31%
0130,CHERRY CREEK 5,1510,CHALLENGE SCHOOL,HALF DAY K,0,8,1,1,14,24,10,42%
0130,CHERRY CREEK 5,1510,CHALLENGE SCHOOL,1ST,0,13,3,2,23,41,18,44%
0130,CHERRY CREEK 5,1510,CHALLENGE SCHOOL,2ND,0,13,2,2,34,51,17,33%
0130,CHERRY CREEK 5,1510,CHALLENGE SCHOOL,3RD,1,12,6,6,36,61,25,41%
0130,CHERRY CREEK 5,1510,CHALLENGE SCHOOL,4TH,1,14,5,6,38,64,26,41%
0130,CHERRY CREEK 5,1510,CHALLENGE SCHOOL,5TH,0,15,4,5,50,74,24,32%
0130,CHERRY CREEK 5,1510,CHALLENGE SCHOOL,6TH,0,18,5,2,51,76,25,33%
0130,CHERRY CREEK 5,1510,CHALLENGE SCHOOL,7TH,0,12,6,4,53,75,22,29%
0130,CHERRY CREEK 5,1510,CHALLENGE SCHOOL,8TH,0,13,4,3,52,72,20,28%
0130,CHERRY CREEK 5,1510,CHALLENGE SCHOOL,SCHOOL TOTAL,2,118,36,31,351,538,187,35%
0130,CHERRY CREEK 5,1551,CHEROKEE TRAIL HIGH SCHOOL,9TH,6,62,77,66,413,624,211,34%
0130,CHERRY CREEK 5,1551,CHEROKEE TRAIL HIGH SCHOOL,10TH,1,48,92,83,369,593,224,38%
0130,CHERRY CREEK 5,1551,CHEROKEE TRAIL HIGH SCHOOL,11TH,6,39,79,55,387,566,179,32%
0130,CHERRY CREEK 5,1551,CHEROKEE TRAIL HIGH SCHOOL,12TH,4,33,81,52,375,545,170,31%
0130,CHERRY CREEK 5,1551,CHEROKEE TRAIL HIGH SCHOOL,SCHOOL TOTAL,17,182,329,256,1544,2328,784,34%
0130,CHERRY CREEK 5,1566,CAMPUS MIDDLE SCHOOL,6TH,1,66,10,31,349,457,108,24%
0130,CHERRY CREEK 5,1566,CAMPUS MIDDLE SCHOOL,7TH,1,52,14,35,378,480,102,21%
0130,CHERRY CREEK 5,1566,CAMPUS MIDDLE SCHOOL,8TH,3,58,24,31,375,491,116,24%
0130,CHERRY CREEK 5,1566,CAMPUS MIDDLE SCHOOL,SCHOOL TOTAL,5,176,48,97,1102,1428,326,23%
0130,CHERRY CREEK 5,1568,WEST MIDDLE SCHOOL,6TH,2,25,21,44,268,360,92,26%
0130,CHERRY CREEK 5,1568,WEST MIDDLE SCHOOL,7TH,2,19,11,28,330,390,60,15%
0130,CHERRY CREEK 5,1568,WEST MIDDLE SCHOOL,8TH,1,21,7,44,316,389,73,19%
0130,CHERRY CREEK 5,1568,WEST MIDDLE SCHOOL,SCHOOL TOTAL,5,65,39,116,914,1139,225,20%
0130,CHERRY CREEK 5,1570,CHERRY CREEK HIGH SCHOOL,9TH,4,76,40,68,700,888,188,21%
0130,CHERRY CREEK 5,1570,CHERRY CREEK HIGH SCHOOL,10TH,1,84,26,68,653,832,179,22%
0130,CHERRY CREEK 5,1570,CHERRY CREEK HIGH SCHOOL,11TH,3,73,26,51,697,850,153,18%
0130,CHERRY CREEK 5,1570,CHERRY CREEK HIGH SCHOOL,12TH,3,64,38,51,775,931,156,17%
0130,CHERRY CREEK 5,1570,CHERRY CREEK HIGH SCHOOL,SCHOOL TOTAL,11,297,130,238,2825,3501,676,19%
0130,CHERRY CREEK 5,1571,CHERRY CREEK CHARTER ACADEMY,HALF DAY K,0,3,3,2,39,47,8,17%
0130,CHERRY CREEK 5,1571,CHERRY CREEK CHARTER ACADEMY,1ST,1,16,6,2,52,77,25,32%
0130,CHERRY CREEK 5,1571,CHERRY CREEK CHARTER ACADEMY,2ND,0,8,4,5,35,52,17,33%
0130,CHERRY CREEK 5,1571,CHERRY CREEK CHARTER ACADEMY,3RD,0,8,7,4,36,55,19,35%
0130,CHERRY CREEK 5,1571,CHERRY CREEK CHARTER ACADEMY,4TH,0,2,4,3,41,50,9,18%
0130,CHERRY CREEK 5,1571,CHERRY CREEK CHARTER ACADEMY,5TH,0,4,6,1,42,53,11,21%
0130,CHERRY CREEK 5,1571,CHERRY CREEK CHARTER ACADEMY,6TH,0,2,7,4,37,50,13,26%
0130,CHERRY CREEK 5,1571,CHERRY CREEK CHARTER ACADEMY,7TH,0,4,2,1,34,41,7,17%
0130,CHERRY CREEK 5,1571,CHERRY CREEK CHARTER ACADEMY,8TH,0,2,2,3,40,47,7,15%
0130,CHERRY CREEK 5,1571,CHERRY CREEK CHARTER ACADEMY,SCHOOL TOTAL,1,49,41,25,356,472,116,25%
0130,CHERRY CREEK 5,1572,HIGH PLAINS ELEMENTARY SCHOOL,HALF DAY K,0,8,1,19,64,92,28,30%
0130,CHERRY CREEK 5,1572,HIGH PLAINS ELEMENTARY SCHOOL,1ST,0,15,3,8,69,95,26,27%
0130,CHERRY CREEK 5,1572,HIGH PLAINS ELEMENTARY SCHOOL,2ND,0,11,1,23,52,87,35,40%
0130,CHERRY CREEK 5,1572,HIGH PLAINS ELEMENTARY SCHOOL,3RD,0,10,3,17,60,90,30,33%
0130,CHERRY CREEK 5,1572,HIGH PLAINS ELEMENTARY SCHOOL,4TH,0,13,2,14,57,86,29,34%
0130,CHERRY CREEK 5,1572,HIGH PLAINS ELEMENTARY SCHOOL,5TH,0,8,7,20,60,95,35,37%
0130,CHERRY CREEK 5,1572,HIGH PLAINS ELEMENTARY SCHOOL,SCHOOL TOTAL,0,65,17,101,362,545,183,34%
0130,CHERRY CREEK 5,1574,CHERRY HILLS VILLAGE ELEMENTARY SCHOOL,HALF DAY K,1,2,2,2,79,86,7,8%
0130,CHERRY CREEK 5,1574,CHERRY HILLS VILLAGE ELEMENTARY SCHOOL,1ST,0,6,0,3,83,92,9,10%
0130,CHERRY CREEK 5,1574,CHERRY HILLS VILLAGE ELEMENTARY SCHOOL,2ND,0,10,0,0,99,109,10,9%
0130,CHERRY CREEK 5,1574,CHERRY HILLS VILLAGE ELEMENTARY SCHOOL,3RD,0,5,1,0,89,95,6,6%
0130,CHERRY CREEK 5,1574,CHERRY HILLS VILLAGE ELEMENTARY SCHOOL,4TH,0,3,3,5,85,96,11,11%
0130,CHERRY CREEK 5,1574,CHERRY HILLS VILLAGE ELEMENTARY SCHOOL,5TH,0,5,0,1,86,92,6,7%
0130,CHERRY CREEK 5,1574,CHERRY HILLS VILLAGE ELEMENTARY SCHOOL,SCHOOL TOTAL,1,31,6,11,521,570,49,9%
0130,CHERRY CREEK 5,1614,CIMARRON ELEMENTARY SCHOOL,PK,0,2,14,11,28,55,27,49%
0130,CHERRY CREEK 5,1614,CIMARRON ELEMENTARY SCHOOL,HALF DAY K,1,5,17,17,55,95,40,42%
0130,CHERRY CREEK 5,1614,CIMARRON ELEMENTARY SCHOOL,1ST,1,5,16,13,40,75,35,47%
0130,CHERRY CREEK 5,1614,CIMARRON ELEMENTARY SCHOOL,2ND,0,8,23,15,42,88,46,52%
0130,CHERRY CREEK 5,1614,CIMARRON ELEMENTARY SCHOOL,3RD,0,6,18,19,50,93,43,46%
0130,CHERRY CREEK 5,1614,CIMARRON ELEMENTARY SCHOOL,4TH,1,3,23,17,44,88,44,50%
0130,CHERRY CREEK 5,1614,CIMARRON ELEMENTARY SCHOOL,5TH,2,6,26,13,38,85,47,55%
0130,CHERRY CREEK 5,1614,CIMARRON ELEMENTARY SCHOOL,SCHOOL TOTAL,5,35,137,105,297,579,282,49%
0130,CHERRY CREEK 5,1916,COTTONWOOD CREEK ELEMENTARY SCHOOL,HALF DAY K,1,9,0,1,79,90,11,12%
0130,CHERRY CREEK 5,1916,COTTONWOOD CREEK ELEMENTARY SCHOOL,1ST,0,22,0,8,80,110,30,27%
0130,CHERRY CREEK 5,1916,COTTONWOOD CREEK ELEMENTARY SCHOOL,2ND,0,18,1,1,83,103,20,19%
0130,CHERRY CREEK 5,1916,COTTONWOOD CREEK ELEMENTARY SCHOOL,3RD,1,14,1,5,81,102,21,21%
0130,CHERRY CREEK 5,1916,COTTONWOOD CREEK ELEMENTARY SCHOOL,4TH,0,15,2,3,90,110,20,18%
0130,CHERRY CREEK 5,1916,COTTONWOOD CREEK ELEMENTARY SCHOOL,5TH,1,13,4,2,92,112,20,18%
0130,CHERRY CREEK 5,1916,COTTONWOOD CREEK ELEMENTARY SCHOOL,SCHOOL TOTAL,3,91,8,20,505,627,122,19%
0130,CHERRY CREEK 5,1970,CREEKSIDE ELEMENTARY SCHOOL,PK,0,13,3,6,44,66,22,33%
0130,CHERRY CREEK 5,1970,CREEKSIDE ELEMENTARY SCHOOL,HALF DAY K,0,7,3,7,92,109,17,16%
0130,CHERRY CREEK 5,1970,CREEKSIDE ELEMENTARY SCHOOL,1ST,1,11,7,9,105,133,28,21%
0130,CHERRY CREEK 5,1970,CREEKSIDE ELEMENTARY SCHOOL,2ND,1,2,7,11,87,108,21,19%
0130,CHERRY CREEK 5,1970,CREEKSIDE ELEMENTARY SCHOOL,3RD,0,9,6,6,90,111,21,19%
0130,CHERRY CREEK 5,1970,CREEKSIDE ELEMENTARY SCHOOL,4TH,0,9,10,10,83,112,29,26%
0130,CHERRY CREEK 5,1970,CREEKSIDE ELEMENTARY SCHOOL,5TH,0,7,5,12,106,130,24,18%
0130,CHERRY CREEK 5,1970,CREEKSIDE ELEMENTARY SCHOOL,SCHOOL TOTAL,2,58,41,61,607,769,162,21%
0130,CHERRY CREEK 5,2094,DAKOTA VALLEY ELEMENTARY SCHOOL,PK,0,7,5,7,28,47,19,40%
0130,CHERRY CREEK 5,2094,DAKOTA VALLEY ELEMENTARY SCHOOL,HALF DAY K,0,17,17,11,95,140,45,32%
0130,CHERRY CREEK 5,2094,DAKOTA VALLEY ELEMENTARY SCHOOL,1ST,0,16,14,22,94,146,52,36%
0130,CHERRY CREEK 5,2094,DAKOTA VALLEY ELEMENTARY SCHOOL,2ND,1,11,10,8,104,134,30,22%
0130,CHERRY CREEK 5,2094,DAKOTA VALLEY ELEMENTARY SCHOOL,3RD,2,19,23,17,89,150,61,41%
0130,CHERRY CREEK 5,2094,DAKOTA VALLEY ELEMENTARY SCHOOL,4TH,1,20,11,17,76,125,49,39%
0130,CHERRY CREEK 5,2094,DAKOTA VALLEY ELEMENTARY SCHOOL,5TH,0,14,19,20,76,129,53,41%
0130,CHERRY CREEK 5,2094,DAKOTA VALLEY ELEMENTARY SCHOOL,SCHOOL TOTAL,4,104,99,102,562,871,309,35%
0130,CHERRY CREEK 5,2292,DRY CREEK ELEMENTARY SCHOOL,HALF DAY K,0,9,2,4,52,67,15,22%
0130,CHERRY CREEK 5,2292,DRY CREEK ELEMENTARY SCHOOL,1ST,0,8,0,4,61,73,12,16%
0130,CHERRY CREEK 5,2292,DRY CREEK ELEMENTARY SCHOOL,2ND,0,8,7,7,55,77,22,29%
0130,CHERRY CREEK 5,2292,DRY CREEK ELEMENTARY SCHOOL,3RD,0,11,4,7,50,72,22,31%
0130,CHERRY CREEK 5,2292,DRY CREEK ELEMENTARY SCHOOL,4TH,0,9,4,6,50,69,19,28%
0130,CHERRY CREEK 5,2292,DRY CREEK ELEMENTARY SCHOOL,5TH,0,7,4,5,56,72,16,22%
0130,CHERRY CREEK 5,2292,DRY CREEK ELEMENTARY SCHOOL,SCHOOL TOTAL,0,52,21,33,324,430,106,25%
0130,CHERRY CREEK 5,2357,EAGLECREST HIGH SCHOOL,9TH,2,42,103,90,330,567,237,42%
0130,CHERRY CREEK 5,2357,EAGLECREST HIGH SCHOOL,10TH,2,39,113,86,356,596,240,40%
0130,CHERRY CREEK 5,2357,EAGLECREST HIGH SCHOOL,11TH,4,44,116,83,352,599,247,41%
0130,CHERRY CREEK 5,2357,EAGLECREST HIGH SCHOOL,12TH,4,50,109,72,365,600,235,39%
0130,CHERRY CREEK 5,2357,EAGLECREST HIGH SCHOOL,SCHOOL TOTAL,12,175,441,331,1403,2362,959,41%
0130,CHERRY CREEK 5,2428,EASTRIDGE COMMUNITY ELEMENTARY SCHOOL,PK,1,3,21,34,13,72,59,82%
0130,CHERRY CREEK 5,2428,EASTRIDGE COMMUNITY ELEMENTARY SCHOOL,KINDERGARTEN,3,13,43,34,47,140,93,66%
0130,CHERRY CREEK 5,2428,EASTRIDGE COMMUNITY ELEMENTARY SCHOOL,1ST,3,8,49,39,42,141,99,70%
0130,CHERRY CREEK 5,2428,EASTRIDGE COMMUNITY ELEMENTARY SCHOOL,2ND,0,7,43,38,35,123,88,72%
0130,CHERRY CREEK 5,2428,EASTRIDGE COMMUNITY ELEMENTARY SCHOOL,3RD,1,11,40,34,43,129,86,67%
0130,CHERRY CREEK 5,2428,EASTRIDGE COMMUNITY ELEMENTARY SCHOOL,4TH,0,8,43,27,46,124,78,63%
0130,CHERRY CREEK 5,2428,EASTRIDGE COMMUNITY ELEMENTARY SCHOOL,5TH,0,8,44,27,33,112,79,71%
0130,CHERRY CREEK 5,2428,EASTRIDGE COMMUNITY ELEMENTARY SCHOOL,SCHOOL TOTAL,8,58,283,233,259,841,582,69%
0130,CHERRY CREEK 5,2897,FALCON CREEK MIDDLE SCHOOL,6TH,2,31,37,40,244,354,110,31%
0130,CHERRY CREEK 5,2897,FALCON CREEK MIDDLE SCHOOL,7TH,2,27,40,37,262,368,106,29%
0130,CHERRY CREEK 5,2897,FALCON CREEK MIDDLE SCHOOL,8TH,1,37,29,35,271,373,102,27%
0130,CHERRY CREEK 5,2897,FALCON CREEK MIDDLE SCHOOL,SCHOOL TOTAL,5,95,106,112,777,1095,318,29%
0130,CHERRY CREEK 5,3030,FOX RIDGE MIDDLE SCHOOL,6TH,0,20,40,20,197,277,80,29%
0130,CHERRY CREEK 5,3030,FOX RIDGE MIDDLE SCHOOL,7TH,3,16,20,27,185,251,66,26%
0130,CHERRY CREEK 5,3030,FOX RIDGE MIDDLE SCHOOL,8TH,0,14,20,25,148,207,59,29%
0130,CHERRY CREEK 5,3030,FOX RIDGE MIDDLE SCHOOL,SCHOOL TOTAL,3,50,80,72,530,735,205,28%
0130,CHERRY CREEK 5,3589,GRANDVIEW HIGH SCHOOL,9TH,4,61,96,47,448,656,208,32%
0130,CHERRY CREEK 5,3589,GRANDVIEW HIGH SCHOOL,10TH,2,70,57,55,432,616,184,30%
0130,CHERRY CREEK 5,3589,GRANDVIEW HIGH SCHOOL,11TH,3,59,66,59,474,661,187,28%
0130,CHERRY CREEK 5,3589,GRANDVIEW HIGH SCHOOL,12TH,0,70,69,57,478,674,196,29%
0130,CHERRY CREEK 5,3589,GRANDVIEW HIGH SCHOOL,SCHOOL TOTAL,9,260,288,218,1832,2607,775,30%
0130,CHERRY CREEK 5,3648,GREENWOOD ELEMENTARY SCHOOL,HALF DAY K,0,8,2,2,51,63,12,19%
0130,CHERRY CREEK 5,3648,GREENWOOD ELEMENTARY SCHOOL,1ST,0,4,3,3,57,67,10,15%
0130,CHERRY CREEK 5,3648,GREENWOOD ELEMENTARY SCHOOL,2ND,1,4,2,2,63,72,9,13%
0130,CHERRY CREEK 5,3648,GREENWOOD ELEMENTARY SCHOOL,3RD,0,6,2,3,58,69,11,16%
0130,CHERRY CREEK 5,3648,GREENWOOD ELEMENTARY SCHOOL,4TH,0,3,3,0,54,60,6,10%
0130,CHERRY CREEK 5,3648,GREENWOOD ELEMENTARY SCHOOL,5TH,2,8,1,2,64,77,13,17%
0130,CHERRY CREEK 5,3648,GREENWOOD ELEMENTARY SCHOOL,SCHOOL TOTAL,3,33,13,12,347,408,61,15%
0130,CHERRY CREEK 5,3926,HERITAGE ELEMENTARY SCHOOL,PK,0,13,6,9,44,72,28,39%
0130,CHERRY CREEK 5,3926,HERITAGE ELEMENTARY SCHOOL,HALF DAY K,0,5,1,4,37,47,10,21%
0130,CHERRY CREEK 5,3926,HERITAGE ELEMENTARY SCHOOL,1ST,0,6,2,0,38,46,8,17%
0130,CHERRY CREEK 5,3926,HERITAGE ELEMENTARY SCHOOL,2ND,1,4,1,3,42,51,9,18%
0130,CHERRY CREEK 5,3926,HERITAGE ELEMENTARY SCHOOL,3RD,0,6,5,3,32,46,14,30%
0130,CHERRY CREEK 5,3926,HERITAGE ELEMENTARY SCHOOL,4TH,0,4,1,3,39,47,8,17%
0130,CHERRY CREEK 5,3926,HERITAGE ELEMENTARY SCHOOL,5TH,0,6,2,4,35,47,12,26%
0130,CHERRY CREEK 5,3926,HERITAGE ELEMENTARY SCHOOL,SCHOOL TOTAL,1,44,18,26,267,356,89,25%
0130,CHERRY CREEK 5,3988,HIGHLINE COMMUNITY ELEMENTARY SCHOOL,KINDERGARTEN,2,2,29,49,19,101,82,81%
0130,CHERRY CREEK 5,3988,HIGHLINE COMMUNITY ELEMENTARY SCHOOL,1ST,2,3,22,49,13,89,76,85%
0130,CHERRY CREEK 5,3988,HIGHLINE COMMUNITY ELEMENTARY SCHOOL,2ND,3,2,31,51,18,105,87,83%
0130,CHERRY CREEK 5,3988,HIGHLINE COMMUNITY ELEMENTARY SCHOOL,3RD,0,4,21,44,26,95,69,73%
0130,CHERRY CREEK 5,3988,HIGHLINE COMMUNITY ELEMENTARY SCHOOL,4TH,0,2,30,60,22,114,92,81%
0130,CHERRY CREEK 5,3988,HIGHLINE COMMUNITY ELEMENTARY SCHOOL,5TH,1,8,22,56,25,112,87,78%
0130,CHERRY CREEK 5,3988,HIGHLINE COMMUNITY ELEMENTARY SCHOOL,SCHOOL TOTAL,8,21,155,309,123,616,493,80%
0130,CHERRY CREEK 5,4062,HOLLY HILLS ELEMENTARY SCHOOL,PK,0,0,1,0,0,1,1,100%
0130,CHERRY CREEK 5,4062,HOLLY HILLS ELEMENTARY SCHOOL,KINDERGARTEN,0,7,18,63,29,117,88,75%
0130,CHERRY CREEK 5,4062,HOLLY HILLS ELEMENTARY SCHOOL,1ST,0,11,12,61,24,108,84,78%
0130,CHERRY CREEK 5,4062,HOLLY HILLS ELEMENTARY SCHOOL,2ND,0,9,8,49,28,94,66,70%
0130,CHERRY CREEK 5,4062,HOLLY HILLS ELEMENTARY SCHOOL,3RD,0,8,17,35,25,85,60,71%
0130,CHERRY CREEK 5,4062,HOLLY HILLS ELEMENTARY SCHOOL,4TH,1,6,16,41,15,79,64,81%
0130,CHERRY CREEK 5,4062,HOLLY HILLS ELEMENTARY SCHOOL,5TH,0,9,16,34,26,85,59,69%
0130,CHERRY CREEK 5,4062,HOLLY HILLS ELEMENTARY SCHOOL,SCHOOL TOTAL,1,50,88,283,147,569,422,74%
0130,CHERRY CREEK 5,4078,HOMESTEAD ELEMENTARY SCHOOL,HALF DAY K,0,6,8,2,64,80,16,20%
0130,CHERRY CREEK 5,4078,HOMESTEAD ELEMENTARY SCHOOL,1ST,1,12,1,7,70,91,21,23%
0130,CHERRY CREEK 5,4078,HOMESTEAD ELEMENTARY SCHOOL,2ND,0,5,3,4,84,96,12,13%
0130,CHERRY CREEK 5,4078,HOMESTEAD ELEMENTARY SCHOOL,3RD,2,10,1,7,66,86,20,23%
0130,CHERRY CREEK 5,4078,HOMESTEAD ELEMENTARY SCHOOL,4TH,2,9,4,3,76,94,18,19%
0130,CHERRY CREEK 5,4078,HOMESTEAD ELEMENTARY SCHOOL,5TH,0,4,2,4,62,72,10,14%
0130,CHERRY CREEK 5,4078,HOMESTEAD ELEMENTARY SCHOOL,SCHOOL TOTAL,5,46,19,27,422,519,97,19%
0130,CHERRY CREEK 5,4100,HORIZON MIDDLE SCHOOL,6TH,5,28,68,75,147,323,176,54%
0130,CHERRY CREEK 5,4100,HORIZON MIDDLE SCHOOL,7TH,2,20,64,65,161,312,151,48%
0130,CHERRY CREEK 5,4100,HORIZON MIDDLE SCHOOL,8TH,5,26,90,80,182,383,201,52%
0130,CHERRY CREEK 5,4100,HORIZON MIDDLE SCHOOL,SCHOOL TOTAL,12,74,222,220,490,1018,528,52%
0130,CHERRY CREEK 5,4276,INDEPENDENCE ELEMENTARY SCHOOL,KINDERGARTEN,1,5,16,15,37,74,37,50%
0130,CHERRY CREEK 5,4276,INDEPENDENCE ELEMENTARY SCHOOL,1ST,0,3,21,24,46,94,48,51%
0130,CHERRY CREEK 5,4276,INDEPENDENCE ELEMENTARY SCHOOL,2ND,1,3,18,18,52,92,40,43%
0130,CHERRY CREEK 5,4276,INDEPENDENCE ELEMENTARY SCHOOL,3RD,1,3,21,22,40,87,47,54%
0130,CHERRY CREEK 5,4276,INDEPENDENCE ELEMENTARY SCHOOL,4TH,0,5,15,19,43,82,39,48%
0130,CHERRY CREEK 5,4276,INDEPENDENCE ELEMENTARY SCHOOL,5TH,1,6,21,21,30,79,49,62%
0130,CHERRY CREEK 5,4276,INDEPENDENCE ELEMENTARY SCHOOL,SCHOOL TOTAL,4,25,112,119,248,508,260,51%
0130,CHERRY CREEK 5,4280,INDIAN RIDGE ELEMENTARY SCHOOL,PK,0,3,7,2,17,29,12,41%
0130,CHERRY CREEK 5,4280,INDIAN RIDGE ELEMENTARY SCHOOL,HALF DAY K,1,7,10,7,52,77,25,32%
0130,CHERRY CREEK 5,4280,INDIAN RIDGE ELEMENTARY SCHOOL,1ST,1,15,12,6,68,102,34,33%
0130,CHERRY CREEK 5,4280,INDIAN RIDGE ELEMENTARY SCHOOL,2ND,0,15,11,7,65,98,33,34%
0130,CHERRY CREEK 5,4280,INDIAN RIDGE ELEMENTARY SCHOOL,3RD,1,11,16,10,70,108,38,35%
0130,CHERRY CREEK 5,4280,INDIAN RIDGE ELEMENTARY SCHOOL,4TH,1,13,10,8,53,85,32,38%
0130,CHERRY CREEK 5,4280,INDIAN RIDGE ELEMENTARY SCHOOL,5TH,0,12,17,12,69,110,41,37%
0130,CHERRY CREEK 5,4280,INDIAN RIDGE ELEMENTARY SCHOOL,SCHOOL TOTAL,4,76,83,52,394,609,215,35%
0130,CHERRY CREEK 5,4975,LAREDO MIDDLE SCHOOL,6TH,2,25,81,59,207,374,167,45%
0130,CHERRY CREEK 5,4975,LAREDO MIDDLE SCHOOL,7TH,2,28,84,42,229,385,156,41%
0130,CHERRY CREEK 5,4975,LAREDO MIDDLE SCHOOL,8TH,4,49,74,58,247,432,185,43%
0130,CHERRY CREEK 5,4975,LAREDO MIDDLE SCHOOL,SCHOOL TOTAL,8,102,239,159,683,1191,508,43%
0130,CHERRY CREEK 5,5744,MEADOW POINT ELEMENTARY SCHOOL,PK,0,1,11,14,33,59,26,44%
0130,CHERRY CREEK 5,5744,MEADOW POINT ELEMENTARY SCHOOL,HALF DAY K,1,1,13,18,27,60,33,55%
0130,CHERRY CREEK 5,5744,MEADOW POINT ELEMENTARY SCHOOL,1ST,0,2,10,22,36,70,34,49%
0130,CHERRY CREEK 5,5744,MEADOW POINT ELEMENTARY SCHOOL,2ND,1,2,11,22,57,93,36,39%
0130,CHERRY CREEK 5,5744,MEADOW POINT ELEMENTARY SCHOOL,3RD,1,1,11,23,49,85,36,42%
0130,CHERRY CREEK 5,5744,MEADOW POINT ELEMENTARY SCHOOL,4TH,0,2,13,30,34,79,45,57%
0130,CHERRY CREEK 5,5744,MEADOW POINT ELEMENTARY SCHOOL,5TH,0,2,13,22,57,94,37,39%
0130,CHERRY CREEK 5,5744,MEADOW POINT ELEMENTARY SCHOOL,SCHOOL TOTAL,3,11,82,151,293,540,247,46%
0130,CHERRY CREEK 5,5934,MISSION VIEJO ELEMENTARY SCHOOL,PK,1,5,15,12,36,69,33,48%
0130,CHERRY CREEK 5,5934,MISSION VIEJO ELEMENTARY SCHOOL,HALF DAY K,3,6,21,14,64,108,44,41%
0130,CHERRY CREEK 5,5934,MISSION VIEJO ELEMENTARY SCHOOL,1ST,2,5,15,20,69,111,42,38%
0130,CHERRY CREEK 5,5934,MISSION VIEJO ELEMENTARY SCHOOL,2ND,1,8,16,23,59,107,48,45%
0130,CHERRY CREEK 5,5934,MISSION VIEJO ELEMENTARY SCHOOL,3RD,1,4,24,16,56,101,45,45%
0130,CHERRY CREEK 5,5934,MISSION VIEJO ELEMENTARY SCHOOL,4TH,0,3,23,16,72,114,42,37%
0130,CHERRY CREEK 5,5934,MISSION VIEJO ELEMENTARY SCHOOL,5TH,1,5,23,23,68,120,52,43%
0130,CHERRY CREEK 5,5934,MISSION VIEJO ELEMENTARY SCHOOL,SCHOOL TOTAL,9,36,137,124,424,730,306,42%
0130,CHERRY CREEK 5,6625,OVERLAND HIGH SCHOOL,9TH,0,28,219,175,178,600,422,70%
0130,CHERRY CREEK 5,6625,OVERLAND HIGH SCHOOL,10TH,6,22,217,165,134,544,410,75%
0130,CHERRY CREEK 5,6625,OVERLAND HIGH SCHOOL,11TH,5,25,194,121,148,493,345,70%
0130,CHERRY CREEK 5,6625,OVERLAND HIGH SCHOOL,12TH,2,31,197,104,167,501,334,67%
0130,CHERRY CREEK 5,6625,OVERLAND HIGH SCHOOL,SCHOOL TOTAL,13,106,827,565,627,2138,1511,71%
0130,CHERRY CREEK 5,6820,PEAKVIEW ELEMENTARY SCHOOL,PK,0,6,6,7,41,60,19,32%
0130,CHERRY CREEK 5,6820,PEAKVIEW ELEMENTARY SCHOOL,HALF DAY K,0,5,8,6,73,92,19,21%
0130,CHERRY CREEK 5,6820,PEAKVIEW ELEMENTARY SCHOOL,1ST,1,4,13,5,63,86,23,27%
0130,CHERRY CREEK 5,6820,PEAKVIEW ELEMENTARY SCHOOL,2ND,0,7,16,6,76,105,29,28%
0130,CHERRY CREEK 5,6820,PEAKVIEW ELEMENTARY SCHOOL,3RD,0,7,16,11,76,110,34,31%
0130,CHERRY CREEK 5,6820,PEAKVIEW ELEMENTARY SCHOOL,4TH,1,7,17,4,71,100,29,29%
0130,CHERRY CREEK 5,6820,PEAKVIEW ELEMENTARY SCHOOL,5TH,0,10,18,11,71,110,39,35%
0130,CHERRY CREEK 5,6820,PEAKVIEW ELEMENTARY SCHOOL,SCHOOL TOTAL,2,46,94,50,471,663,192,29%
0130,CHERRY CREEK 5,7102,POLTON COMMUNITY ELEMENTARY SCHOOL,PK,0,9,7,18,32,66,34,52%
0130,CHERRY CREEK 5,7102,POLTON COMMUNITY ELEMENTARY SCHOOL,HALF DAY K,0,3,12,7,38,60,22,37%
0130,CHERRY CREEK 5,7102,POLTON COMMUNITY ELEMENTARY SCHOOL,1ST,0,3,19,8,46,76,30,39%
0130,CHERRY CREEK 5,7102,POLTON COMMUNITY ELEMENTARY SCHOOL,2ND,0,2,13,8,47,70,23,33%
0130,CHERRY CREEK 5,7102,POLTON COMMUNITY ELEMENTARY SCHOOL,3RD,0,5,22,8,34,69,35,51%
0130,CHERRY CREEK 5,7102,POLTON COMMUNITY ELEMENTARY SCHOOL,4TH,0,3,15,5,35,58,23,40%
0130,CHERRY CREEK 5,7102,POLTON COMMUNITY ELEMENTARY SCHOOL,5TH,2,0,17,8,36,63,27,43%
0130,CHERRY CREEK 5,7102,POLTON COMMUNITY ELEMENTARY SCHOOL,SCHOOL TOTAL,2,25,105,62,268,462,194,42%
0130,CHERRY CREEK 5,7116,PONDEROSA ELEMENTARY SCHOOL,PK,2,12,27,19,16,76,60,79%
0130,CHERRY CREEK 5,7116,PONDEROSA ELEMENTARY SCHOOL,KINDERGARTEN,1,6,37,37,38,119,81,68%
0130,CHERRY CREEK 5,7116,PONDEROSA ELEMENTARY SCHOOL,1ST,1,14,39,46,30,130,100,77%
0130,CHERRY CREEK 5,7116,PONDEROSA ELEMENTARY SCHOOL,2ND,0,3,37,33,23,96,73,76%
0130,CHERRY CREEK 5,7116,PONDEROSA ELEMENTARY SCHOOL,3RD,1,6,33,29,29,98,69,70%
0130,CHERRY CREEK 5,7116,PONDEROSA ELEMENTARY SCHOOL,4TH,1,4,39,42,23,109,86,79%
0130,CHERRY CREEK 5,7116,PONDEROSA ELEMENTARY SCHOOL,5TH,2,12,37,30,27,108,81,75%
0130,CHERRY CREEK 5,7116,PONDEROSA ELEMENTARY SCHOOL,SCHOOL TOTAL,8,57,249,236,186,736,550,75%
0130,CHERRY CREEK 5,7158,PRAIRIE MIDDLE SCHOOL,6TH,4,27,176,169,131,507,376,74%
0130,CHERRY CREEK 5,7158,PRAIRIE MIDDLE SCHOOL,7TH,4,32,167,150,132,485,353,73%
0130,CHERRY CREEK 5,7158,PRAIRIE MIDDLE SCHOOL,8TH,3,37,213,170,135,558,423,76%
0130,CHERRY CREEK 5,7158,PRAIRIE MIDDLE SCHOOL,SCHOOL TOTAL,11,96,556,489,398,1550,1152,74%
0130,CHERRY CREEK 5,7277,RED HAWK RIDGE ELEMENTARY SCHOOL,PK,0,11,6,9,58,84,26,31%
0130,CHERRY CREEK 5,7277,RED HAWK RIDGE ELEMENTARY SCHOOL,HALF DAY K,0,15,9,19,74,117,43,37%
0130,CHERRY CREEK 5,7277,RED HAWK RIDGE ELEMENTARY SCHOOL,1ST,1,13,8,16,66,104,38,37%
0130,CHERRY CREEK 5,7277,RED HAWK RIDGE ELEMENTARY SCHOOL,2ND,0,14,14,19,55,102,47,46%
0130,CHERRY CREEK 5,7277,RED HAWK RIDGE ELEMENTARY SCHOOL,3RD,2,3,6,19,58,88,30,34%
0130,CHERRY CREEK 5,7277,RED HAWK RIDGE ELEMENTARY SCHOOL,4TH,3,4,13,14,61,95,34,36%
0130,CHERRY CREEK 5,7277,RED HAWK RIDGE ELEMENTARY SCHOOL,5TH,1,5,20,20,48,94,46,49%
0130,CHERRY CREEK 5,7277,RED HAWK RIDGE ELEMENTARY SCHOOL,SCHOOL TOTAL,7,65,76,116,420,684,264,39%
0130,CHERRY CREEK 5,7476,ROLLING HILLS ELEMENTARY SCHOOL,HALF DAY K,0,19,10,11,72,112,40,36%
0130,CHERRY CREEK 5,7476,ROLLING HILLS ELEMENTARY SCHOOL,1ST,0,13,11,5,76,105,29,28%
0130,CHERRY CREEK 5,7476,ROLLING HILLS ELEMENTARY SCHOOL,2ND,0,12,7,8,88,115,27,23%
0130,CHERRY CREEK 5,7476,ROLLING HILLS ELEMENTARY SCHOOL,3RD,0,10,13,10,93,126,33,26%
0130,CHERRY CREEK 5,7476,ROLLING HILLS ELEMENTARY SCHOOL,4TH,0,14,12,4,87,117,30,26%
0130,CHERRY CREEK 5,7476,ROLLING HILLS ELEMENTARY SCHOOL,5TH,1,24,12,12,89,138,49,36%
0130,CHERRY CREEK 5,7476,ROLLING HILLS ELEMENTARY SCHOOL,SCHOOL TOTAL,1,92,65,50,505,713,208,29%
0130,CHERRY CREEK 5,7559,SAGEBRUSH ELEMENTARY SCHOOL,HALF DAY K,2,9,16,12,35,74,39,53%
0130,CHERRY CREEK 5,7559,SAGEBRUSH ELEMENTARY SCHOOL,1ST,0,3,14,14,55,86,31,36%
0130,CHERRY CREEK 5,7559,SAGEBRUSH ELEMENTARY SCHOOL,2ND,1,9,17,23,59,109,50,46%
0130,CHERRY CREEK 5,7559,SAGEBRUSH ELEMENTARY SCHOOL,3RD,0,6,19,14,62,101,39,39%
0130,CHERRY CREEK 5,7559,SAGEBRUSH ELEMENTARY SCHOOL,4TH,0,12,23,21,51,107,56,52%
0130,CHERRY CREEK 5,7559,SAGEBRUSH ELEMENTARY SCHOOL,5TH,2,14,24,8,70,118,48,41%
0130,CHERRY CREEK 5,7559,SAGEBRUSH ELEMENTARY SCHOOL,SCHOOL TOTAL,5,53,113,92,332,595,263,44%
0130,CHERRY CREEK 5,8020,SMOKY HILL HIGH SCHOOL,9TH,5,43,117,76,311,552,241,44%
0130,CHERRY CREEK 5,8020,SMOKY HILL HIGH SCHOOL,10TH,4,58,129,75,358,624,266,43%
0130,CHERRY CREEK 5,8020,SMOKY HILL HIGH SCHOOL,11TH,3,43,110,67,375,598,223,37%
0130,CHERRY CREEK 5,8020,SMOKY HILL HIGH SCHOOL,12TH,8,45,129,62,356,600,244,41%
0130,CHERRY CREEK 5,8020,SMOKY HILL HIGH SCHOOL,SCHOOL TOTAL,20,189,485,280,1400,2374,974,41%
0130,CHERRY CREEK 5,8380,SUMMIT ELEMENTARY SCHOOL,HALF DAY K,1,1,7,13,44,66,22,33%
0130,CHERRY CREEK 5,8380,SUMMIT ELEMENTARY SCHOOL,1ST,0,5,16,11,48,80,32,40%
0130,CHERRY CREEK 5,8380,SUMMIT ELEMENTARY SCHOOL,2ND,2,1,23,13,33,72,39,54%
0130,CHERRY CREEK 5,8380,SUMMIT ELEMENTARY SCHOOL,3RD,0,4,11,17,53,85,32,38%
0130,CHERRY CREEK 5,8380,SUMMIT ELEMENTARY SCHOOL,4TH,4,3,20,15,39,81,42,52%
0130,CHERRY CREEK 5,8380,SUMMIT ELEMENTARY SCHOOL,5TH,1,5,14,17,57,94,37,39%
0130,CHERRY CREEK 5,8380,SUMMIT ELEMENTARY SCHOOL,SCHOOL TOTAL,8,19,91,86,274,478,204,43%
0130,CHERRY CREEK 5,8394,SUNRISE ELEMENTARY SCHOOL,PK,0,2,12,15,34,63,29,46%
0130,CHERRY CREEK 5,8394,SUNRISE ELEMENTARY SCHOOL,HALF DAY K,3,5,19,17,52,96,44,46%
0130,CHERRY CREEK 5,8394,SUNRISE ELEMENTARY SCHOOL,1ST,0,2,29,28,49,108,59,55%
0130,CHERRY CREEK 5,8394,SUNRISE ELEMENTARY SCHOOL,2ND,1,7,15,23,57,103,46,45%
0130,CHERRY CREEK 5,8394,SUNRISE ELEMENTARY SCHOOL,3RD,1,8,27,19,74,129,55,43%
0130,CHERRY CREEK 5,8394,SUNRISE ELEMENTARY SCHOOL,4TH,1,6,19,18,61,105,44,42%
0130,CHERRY CREEK 5,8394,SUNRISE ELEMENTARY SCHOOL,5TH,3,7,25,18,50,103,53,51%
0130,CHERRY CREEK 5,8394,SUNRISE ELEMENTARY SCHOOL,SCHOOL TOTAL,9,37,146,138,377,707,330,47%
0130,CHERRY CREEK 5,8848,THUNDER RIDGE MIDDLE SCHOOL,6TH,3,29,59,53,261,405,144,36%
0130,CHERRY CREEK 5,8848,THUNDER RIDGE MIDDLE SCHOOL,7TH,2,26,56,59,247,390,143,37%
0130,CHERRY CREEK 5,8848,THUNDER RIDGE MIDDLE SCHOOL,8TH,0,35,56,45,285,421,136,32%
0130,CHERRY CREEK 5,8848,THUNDER RIDGE MIDDLE SCHOOL,SCHOOL TOTAL,5,90,171,157,793,1216,423,35%
0130,CHERRY CREEK 5,8850,TIMBERLINE ELEMENTARY SCHOOL,PK,0,12,7,5,71,95,24,25%
0130,CHERRY CREEK 5,8850,TIMBERLINE ELEMENTARY SCHOOL,HALF DAY K,0,7,11,7,77,102,25,25%
0130,CHERRY CREEK 5,8850,TIMBERLINE ELEMENTARY SCHOOL,1ST,1,5,8,9,94,117,23,20%
0130,CHERRY CREEK 5,8850,TIMBERLINE ELEMENTARY SCHOOL,2ND,0,10,4,13,82,109,27,25%
0130,CHERRY CREEK 5,8850,TIMBERLINE ELEMENTARY SCHOOL,3RD,1,8,9,7,78,103,25,24%
0130,CHERRY CREEK 5,8850,TIMBERLINE ELEMENTARY SCHOOL,4TH,1,7,14,10,81,113,32,28%
0130,CHERRY CREEK 5,8850,TIMBERLINE ELEMENTARY SCHOOL,5TH,0,6,10,8,91,115,24,21%
0130,CHERRY CREEK 5,8850,TIMBERLINE ELEMENTARY SCHOOL,SCHOOL TOTAL,3,55,63,59,574,754,180,24%
0130,CHERRY CREEK 5,8887,TRAILS WEST ELEMENTARY SCHOOL,PK,0,9,6,5,65,85,20,24%
0130,CHERRY CREEK 5,8887,TRAILS WEST ELEMENTARY SCHOOL,HALF DAY K,0,9,5,6,68,88,20,23%
0130,CHERRY CREEK 5,8887,TRAILS WEST ELEMENTARY SCHOOL,1ST,0,5,7,10,59,81,22,27%
0130,CHERRY CREEK 5,8887,TRAILS WEST ELEMENTARY SCHOOL,2ND,1,5,10,5,68,89,21,24%
0130,CHERRY CREEK 5,8887,TRAILS WEST ELEMENTARY SCHOOL,3RD,0,5,8,7,81,101,20,20%
0130,CHERRY CREEK 5,8887,TRAILS WEST ELEMENTARY SCHOOL,4TH,1,8,12,7,58,86,28,33%
0130,CHERRY CREEK 5,8887,TRAILS WEST ELEMENTARY SCHOOL,5TH,2,9,7,10,63,91,28,31%
0130,CHERRY CREEK 5,8887,TRAILS WEST ELEMENTARY SCHOOL,SCHOOL TOTAL,4,50,55,50,462,621,159,26%
0130,CHERRY CREEK 5,9108,VILLAGE EAST COMMUNITY ELEMENTARY SCHOOL,KINDERGARTEN,1,16,45,44,46,152,106,70%
0130,CHERRY CREEK 5,9108,VILLAGE EAST COMMUNITY ELEMENTARY SCHOOL,1ST,2,13,52,59,42,168,126,75%
0130,CHERRY CREEK 5,9108,VILLAGE EAST COMMUNITY ELEMENTARY SCHOOL,2ND,2,6,47,35,37,127,90,71%
0130,CHERRY CREEK 5,9108,VILLAGE EAST COMMUNITY ELEMENTARY SCHOOL,3RD,0,12,47,40,25,124,99,80%
0130,CHERRY CREEK 5,9108,VILLAGE EAST COMMUNITY ELEMENTARY SCHOOL,4TH,1,16,58,38,30,143,113,79%
0130,CHERRY CREEK 5,9108,VILLAGE EAST COMMUNITY ELEMENTARY SCHOOL,5TH,1,6,39,35,21,102,81,79%
0130,CHERRY CREEK 5,9108,VILLAGE EAST COMMUNITY ELEMENTARY SCHOOL,SCHOOL TOTAL,7,69,288,251,201,816,615,75%
0130,CHERRY CREEK 5,9200,WALNUT HILLS COMMUNITY ELEMENTARY SCHOOL,PK,1,6,1,9,38,55,17,31%
0130,CHERRY CREEK 5,9200,WALNUT HILLS COMMUNITY ELEMENTARY SCHOOL,HALF DAY K,0,4,4,2,61,71,10,14%
0130,CHERRY CREEK 5,9200,WALNUT HILLS COMMUNITY ELEMENTARY SCHOOL,1ST,1,3,2,6,42,54,12,22%
0130,CHERRY CREEK 5,9200,WALNUT HILLS COMMUNITY ELEMENTARY SCHOOL,2ND,0,4,2,4,43,53,10,19%
0130,CHERRY CREEK 5,9200,WALNUT HILLS COMMUNITY ELEMENTARY SCHOOL,3RD,0,5,1,5,54,65,11,17%
0130,CHERRY CREEK 5,9200,WALNUT HILLS COMMUNITY ELEMENTARY SCHOOL,4TH,1,5,1,5,63,75,12,16%
0130,CHERRY CREEK 5,9200,WALNUT HILLS COMMUNITY ELEMENTARY SCHOOL,5TH,1,2,2,1,49,55,6,11%
0130,CHERRY CREEK 5,9200,WALNUT HILLS COMMUNITY ELEMENTARY SCHOOL,SCHOOL TOTAL,4,29,13,32,350,428,78,18%
0130,CHERRY CREEK 5,9624,WILLOW CREEK ELEMENTARY SCHOOL,HALF DAY K,0,10,3,3,65,81,16,20%
0130,CHERRY CREEK 5,9624,WILLOW CREEK ELEMENTARY SCHOOL,1ST,1,13,5,2,68,89,21,24%
0130,CHERRY CREEK 5,9624,WILLOW CREEK ELEMENTARY SCHOOL,2ND,0,15,3,2,77,97,20,21%
0130,CHERRY CREEK 5,9624,WILLOW CREEK ELEMENTARY SCHOOL,3RD,1,15,2,4,76,98,22,22%
0130,CHERRY CREEK 5,9624,WILLOW CREEK ELEMENTARY SCHOOL,4TH,0,12,2,5,74,93,19,20%
0130,CHERRY CREEK 5,9624,WILLOW CREEK ELEMENTARY SCHOOL,5TH,0,6,4,3,82,95,13,14%
0130,CHERRY CREEK 5,9624,WILLOW CREEK ELEMENTARY SCHOOL,SCHOOL TOTAL,2,71,19,19,442,553,111,20%
0130,CHERRY CREEK 5,,DISTRICT TOTAL,,295,4456,7592,7224,32141,51708,19567,38%
0140,LITTLETON 6,0298,ARAPAHOE HIGH SCHOOL,9TH,2,14,5,39,500,560,60,11%
0140,LITTLETON 6,0298,ARAPAHOE HIGH SCHOOL,10TH,4,18,5,23,496,546,50,9%
0140,LITTLETON 6,0298,ARAPAHOE HIGH SCHOOL,11TH,1,9,10,28,501,549,48,9%
0140,LITTLETON 6,0298,ARAPAHOE HIGH SCHOOL,12TH,3,19,8,35,531,596,65,11%
0140,LITTLETON 6,0298,ARAPAHOE HIGH SCHOOL,SCHOOL TOTAL,10,60,28,125,2028,2251,223,10%
0140,LITTLETON 6,0752,FRANKLIN ELEMENTARY SCHOOL,HALF DAY K,0,1,1,1,77,80,3,4%
0140,LITTLETON 6,0752,FRANKLIN ELEMENTARY SCHOOL,1ST,2,5,0,4,80,91,11,12%
0140,LITTLETON 6,0752,FRANKLIN ELEMENTARY SCHOOL,2ND,3,5,1,7,71,87,16,18%
0140,LITTLETON 6,0752,FRANKLIN ELEMENTARY SCHOOL,3RD,0,2,0,7,51,60,9,15%
0140,LITTLETON 6,0752,FRANKLIN ELEMENTARY SCHOOL,4TH,1,4,1,4,81,91,10,11%
0140,LITTLETON 6,0752,FRANKLIN ELEMENTARY SCHOOL,5TH,0,7,1,8,64,80,16,20%
0140,LITTLETON 6,0752,FRANKLIN ELEMENTARY SCHOOL,SCHOOL TOTAL,6,24,4,31,424,489,65,13%
0140,LITTLETON 6,1382,CENTENNIAL ACADEMY OF FINE ARTS EDUCATION,KINDERGARTEN,0,3,3,17,81,104,23,22%
0140,LITTLETON 6,1382,CENTENNIAL ACADEMY OF FINE ARTS EDUCATION,1ST,0,2,4,24,77,107,30,28%
0140,LITTLETON 6,1382,CENTENNIAL ACADEMY OF FINE ARTS EDUCATION,2ND,0,4,4,12,59,79,20,25%
0140,LITTLETON 6,1382,CENTENNIAL ACADEMY OF FINE ARTS EDUCATION,3RD,1,5,3,21,56,86,30,35%
0140,LITTLETON 6,1382,CENTENNIAL ACADEMY OF FINE ARTS EDUCATION,4TH,1,2,1,21,48,73,25,34%
0140,LITTLETON 6,1382,CENTENNIAL ACADEMY OF FINE ARTS EDUCATION,5TH,0,4,5,18,57,84,27,32%
0140,LITTLETON 6,1382,CENTENNIAL ACADEMY OF FINE ARTS EDUCATION,SCHOOL TOTAL,2,20,20,113,378,533,155,29%
0140,LITTLETON 6,2382,EAST ELEMENTARY SCHOOL,KINDERGARTEN,0,0,0,13,26,39,13,33%
0140,LITTLETON 6,2382,EAST ELEMENTARY SCHOOL,1ST,4,0,0,23,11,38,27,71%
0140,LITTLETON 6,2382,EAST ELEMENTARY SCHOOL,2ND,1,1,1,13,18,34,16,47%
0140,LITTLETON 6,2382,EAST ELEMENTARY SCHOOL,3RD,0,1,2,19,16,38,22,58%
0140,LITTLETON 6,2382,EAST ELEMENTARY SCHOOL,4TH,0,1,4,15,20,40,20,50%
0140,LITTLETON 6,2382,EAST ELEMENTARY SCHOOL,5TH,1,1,1,17,12,32,20,63%
0140,LITTLETON 6,2382,EAST ELEMENTARY SCHOOL,SCHOOL TOTAL,6,4,8,100,103,221,118,53%
0140,LITTLETON 6,2804,EUCLID MIDDLE SCHOOL,6TH,2,10,9,39,193,253,60,24%
0140,LITTLETON 6,2804,EUCLID MIDDLE SCHOOL,7TH,3,13,5,28,181,230,49,21%
0140,LITTLETON 6,2804,EUCLID MIDDLE SCHOOL,8TH,2,6,9,30,206,253,47,19%
0140,LITTLETON 6,2804,EUCLID MIDDLE SCHOOL,SCHOOL TOTAL,7,29,23,97,580,736,156,21%
0140,LITTLETON 6,2926,FIELD ELEMENTARY SCHOOL,HALF DAY K,0,0,0,1,0,1,1,100%
0140,LITTLETON 6,2926,FIELD ELEMENTARY SCHOOL,KINDERGARTEN,0,1,0,40,37,78,41,53%
0140,LITTLETON 6,2926,FIELD ELEMENTARY SCHOOL,1ST,1,0,3,43,25,72,47,65%
0140,LITTLETON 6,2926,FIELD ELEMENTARY SCHOOL,2ND,0,2,3,39,34,78,44,56%
0140,LITTLETON 6,2926,FIELD ELEMENTARY SCHOOL,3RD,0,2,1,27,37,67,30,45%
0140,LITTLETON 6,2926,FIELD ELEMENTARY SCHOOL,4TH,0,2,6,38,33,79,46,58%
0140,LITTLETON 6,2926,FIELD ELEMENTARY SCHOOL,5TH,0,0,6,33,24,63,39,62%
0140,LITTLETON 6,2926,FIELD ELEMENTARY SCHOOL,SCHOOL TOTAL,1,7,19,221,190,438,248,57%
0140,LITTLETON 6,3472,GODDARD MIDDLE SCHOOL,6TH,5,12,4,65,201,287,86,30%
0140,LITTLETON 6,3472,GODDARD MIDDLE SCHOOL,7TH,0,8,9,68,154,239,85,36%
0140,LITTLETON 6,3472,GODDARD MIDDLE SCHOOL,8TH,3,3,5,46,184,241,57,24%
0140,LITTLETON 6,3472,GODDARD MIDDLE SCHOOL,SCHOOL TOTAL,8,23,18,179,539,767,228,30%
0140,LITTLETON 6,3930,HERITAGE HIGH SCHOOL,9TH,3,8,14,36,409,470,61,13%
0140,LITTLETON 6,3930,HERITAGE HIGH SCHOOL,10TH,3,11,7,35,356,412,56,14%
0140,LITTLETON 6,3930,HERITAGE HIGH SCHOOL,11TH,4,11,14,33,365,427,62,15%
0140,LITTLETON 6,3930,HERITAGE HIGH SCHOOL,12TH,3,10,9,24,367,413,46,11%
0140,LITTLETON 6,3930,HERITAGE HIGH SCHOOL,SCHOOL TOTAL,13,40,44,128,1497,1722,225,13%
0140,LITTLETON 6,3950,HIGHLAND ELEMENTARY SCHOOL,PK,0,0,0,0,33,33,0,0%
0140,LITTLETON 6,3950,HIGHLAND ELEMENTARY SCHOOL,HALF DAY K,1,3,1,3,51,59,8,14%
0140,LITTLETON 6,3950,HIGHLAND ELEMENTARY SCHOOL,1ST,0,4,1,4,59,68,9,13%
0140,LITTLETON 6,3950,HIGHLAND ELEMENTARY SCHOOL,2ND,0,9,1,8,42,60,18,30%
0140,LITTLETON 6,3950,HIGHLAND ELEMENTARY SCHOOL,3RD,0,3,1,4,48,56,8,14%
0140,LITTLETON 6,3950,HIGHLAND ELEMENTARY SCHOOL,4TH,0,8,1,8,64,81,17,21%
0140,LITTLETON 6,3950,HIGHLAND ELEMENTARY SCHOOL,5TH,0,4,1,11,64,80,16,20%
0140,LITTLETON 6,3950,HIGHLAND ELEMENTARY SCHOOL,SCHOOL TOTAL,1,31,6,38,361,437,76,17%
0140,LITTLETON 6,4316,NEWTON MIDDLE SCHOOL,6TH,2,11,2,20,206,241,35,15%
0140,LITTLETON 6,4316,NEWTON MIDDLE SCHOOL,7TH,2,5,4,11,196,218,22,10%
0140,LITTLETON 6,4316,NEWTON MIDDLE SCHOOL,8TH,2,6,3,13,211,235,24,10%
0140,LITTLETON 6,4316,NEWTON MIDDLE SCHOOL,SCHOOL TOTAL,6,22,9,44,613,694,81,12%
0140,LITTLETON 6,4447,JOHN WESLEY POWELL MIDDLE SCHOOL,6TH,0,12,4,22,223,261,38,15%
0140,LITTLETON 6,4447,JOHN WESLEY POWELL MIDDLE SCHOOL,7TH,2,10,6,18,239,275,36,13%
0140,LITTLETON 6,4447,JOHN WESLEY POWELL MIDDLE SCHOOL,8TH,4,7,3,19,276,309,33,11%
0140,LITTLETON 6,4447,JOHN WESLEY POWELL MIDDLE SCHOOL,SCHOOL TOTAL,6,29,13,59,738,845,107,13%
0140,LITTLETON 6,5224,LITTLETON HIGH SCHOOL,9TH,6,9,10,50,280,355,75,21%
0140,LITTLETON 6,5224,LITTLETON HIGH SCHOOL,10TH,1,13,12,60,300,386,86,22%
0140,LITTLETON 6,5224,LITTLETON HIGH SCHOOL,11TH,5,7,13,53,306,384,78,20%
0140,LITTLETON 6,5224,LITTLETON HIGH SCHOOL,12TH,2,15,11,56,329,413,84,20%
0140,LITTLETON 6,5224,LITTLETON HIGH SCHOOL,SCHOOL TOTAL,14,44,46,219,1215,1538,323,21%
0140,LITTLETON 6,5229,LITTLETON ACADEMY,HALF DAY K,0,10,0,2,39,51,12,24%
0140,LITTLETON 6,5229,LITTLETON ACADEMY,1ST,0,5,0,1,44,50,6,12%
0140,LITTLETON 6,5229,LITTLETON ACADEMY,2ND,1,3,1,1,45,51,6,12%
0140,LITTLETON 6,5229,LITTLETON ACADEMY,3RD,0,9,1,4,38,52,14,27%
0140,LITTLETON 6,5229,LITTLETON ACADEMY,4TH,0,7,0,3,42,52,10,19%
0140,LITTLETON 6,5229,LITTLETON ACADEMY,5TH,0,5,0,2,45,52,7,13%
0140,LITTLETON 6,5229,LITTLETON ACADEMY,6TH,0,9,0,2,41,52,11,21%
0140,LITTLETON 6,5229,LITTLETON ACADEMY,7TH,0,9,1,1,41,52,11,21%
0140,LITTLETON 6,5229,LITTLETON ACADEMY,8TH,0,7,1,1,40,49,9,18%
0140,LITTLETON 6,5229,LITTLETON ACADEMY,SCHOOL TOTAL,1,64,4,17,375,461,86,19%
0140,LITTLETON 6,5233,LITTLETON PREP CHARTER SCHOOL,HALF DAY K,0,0,1,13,44,58,14,24%
0140,LITTLETON 6,5233,LITTLETON PREP CHARTER SCHOOL,1ST,0,0,3,6,51,60,9,15%
0140,LITTLETON 6,5233,LITTLETON PREP CHARTER SCHOOL,2ND,0,2,1,15,41,59,18,31%
0140,LITTLETON 6,5233,LITTLETON PREP CHARTER SCHOOL,3RD,0,0,2,22,36,60,24,40%
0140,LITTLETON 6,5233,LITTLETON PREP CHARTER SCHOOL,4TH,1,1,4,14,40,60,20,33%
0140,LITTLETON 6,5233,LITTLETON PREP CHARTER SCHOOL,5TH,0,1,2,23,34,60,26,43%
0140,LITTLETON 6,5233,LITTLETON PREP CHARTER SCHOOL,6TH,1,3,1,17,36,58,22,38%
0140,LITTLETON 6,5233,LITTLETON PREP CHARTER SCHOOL,7TH,0,1,1,19,35,56,21,38%
0140,LITTLETON 6,5233,LITTLETON PREP CHARTER SCHOOL,8TH,2,2,1,11,26,42,16,38%
0140,LITTLETON 6,5233,LITTLETON PREP CHARTER SCHOOL,SCHOOL TOTAL,4,10,16,140,343,513,170,33%
0140,LITTLETON 6,5236,LOIS LENSKI ELEMENTARY SCHOOL,HALF DAY K,0,3,2,3,87,95,8,8%
0140,LITTLETON 6,5236,LOIS LENSKI ELEMENTARY SCHOOL,1ST,0,5,0,6,90,101,11,11%
0140,LITTLETON 6,5236,LOIS LENSKI ELEMENTARY SCHOOL,2ND,0,4,2,2,101,109,8,7%
0140,LITTLETON 6,5236,LOIS LENSKI ELEMENTARY SCHOOL,3RD,1,6,2,7,80,96,16,17%
0140,LITTLETON 6,5236,LOIS LENSKI ELEMENTARY SCHOOL,4TH,0,5,0,6,96,107,11,10%
0140,LITTLETON 6,5236,LOIS LENSKI ELEMENTARY SCHOOL,5TH,0,5,1,5,97,108,11,10%
0140,LITTLETON 6,5236,LOIS LENSKI ELEMENTARY SCHOOL,SCHOOL TOTAL,1,28,7,29,551,616,65,11%
0140,LITTLETON 6,5572,HOPKINS ELEMENTARY SCHOOL,PK,0,0,0,0,53,53,0,0%
0140,LITTLETON 6,5572,HOPKINS ELEMENTARY SCHOOL,KINDERGARTEN,0,1,1,9,50,61,11,18%
0140,LITTLETON 6,5572,HOPKINS ELEMENTARY SCHOOL,1ST,0,0,0,6,39,45,6,13%
0140,LITTLETON 6,5572,HOPKINS ELEMENTARY SCHOOL,2ND,1,3,1,5,43,53,10,19%
0140,LITTLETON 6,5572,HOPKINS ELEMENTARY SCHOOL,3RD,1,2,3,6,45,57,12,21%
0140,LITTLETON 6,5572,HOPKINS ELEMENTARY SCHOOL,4TH,0,2,1,4,37,44,7,16%
0140,LITTLETON 6,5572,HOPKINS ELEMENTARY SCHOOL,5TH,2,2,3,2,34,43,9,21%
0140,LITTLETON 6,5572,HOPKINS ELEMENTARY SCHOOL,SCHOOL TOTAL,4,10,9,32,301,356,55,15%
0140,LITTLETON 6,5574,TWAIN ELEMENTARY SCHOOL,HALF DAY K,0,2,0,1,47,50,3,6%
0140,LITTLETON 6,5574,TWAIN ELEMENTARY SCHOOL,1ST,0,2,0,4,47,53,6,11%
0140,LITTLETON 6,5574,TWAIN ELEMENTARY SCHOOL,2ND,0,2,1,4,55,62,7,11%
0140,LITTLETON 6,5574,TWAIN ELEMENTARY SCHOOL,3RD,0,0,1,2,58,61,3,5%
0140,LITTLETON 6,5574,TWAIN ELEMENTARY SCHOOL,4TH,1,3,2,6,41,53,12,23%
0140,LITTLETON 6,5574,TWAIN ELEMENTARY SCHOOL,5TH,1,3,1,9,63,77,14,18%
0140,LITTLETON 6,5574,TWAIN ELEMENTARY SCHOOL,SCHOOL TOTAL,2,12,5,26,311,356,45,13%
0140,LITTLETON 6,6292,VILLAGE AT NORTH,PK,1,2,1,9,271,284,13,5%
0140,LITTLETON 6,6292,VILLAGE AT NORTH,SCHOOL TOTAL,1,2,1,9,271,284,13,5%
0140,LITTLETON 6,6814,PEABODY ELEMENTARY SCHOOL,HALF DAY K,0,0,2,5,60,67,7,10%
0140,LITTLETON 6,6814,PEABODY ELEMENTARY SCHOOL,1ST,0,3,1,4,66,74,8,11%
0140,LITTLETON 6,6814,PEABODY ELEMENTARY SCHOOL,2ND,0,2,3,2,64,71,7,10%
0140,LITTLETON 6,6814,PEABODY ELEMENTARY SCHOOL,3RD,0,2,1,7,53,63,10,16%
0140,LITTLETON 6,6814,PEABODY ELEMENTARY SCHOOL,4TH,0,1,0,5,70,76,6,8%
0140,LITTLETON 6,6814,PEABODY ELEMENTARY SCHOOL,5TH,1,3,3,7,65,79,14,18%
0140,LITTLETON 6,6814,PEABODY ELEMENTARY SCHOOL,SCHOOL TOTAL,1,11,10,30,378,430,52,12%
0140,LITTLETON 6,7518,RUNYON ELEMENTARY SCHOOL,HALF DAY K,0,0,0,3,67,70,3,4%
0140,LITTLETON 6,7518,RUNYON ELEMENTARY SCHOOL,1ST,0,2,1,7,60,70,10,14%
0140,LITTLETON 6,7518,RUNYON ELEMENTARY SCHOOL,2ND,0,3,0,6,63,72,9,13%
0140,LITTLETON 6,7518,RUNYON ELEMENTARY SCHOOL,3RD,0,2,1,5,69,77,8,10%
0140,LITTLETON 6,7518,RUNYON ELEMENTARY SCHOOL,4TH,0,1,1,6,74,82,8,10%
0140,LITTLETON 6,7518,RUNYON ELEMENTARY SCHOOL,5TH,0,5,0,8,68,81,13,16%
0140,LITTLETON 6,7518,RUNYON ELEMENTARY SCHOOL,SCHOOL TOTAL,0,13,3,35,401,452,51,11%
0140,LITTLETON 6,7606,SANDBURG ELEMENTARY SCHOOL,PK,0,1,1,0,52,54,2,4%
0140,LITTLETON 6,7606,SANDBURG ELEMENTARY SCHOOL,HALF DAY K,0,5,1,0,78,84,6,7%
0140,LITTLETON 6,7606,SANDBURG ELEMENTARY SCHOOL,1ST,1,5,2,2,81,91,10,11%
0140,LITTLETON 6,7606,SANDBURG ELEMENTARY SCHOOL,2ND,0,3,1,1,70,75,5,7%
0140,LITTLETON 6,7606,SANDBURG ELEMENTARY SCHOOL,3RD,0,2,0,2,69,73,4,5%
0140,LITTLETON 6,7606,SANDBURG ELEMENTARY SCHOOL,4TH,1,3,0,4,71,79,8,10%
0140,LITTLETON 6,7606,SANDBURG ELEMENTARY SCHOOL,5TH,1,2,2,3,72,80,8,10%
0140,LITTLETON 6,7606,SANDBURG ELEMENTARY SCHOOL,SCHOOL TOTAL,3,21,7,12,493,536,43,8%
0140,LITTLETON 6,8064,MOODY ELEMENTARY SCHOOL,PK,0,0,0,0,35,35,0,0%
0140,LITTLETON 6,8064,MOODY ELEMENTARY SCHOOL,HALF DAY K,0,0,0,0,1,1,0,0%
0140,LITTLETON 6,8064,MOODY ELEMENTARY SCHOOL,KINDERGARTEN,1,2,5,9,57,74,17,23%
0140,LITTLETON 6,8064,MOODY ELEMENTARY SCHOOL,1ST,1,4,5,13,45,68,23,34%
0140,LITTLETON 6,8064,MOODY ELEMENTARY SCHOOL,2ND,1,1,5,10,48,65,17,26%
0140,LITTLETON 6,8064,MOODY ELEMENTARY SCHOOL,3RD,0,1,3,9,47,60,13,22%
0140,LITTLETON 6,8064,MOODY ELEMENTARY SCHOOL,4TH,1,4,6,14,42,67,25,37%
0140,LITTLETON 6,8064,MOODY ELEMENTARY SCHOOL,5TH,1,3,8,10,42,64,22,34%
0140,LITTLETON 6,8064,MOODY ELEMENTARY SCHOOL,SCHOOL TOTAL,5,15,32,65,317,434,117,27%
0140,LITTLETON 6,9600,WILDER ELEMENTARY SCHOOL,HALF DAY K,0,1,1,3,88,93,5,5%
0140,LITTLETON 6,9600,WILDER ELEMENTARY SCHOOL,1ST,0,3,0,4,100,107,7,7%
0140,LITTLETON 6,9600,WILDER ELEMENTARY SCHOOL,2ND,1,2,1,7,96,107,11,10%
0140,LITTLETON 6,9600,WILDER ELEMENTARY SCHOOL,3RD,0,7,1,4,94,106,12,11%
0140,LITTLETON 6,9600,WILDER ELEMENTARY SCHOOL,4TH,0,2,2,4,99,107,8,7%
0140,LITTLETON 6,9600,WILDER ELEMENTARY SCHOOL,5TH,1,2,1,5,115,124,9,7%
0140,LITTLETON 6,9600,WILDER ELEMENTARY SCHOOL,SCHOOL TOTAL,2,17,6,27,592,644,52,8%
0140,LITTLETON 6,,DISTRICT TOTAL,,104,536,338,1776,12999,15753,2754,17%
0170,DEER TRAIL 26J,2136,DEER TRAIL ELEMENTARY SCHOOL,PK,0,0,0,2,13,15,2,13%
0170,DEER TRAIL 26J,2136,DEER TRAIL ELEMENTARY SCHOOL,KINDERGARTEN,0,0,0,1,10,11,1,9%
0170,DEER TRAIL 26J,2136,DEER TRAIL ELEMENTARY SCHOOL,1ST,0,0,0,0,9,9,0,0%
0170,DEER TRAIL 26J,2136,DEER TRAIL ELEMENTARY SCHOOL,2ND,0,0,1,0,10,11,1,9%
0170,DEER TRAIL 26J,2136,DEER TRAIL ELEMENTARY SCHOOL,3RD,0,0,0,0,9,9,0,0%
0170,DEER TRAIL 26J,2136,DEER TRAIL ELEMENTARY SCHOOL,4TH,0,0,0,0,12,12,0,0%
0170,DEER TRAIL 26J,2136,DEER TRAIL ELEMENTARY SCHOOL,5TH,1,0,0,0,9,10,1,10%
0170,DEER TRAIL 26J,2136,DEER TRAIL ELEMENTARY SCHOOL,SCHOOL TOTAL,1,0,1,3,72,77,5,6%
0170,DEER TRAIL 26J,2140,DEER TRAIL JUNIOR-SENIOR HIGH SCHOOL,6TH,0,0,0,0,8,8,0,0%
0170,DEER TRAIL 26J,2140,DEER TRAIL JUNIOR-SENIOR HIGH SCHOOL,7TH,0,0,0,0,8,8,0,0%
0170,DEER TRAIL 26J,2140,DEER TRAIL JUNIOR-SENIOR HIGH SCHOOL,8TH,0,0,1,0,11,12,1,8%
0170,DEER TRAIL 26J,2140,DEER TRAIL JUNIOR-SENIOR HIGH SCHOOL,9TH,0,1,0,1,12,14,2,14%
0170,DEER TRAIL 26J,2140,DEER TRAIL JUNIOR-SENIOR HIGH SCHOOL,10TH,0,1,1,3,16,21,5,24%
0170,DEER TRAIL 26J,2140,DEER TRAIL JUNIOR-SENIOR HIGH SCHOOL,11TH,0,0,0,0,15,15,0,0%
0170,DEER TRAIL 26J,2140,DEER TRAIL JUNIOR-SENIOR HIGH SCHOOL,12TH,0,0,0,0,10,10,0,0%
0170,DEER TRAIL 26J,2140,DEER TRAIL JUNIOR-SENIOR HIGH SCHOOL,SCHOOL TOTAL,0,2,2,4,80,88,8,9%
0170,DEER TRAIL 26J,,DISTRICT TOTAL,,1,2,3,7,152,165,13,8%
0180,ADAMS-ARAPAHOE 28J,0213,AXL ACADEMY,KINDERGARTEN,0,2,10,11,13,36,23,64%
0180,ADAMS-ARAPAHOE 28J,0213,AXL ACADEMY,1ST,0,1,10,15,15,41,26,63%
0180,ADAMS-ARAPAHOE 28J,0213,AXL ACADEMY,2ND,0,1,14,10,18,43,25,58%
0180,ADAMS-ARAPAHOE 28J,0213,AXL ACADEMY,3RD,0,2,13,13,14,42,28,67%
0180,ADAMS-ARAPAHOE 28J,0213,AXL ACADEMY,4TH,0,2,13,12,11,38,27,71%
0180,ADAMS-ARAPAHOE 28J,0213,AXL ACADEMY,5TH,1,0,11,13,16,41,25,61%
0180,ADAMS-ARAPAHOE 28J,0213,AXL ACADEMY,6TH,0,1,13,11,16,41,25,61%
0180,ADAMS-ARAPAHOE 28J,0213,AXL ACADEMY,SCHOOL TOTAL,1,9,84,85,103,282,179,63%
0180,ADAMS-ARAPAHOE 28J,0214,ALTURA ELEMENTARY SCHOOL,PK,0,1,2,23,3,29,26,90%
0180,ADAMS-ARAPAHOE 28J,0214,ALTURA ELEMENTARY SCHOOL,KINDERGARTEN,1,1,6,62,13,83,70,84%
0180,ADAMS-ARAPAHOE 28J,0214,ALTURA ELEMENTARY SCHOOL,1ST,1,1,12,58,12,84,72,86%
0180,ADAMS-ARAPAHOE 28J,0214,ALTURA ELEMENTARY SCHOOL,2ND,0,0,10,46,9,65,56,86%
0180,ADAMS-ARAPAHOE 28J,0214,ALTURA ELEMENTARY SCHOOL,3RD,0,1,8,55,6,70,64,91%
0180,ADAMS-ARAPAHOE 28J,0214,ALTURA ELEMENTARY SCHOOL,4TH,0,0,14,62,10,86,76,88%
0180,ADAMS-ARAPAHOE 28J,0214,ALTURA ELEMENTARY SCHOOL,5TH,0,0,10,59,6,75,69,92%
0180,ADAMS-ARAPAHOE 28J,0214,ALTURA ELEMENTARY SCHOOL,SCHOOL TOTAL,2,4,62,365,59,492,433,88%
0180,ADAMS-ARAPAHOE 28J,0310,ARKANSAS ELEMENTARY SCHOOL,PK,0,0,15,30,17,62,45,73%
0180,ADAMS-ARAPAHOE 28J,0310,ARKANSAS ELEMENTARY SCHOOL,HALF DAY K,1,5,22,25,23,76,53,70%
0180,ADAMS-ARAPAHOE 28J,0310,ARKANSAS ELEMENTARY SCHOOL,1ST,0,3,19,35,25,82,57,70%
0180,ADAMS-ARAPAHOE 28J,0310,ARKANSAS ELEMENTARY SCHOOL,2ND,1,1,22,40,20,84,64,76%
0180,ADAMS-ARAPAHOE 28J,0310,ARKANSAS ELEMENTARY SCHOOL,3RD,1,5,31,39,19,95,76,80%
0180,ADAMS-ARAPAHOE 28J,0310,ARKANSAS ELEMENTARY SCHOOL,4TH,0,4,22,30,28,84,56,67%
0180,ADAMS-ARAPAHOE 28J,0310,ARKANSAS ELEMENTARY SCHOOL,5TH,0,2,42,29,18,91,73,80%
0180,ADAMS-ARAPAHOE 28J,0310,ARKANSAS ELEMENTARY SCHOOL,SCHOOL TOTAL,3,20,173,228,150,574,424,74%
0180,ADAMS-ARAPAHOE 28J,0458,AURORA ACADEMY CHARTER SCHOOL,HALF DAY K,1,3,9,12,25,50,25,50%
0180,ADAMS-ARAPAHOE 28J,0458,AURORA ACADEMY CHARTER SCHOOL,1ST,0,1,16,12,21,50,29,58%
0180,ADAMS-ARAPAHOE 28J,0458,AURORA ACADEMY CHARTER SCHOOL,2ND,1,1,10,11,27,50,23,46%
0180,ADAMS-ARAPAHOE 28J,0458,AURORA ACADEMY CHARTER SCHOOL,3RD,1,1,15,13,20,50,30,60%
0180,ADAMS-ARAPAHOE 28J,0458,AURORA ACADEMY CHARTER SCHOOL,4TH,1,3,20,24,27,75,48,64%
0180,ADAMS-ARAPAHOE 28J,0458,AURORA ACADEMY CHARTER SCHOOL,5TH,1,4,19,20,31,75,44,59%
0180,ADAMS-ARAPAHOE 28J,0458,AURORA ACADEMY CHARTER SCHOOL,6TH,1,0,17,14,18,50,32,64%
0180,ADAMS-ARAPAHOE 28J,0458,AURORA ACADEMY CHARTER SCHOOL,7TH,0,1,8,12,25,46,21,46%
0180,ADAMS-ARAPAHOE 28J,0458,AURORA ACADEMY CHARTER SCHOOL,8TH,0,0,5,14,26,45,19,42%
0180,ADAMS-ARAPAHOE 28J,0458,AURORA ACADEMY CHARTER SCHOOL,SCHOOL TOTAL,6,14,119,132,220,491,271,55%
0180,ADAMS-ARAPAHOE 28J,0464,AURORA HILLS MIDDLE SCHOOL,6TH,3,14,87,177,52,333,281,84%
0180,ADAMS-ARAPAHOE 28J,0464,AURORA HILLS MIDDLE SCHOOL,7TH,1,13,95,175,51,335,284,85%
0180,ADAMS-ARAPAHOE 28J,0464,AURORA HILLS MIDDLE SCHOOL,8TH,4,16,80,156,67,323,256,79%
0180,ADAMS-ARAPAHOE 28J,0464,AURORA HILLS MIDDLE SCHOOL,SCHOOL TOTAL,8,43,262,508,170,991,821,83%
0180,ADAMS-ARAPAHOE 28J,0465,AURORA FRONTIER K-8,HALF DAY K,1,6,13,13,15,48,33,69%
0180,ADAMS-ARAPAHOE 28J,0465,AURORA FRONTIER K-8,KINDERGARTEN,1,1,11,7,27,47,20,43%
0180,ADAMS-ARAPAHOE 28J,0465,AURORA FRONTIER K-8,1ST,0,13,26,23,40,102,62,61%
0180,ADAMS-ARAPAHOE 28J,0465,AURORA FRONTIER K-8,2ND,0,12,21,17,41,91,50,55%
0180,ADAMS-ARAPAHOE 28J,0465,AURORA FRONTIER K-8,3RD,2,11,24,23,33,93,60,65%
0180,ADAMS-ARAPAHOE 28J,0465,AURORA FRONTIER K-8,4TH,0,3,23,21,21,68,47,69%
0180,ADAMS-ARAPAHOE 28J,0465,AURORA FRONTIER K-8,5TH,0,14,20,22,24,80,56,70%
0180,ADAMS-ARAPAHOE 28J,0465,AURORA FRONTIER K-8,6TH,3,8,23,29,23,86,63,73%
0180,ADAMS-ARAPAHOE 28J,0465,AURORA FRONTIER K-8,7TH,4,7,26,12,22,71,49,69%
0180,ADAMS-ARAPAHOE 28J,0465,AURORA FRONTIER K-8,8TH,1,4,28,16,17,66,49,74%
0180,ADAMS-ARAPAHOE 28J,0465,AURORA FRONTIER K-8,SCHOOL TOTAL,12,79,215,183,263,752,489,65%
0180,ADAMS-ARAPAHOE 28J,0914,BOSTON K-8 SCHOOL,PK,0,0,1,11,1,13,12,92%
0180,ADAMS-ARAPAHOE 28J,0914,BOSTON K-8 SCHOOL,HALF DAY K,0,2,4,10,3,19,16,84%
0180,ADAMS-ARAPAHOE 28J,0914,BOSTON K-8 SCHOOL,KINDERGARTEN,0,0,1,20,3,24,21,88%
0180,ADAMS-ARAPAHOE 28J,0914,BOSTON K-8 SCHOOL,1ST,0,2,7,48,1,58,57,98%
0180,ADAMS-ARAPAHOE 28J,0914,BOSTON K-8 SCHOOL,2ND,1,3,5,37,2,48,46,96%
0180,ADAMS-ARAPAHOE 28J,0914,BOSTON K-8 SCHOOL,3RD,0,4,2,40,3,49,46,94%
0180,ADAMS-ARAPAHOE 28J,0914,BOSTON K-8 SCHOOL,4TH,1,3,11,30,1,46,45,98%
0180,ADAMS-ARAPAHOE 28J,0914,BOSTON K-8 SCHOOL,5TH,0,4,5,34,3,46,43,93%
0180,ADAMS-ARAPAHOE 28J,0914,BOSTON K-8 SCHOOL,6TH,0,2,4,30,1,37,36,97%
0180,ADAMS-ARAPAHOE 28J,0914,BOSTON K-8 SCHOOL,7TH,0,1,5,29,0,35,35,100%
0180,ADAMS-ARAPAHOE 28J,0914,BOSTON K-8 SCHOOL,SCHOOL TOTAL,2,21,45,289,18,375,357,95%
0180,ADAMS-ARAPAHOE 28J,1458,AURORA CENTRAL HIGH SCHOOL,9TH,5,23,91,423,45,587,542,92%
0180,ADAMS-ARAPAHOE 28J,1458,AURORA CENTRAL HIGH SCHOOL,10TH,7,20,87,417,52,583,531,91%
0180,ADAMS-ARAPAHOE 28J,1458,AURORA CENTRAL HIGH SCHOOL,11TH,5,23,102,376,56,562,506,90%
0180,ADAMS-ARAPAHOE 28J,1458,AURORA CENTRAL HIGH SCHOOL,12TH,4,24,154,438,85,705,620,88%
0180,ADAMS-ARAPAHOE 28J,1458,AURORA CENTRAL HIGH SCHOOL,SCHOOL TOTAL,21,90,434,1654,238,2437,2199,90%
0180,ADAMS-ARAPAHOE 28J,1470,CENTURY ELEMENTARY SCHOOL,PK,1,1,25,25,23,75,52,69%
0180,ADAMS-ARAPAHOE 28J,1470,CENTURY ELEMENTARY SCHOOL,HALF DAY K,1,3,18,27,15,64,49,77%
0180,ADAMS-ARAPAHOE 28J,1470,CENTURY ELEMENTARY SCHOOL,KINDERGARTEN,0,0,1,0,0,1,1,100%
0180,ADAMS-ARAPAHOE 28J,1470,CENTURY ELEMENTARY SCHOOL,1ST,1,4,15,24,15,59,44,75%
0180,ADAMS-ARAPAHOE 28J,1470,CENTURY ELEMENTARY SCHOOL,2ND,0,1,21,22,11,55,44,80%
0180,ADAMS-ARAPAHOE 28J,1470,CENTURY ELEMENTARY SCHOOL,3RD,1,4,16,21,21,63,42,67%
0180,ADAMS-ARAPAHOE 28J,1470,CENTURY ELEMENTARY SCHOOL,4TH,1,4,19,15,12,51,39,76%
0180,ADAMS-ARAPAHOE 28J,1470,CENTURY ELEMENTARY SCHOOL,5TH,1,3,14,26,17,61,44,72%
0180,ADAMS-ARAPAHOE 28J,1470,CENTURY ELEMENTARY SCHOOL,SCHOOL TOTAL,6,20,129,160,114,429,315,73%
0180,ADAMS-ARAPAHOE 28J,1720,CLYDE MILLER ELEMENTARY SCHOOL,PK,0,0,4,25,5,34,29,85%
0180,ADAMS-ARAPAHOE 28J,1720,CLYDE MILLER ELEMENTARY SCHOOL,KINDERGARTEN,0,1,12,49,19,81,62,77%
0180,ADAMS-ARAPAHOE 28J,1720,CLYDE MILLER ELEMENTARY SCHOOL,1ST,0,0,12,44,20,76,56,74%
0180,ADAMS-ARAPAHOE 28J,1720,CLYDE MILLER ELEMENTARY SCHOOL,2ND,1,1,10,50,13,75,62,83%
0180,ADAMS-ARAPAHOE 28J,1720,CLYDE MILLER ELEMENTARY SCHOOL,3RD,1,2,12,50,19,84,65,77%
0180,ADAMS-ARAPAHOE 28J,1720,CLYDE MILLER ELEMENTARY SCHOOL,4TH,1,2,11,49,21,84,63,75%
0180,ADAMS-ARAPAHOE 28J,1720,CLYDE MILLER ELEMENTARY SCHOOL,5TH,0,1,9,45,20,75,55,73%
0180,ADAMS-ARAPAHOE 28J,1720,CLYDE MILLER ELEMENTARY SCHOOL,SCHOOL TOTAL,3,7,70,312,117,509,392,77%
0180,ADAMS-ARAPAHOE 28J,1800,COLUMBIA MIDDLE SCHOOL,6TH,5,18,46,64,103,236,133,56%
0180,ADAMS-ARAPAHOE 28J,1800,COLUMBIA MIDDLE SCHOOL,7TH,1,13,58,93,99,264,165,63%
0180,ADAMS-ARAPAHOE 28J,1800,COLUMBIA MIDDLE SCHOOL,8TH,4,17,55,83,130,289,159,55%
0180,ADAMS-ARAPAHOE 28J,1800,COLUMBIA MIDDLE SCHOOL,SCHOOL TOTAL,10,48,159,240,332,789,457,58%
0180,ADAMS-ARAPAHOE 28J,1948,CRAWFORD ELEMENTARY SCHOOL,PK,0,0,3,23,2,28,26,93%
0180,ADAMS-ARAPAHOE 28J,1948,CRAWFORD ELEMENTARY SCHOOL,KINDERGARTEN,1,6,16,88,3,114,111,97%
0180,ADAMS-ARAPAHOE 28J,1948,CRAWFORD ELEMENTARY SCHOOL,1ST,2,4,8,99,3,116,113,97%
0180,ADAMS-ARAPAHOE 28J,1948,CRAWFORD ELEMENTARY SCHOOL,2ND,2,2,11,83,7,105,98,93%
0180,ADAMS-ARAPAHOE 28J,1948,CRAWFORD ELEMENTARY SCHOOL,3RD,1,2,6,90,1,100,99,99%
0180,ADAMS-ARAPAHOE 28J,1948,CRAWFORD ELEMENTARY SCHOOL,4TH,2,5,10,71,2,90,88,98%
0180,ADAMS-ARAPAHOE 28J,1948,CRAWFORD ELEMENTARY SCHOOL,5TH,2,4,4,63,1,74,73,99%
0180,ADAMS-ARAPAHOE 28J,1948,CRAWFORD ELEMENTARY SCHOOL,SCHOOL TOTAL,10,23,58,517,19,627,608,97%
0180,ADAMS-ARAPAHOE 28J,2095,DALTON ELEMENTARY SCHOOL,PK,0,2,5,27,9,43,34,79%
0180,ADAMS-ARAPAHOE 28J,2095,DALTON ELEMENTARY SCHOOL,KINDERGARTEN,1,4,21,20,43,89,46,52%
0180,ADAMS-ARAPAHOE 28J,2095,DALTON ELEMENTARY SCHOOL,1ST,1,9,16,29,31,86,55,64%
0180,ADAMS-ARAPAHOE 28J,2095,DALTON ELEMENTARY SCHOOL,2ND,0,6,12,26,46,90,44,49%
0180,ADAMS-ARAPAHOE 28J,2095,DALTON ELEMENTARY SCHOOL,3RD,1,4,9,29,38,81,43,53%
0180,ADAMS-ARAPAHOE 28J,2095,DALTON ELEMENTARY SCHOOL,4TH,2,7,15,26,49,99,50,51%
0180,ADAMS-ARAPAHOE 28J,2095,DALTON ELEMENTARY SCHOOL,5TH,3,2,10,31,34,80,46,58%
0180,ADAMS-ARAPAHOE 28J,2095,DALTON ELEMENTARY SCHOOL,SCHOOL TOTAL,8,34,88,188,250,568,318,56%
0180,ADAMS-ARAPAHOE 28J,2114,DARTMOUTH ELEMENTARY SCHOOL,PK,1,0,5,16,23,45,22,49%
0180,ADAMS-ARAPAHOE 28J,2114,DARTMOUTH ELEMENTARY SCHOOL,KINDERGARTEN,4,2,17,21,34,78,44,56%
0180,ADAMS-ARAPAHOE 28J,2114,DARTMOUTH ELEMENTARY SCHOOL,1ST,0,3,6,21,29,59,30,51%
0180,ADAMS-ARAPAHOE 28J,2114,DARTMOUTH ELEMENTARY SCHOOL,2ND,0,4,10,16,39,69,30,43%
0180,ADAMS-ARAPAHOE 28J,2114,DARTMOUTH ELEMENTARY SCHOOL,3RD,2,4,17,17,27,67,40,60%
0180,ADAMS-ARAPAHOE 28J,2114,DARTMOUTH ELEMENTARY SCHOOL,4TH,0,3,13,29,17,62,45,73%
0180,ADAMS-ARAPAHOE 28J,2114,DARTMOUTH ELEMENTARY SCHOOL,5TH,0,1,12,22,33,68,35,51%
0180,ADAMS-ARAPAHOE 28J,2114,DARTMOUTH ELEMENTARY SCHOOL,SCHOOL TOTAL,7,17,80,142,202,448,246,55%
0180,ADAMS-ARAPAHOE 28J,2384,EAST MIDDLE SCHOOL,6TH,2,16,57,223,38,336,298,89%
0180,ADAMS-ARAPAHOE 28J,2384,EAST MIDDLE SCHOOL,7TH,1,12,52,214,43,322,279,87%
0180,ADAMS-ARAPAHOE 28J,2384,EAST MIDDLE SCHOOL,8TH,0,22,60,176,52,310,258,83%
0180,ADAMS-ARAPAHOE 28J,2384,EAST MIDDLE SCHOOL,SCHOOL TOTAL,3,50,169,613,133,968,835,86%
0180,ADAMS-ARAPAHOE 28J,2618,ELKHART ELEMENTARY SCHOOL,KINDERGARTEN,1,5,18,91,11,126,115,91%
0180,ADAMS-ARAPAHOE 28J,2618,ELKHART ELEMENTARY SCHOOL,1ST,1,9,23,77,14,124,110,89%
0180,ADAMS-ARAPAHOE 28J,2618,ELKHART ELEMENTARY SCHOOL,2ND,0,13,22,85,6,126,120,95%
0180,ADAMS-ARAPAHOE 28J,2618,ELKHART ELEMENTARY SCHOOL,3RD,0,8,22,70,5,105,100,95%
0180,ADAMS-ARAPAHOE 28J,2618,ELKHART ELEMENTARY SCHOOL,4TH,0,7,14,82,2,105,103,98%
0180,ADAMS-ARAPAHOE 28J,2618,ELKHART ELEMENTARY SCHOOL,5TH,1,7,14,68,7,97,90,93%
0180,ADAMS-ARAPAHOE 28J,2618,ELKHART ELEMENTARY SCHOOL,SCHOOL TOTAL,3,49,113,473,45,683,638,93%
0180,ADAMS-ARAPAHOE 28J,2951,AURORA PUBLIC SCHOOLS CHILD DEVELOPMENT CENTER,PK,2,8,44,181,29,264,235,89%
0180,ADAMS-ARAPAHOE 28J,2951,AURORA PUBLIC SCHOOLS CHILD DEVELOPMENT CENTER,SCHOOL TOTAL,2,8,44,181,29,264,235,89%
0180,ADAMS-ARAPAHOE 28J,2995,FLETCHER INTERMEDIATE SCIENCE & TECHNOLOGY SCHOOL,4TH,0,1,9,62,2,74,72,97%
0180,ADAMS-ARAPAHOE 28J,2995,FLETCHER INTERMEDIATE SCIENCE & TECHNOLOGY SCHOOL,5TH,2,2,9,64,3,80,77,96%
0180,ADAMS-ARAPAHOE 28J,2995,FLETCHER INTERMEDIATE SCIENCE & TECHNOLOGY SCHOOL,6TH,0,0,3,51,2,56,54,96%
0180,ADAMS-ARAPAHOE 28J,2995,FLETCHER INTERMEDIATE SCIENCE & TECHNOLOGY SCHOOL,7TH,0,0,0,26,1,27,26,96%
0180,ADAMS-ARAPAHOE 28J,2995,FLETCHER INTERMEDIATE SCIENCE & TECHNOLOGY SCHOOL,SCHOOL TOTAL,2,3,21,203,8,237,229,97%
0180,ADAMS-ARAPAHOE 28J,2998,FLETCHER PRIMARY SCHOOL,PK,0,2,0,30,0,32,32,100%
0180,ADAMS-ARAPAHOE 28J,2998,FLETCHER PRIMARY SCHOOL,KINDERGARTEN,1,1,7,75,4,88,84,95%
0180,ADAMS-ARAPAHOE 28J,2998,FLETCHER PRIMARY SCHOOL,1ST,0,1,5,80,5,91,86,95%
0180,ADAMS-ARAPAHOE 28J,2998,FLETCHER PRIMARY SCHOOL,2ND,0,3,9,88,2,102,100,98%
0180,ADAMS-ARAPAHOE 28J,2998,FLETCHER PRIMARY SCHOOL,3RD,1,4,9,72,6,92,86,93%
0180,ADAMS-ARAPAHOE 28J,2998,FLETCHER PRIMARY SCHOOL,SCHOOL TOTAL,2,11,30,345,17,405,388,96%
0180,ADAMS-ARAPAHOE 28J,3272,FULTON ELEMENTARY SCHOOL,PK,0,6,3,47,3,59,56,95%
0180,ADAMS-ARAPAHOE 28J,3272,FULTON ELEMENTARY SCHOOL,KINDERGARTEN,1,2,6,60,6,75,69,92%
0180,ADAMS-ARAPAHOE 28J,3272,FULTON ELEMENTARY SCHOOL,1ST,0,8,4,61,5,78,73,94%
0180,ADAMS-ARAPAHOE 28J,3272,FULTON ELEMENTARY SCHOOL,2ND,1,4,13,63,3,84,81,96%
0180,ADAMS-ARAPAHOE 28J,3272,FULTON ELEMENTARY SCHOOL,3RD,0,5,5,51,7,68,61,90%
0180,ADAMS-ARAPAHOE 28J,3272,FULTON ELEMENTARY SCHOOL,4TH,0,2,9,53,6,70,64,91%
0180,ADAMS-ARAPAHOE 28J,3272,FULTON ELEMENTARY SCHOOL,5TH,0,4,7,44,9,64,55,86%
0180,ADAMS-ARAPAHOE 28J,3272,FULTON ELEMENTARY SCHOOL,SCHOOL TOTAL,2,31,47,379,39,498,459,92%
0180,ADAMS-ARAPAHOE 28J,3354,GATEWAY HIGH SCHOOL,9TH,6,10,102,188,102,408,306,75%
0180,ADAMS-ARAPAHOE 28J,3354,GATEWAY HIGH SCHOOL,10TH,5,22,130,175,106,438,332,76%
0180,ADAMS-ARAPAHOE 28J,3354,GATEWAY HIGH SCHOOL,11TH,6,23,136,128,114,407,293,72%
0180,ADAMS-ARAPAHOE 28J,3354,GATEWAY HIGH SCHOOL,12TH,7,25,149,159,135,475,340,72%
0180,ADAMS-ARAPAHOE 28J,3354,GATEWAY HIGH SCHOOL,SCHOOL TOTAL,24,80,517,650,457,1728,1271,74%
0180,ADAMS-ARAPAHOE 28J,3471,GLOBAL VILLAGE ACADEMY,HALF DAY K,0,4,6,21,9,40,31,78%
0180,ADAMS-ARAPAHOE 28J,3471,GLOBAL VILLAGE ACADEMY,KINDERGARTEN,0,8,8,19,15,50,35,70%
0180,ADAMS-ARAPAHOE 28J,3471,GLOBAL VILLAGE ACADEMY,1ST,0,19,41,32,34,126,92,73%
0180,ADAMS-ARAPAHOE 28J,3471,GLOBAL VILLAGE ACADEMY,2ND,1,9,21,27,23,81,58,72%
0180,ADAMS-ARAPAHOE 28J,3471,GLOBAL VILLAGE ACADEMY,3RD,0,6,13,17,13,49,36,73%
0180,ADAMS-ARAPAHOE 28J,3471,GLOBAL VILLAGE ACADEMY,4TH,0,7,10,18,13,48,35,73%
0180,ADAMS-ARAPAHOE 28J,3471,GLOBAL VILLAGE ACADEMY,5TH,0,8,6,13,13,40,27,68%
0180,ADAMS-ARAPAHOE 28J,3471,GLOBAL VILLAGE ACADEMY,6TH,0,8,6,14,7,35,28,80%
0180,ADAMS-ARAPAHOE 28J,3471,GLOBAL VILLAGE ACADEMY,7TH,0,5,4,25,12,46,34,74%
0180,ADAMS-ARAPAHOE 28J,3471,GLOBAL VILLAGE ACADEMY,SCHOOL TOTAL,1,74,115,186,139,515,376,73%
0180,ADAMS-ARAPAHOE 28J,4024,HINKLEY HIGH SCHOOL,9TH,2,24,86,326,88,526,438,83%
0180,ADAMS-ARAPAHOE 28J,4024,HINKLEY HIGH SCHOOL,10TH,5,34,119,280,98,536,438,82%
0180,ADAMS-ARAPAHOE 28J,4024,HINKLEY HIGH SCHOOL,11TH,4,31,113,265,91,504,413,82%
0180,ADAMS-ARAPAHOE 28J,4024,HINKLEY HIGH SCHOOL,12TH,3,29,130,264,75,501,426,85%
0180,ADAMS-ARAPAHOE 28J,4024,HINKLEY HIGH SCHOOL,SCHOOL TOTAL,14,118,448,1135,352,2067,1715,83%
0180,ADAMS-ARAPAHOE 28J,4270,IOWA ELEMENTARY SCHOOL,PK,1,4,15,33,11,64,53,83%
0180,ADAMS-ARAPAHOE 28J,4270,IOWA ELEMENTARY SCHOOL,HALF DAY K,0,2,12,25,19,58,39,67%
0180,ADAMS-ARAPAHOE 28J,4270,IOWA ELEMENTARY SCHOOL,1ST,0,3,26,34,35,98,63,64%
0180,ADAMS-ARAPAHOE 28J,4270,IOWA ELEMENTARY SCHOOL,2ND,0,6,28,26,12,72,60,83%
0180,ADAMS-ARAPAHOE 28J,4270,IOWA ELEMENTARY SCHOOL,3RD,0,6,14,35,20,75,55,73%
0180,ADAMS-ARAPAHOE 28J,4270,IOWA ELEMENTARY SCHOOL,4TH,1,4,22,31,18,76,58,76%
0180,ADAMS-ARAPAHOE 28J,4270,IOWA ELEMENTARY SCHOOL,5TH,0,4,25,27,18,74,56,76%
0180,ADAMS-ARAPAHOE 28J,4270,IOWA ELEMENTARY SCHOOL,SCHOOL TOTAL,2,29,142,211,133,517,384,74%
0180,ADAMS-ARAPAHOE 28J,4385,JAMAICA CHILD DEVELOPMENT CENTER,PK,1,7,38,174,23,243,220,91%
0180,ADAMS-ARAPAHOE 28J,4385,JAMAICA CHILD DEVELOPMENT CENTER,SCHOOL TOTAL,1,7,38,174,23,243,220,91%
0180,ADAMS-ARAPAHOE 28J,4426,JEWELL ELEMENTARY SCHOOL,PK,0,1,10,14,6,31,25,81%
0180,ADAMS-ARAPAHOE 28J,4426,JEWELL ELEMENTARY SCHOOL,KINDERGARTEN,1,6,28,41,22,98,76,78%
0180,ADAMS-ARAPAHOE 28J,4426,JEWELL ELEMENTARY SCHOOL,1ST,0,4,32,40,18,94,76,81%
0180,ADAMS-ARAPAHOE 28J,4426,JEWELL ELEMENTARY SCHOOL,2ND,0,8,24,35,16,83,67,81%
0180,ADAMS-ARAPAHOE 28J,4426,JEWELL ELEMENTARY SCHOOL,3RD,2,5,26,35,12,80,68,85%
0180,ADAMS-ARAPAHOE 28J,4426,JEWELL ELEMENTARY SCHOOL,4TH,0,4,23,35,15,77,62,81%
0180,ADAMS-ARAPAHOE 28J,4426,JEWELL ELEMENTARY SCHOOL,5TH,1,6,31,34,13,85,72,85%
0180,ADAMS-ARAPAHOE 28J,4426,JEWELL ELEMENTARY SCHOOL,SCHOOL TOTAL,4,34,174,234,102,548,446,81%
0180,ADAMS-ARAPAHOE 28J,4646,KENTON ELEMENTARY SCHOOL,KINDERGARTEN,1,2,8,79,8,98,90,92%
0180,ADAMS-ARAPAHOE 28J,4646,KENTON ELEMENTARY SCHOOL,1ST,0,2,5,89,8,104,96,92%
0180,ADAMS-ARAPAHOE 28J,4646,KENTON ELEMENTARY SCHOOL,2ND,0,1,8,76,5,90,85,94%
0180,ADAMS-ARAPAHOE 28J,4646,KENTON ELEMENTARY SCHOOL,3RD,1,0,9,79,8,97,89,92%
0180,ADAMS-ARAPAHOE 28J,4646,KENTON ELEMENTARY SCHOOL,4TH,1,2,7,83,4,97,93,96%
0180,ADAMS-ARAPAHOE 28J,4646,KENTON ELEMENTARY SCHOOL,5TH,0,1,6,59,4,70,66,94%
0180,ADAMS-ARAPAHOE 28J,4646,KENTON ELEMENTARY SCHOOL,SCHOOL TOTAL,3,8,43,465,37,556,519,93%
0180,ADAMS-ARAPAHOE 28J,4970,LANSING ELEMENTARY SCHOOL,KINDERGARTEN,0,0,22,36,7,65,58,89%
0180,ADAMS-ARAPAHOE 28J,4970,LANSING ELEMENTARY SCHOOL,1ST,2,2,24,45,6,79,73,92%
0180,ADAMS-ARAPAHOE 28J,4970,LANSING ELEMENTARY SCHOOL,2ND,1,3,17,39,6,66,60,91%
0180,ADAMS-ARAPAHOE 28J,4970,LANSING ELEMENTARY SCHOOL,3RD,0,3,23,31,9,66,57,86%
0180,ADAMS-ARAPAHOE 28J,4970,LANSING ELEMENTARY SCHOOL,4TH,0,2,19,35,7,63,56,89%
0180,ADAMS-ARAPAHOE 28J,4970,LANSING ELEMENTARY SCHOOL,5TH,0,2,18,29,6,55,49,89%
0180,ADAMS-ARAPAHOE 28J,4970,LANSING ELEMENTARY SCHOOL,SCHOOL TOTAL,3,12,123,215,41,394,353,90%
0180,ADAMS-ARAPAHOE 28J,4973,LAREDO ELEMENTARY SCHOOL,HALF DAY K,0,2,2,23,4,31,27,87%
0180,ADAMS-ARAPAHOE 28J,4973,LAREDO ELEMENTARY SCHOOL,KINDERGARTEN,0,3,12,26,7,48,41,85%
0180,ADAMS-ARAPAHOE 28J,4973,LAREDO ELEMENTARY SCHOOL,1ST,0,5,15,53,13,86,73,85%
0180,ADAMS-ARAPAHOE 28J,4973,LAREDO ELEMENTARY SCHOOL,2ND,0,5,11,46,16,78,62,79%
0180,ADAMS-ARAPAHOE 28J,4973,LAREDO ELEMENTARY SCHOOL,3RD,1,7,22,43,8,81,73,90%
0180,ADAMS-ARAPAHOE 28J,4973,LAREDO ELEMENTARY SCHOOL,4TH,2,5,15,48,13,83,70,84%
0180,ADAMS-ARAPAHOE 28J,4973,LAREDO ELEMENTARY SCHOOL,5TH,0,1,12,47,8,68,60,88%
0180,ADAMS-ARAPAHOE 28J,4973,LAREDO ELEMENTARY SCHOOL,SCHOOL TOTAL,3,28,89,286,69,475,406,85%
0180,ADAMS-ARAPAHOE 28J,5298,LOTUS SCHOOL FOR EXCELLENCE,6TH,1,1,26,33,23,84,61,73%
0180,ADAMS-ARAPAHOE 28J,5298,LOTUS SCHOOL FOR EXCELLENCE,7TH,3,1,31,30,17,82,65,79%
0180,ADAMS-ARAPAHOE 28J,5298,LOTUS SCHOOL FOR EXCELLENCE,8TH,0,2,24,24,11,61,50,82%
0180,ADAMS-ARAPAHOE 28J,5298,LOTUS SCHOOL FOR EXCELLENCE,9TH,0,1,13,22,15,51,36,71%
0180,ADAMS-ARAPAHOE 28J,5298,LOTUS SCHOOL FOR EXCELLENCE,10TH,0,0,13,7,6,26,20,77%
0180,ADAMS-ARAPAHOE 28J,5298,LOTUS SCHOOL FOR EXCELLENCE,SCHOOL TOTAL,4,5,107,116,72,304,232,76%
0180,ADAMS-ARAPAHOE 28J,5361,LYN KNOLL ELEMENTARY SCHOOL,KINDERGARTEN,0,0,15,31,5,51,46,90%
0180,ADAMS-ARAPAHOE 28J,5361,LYN KNOLL ELEMENTARY SCHOOL,1ST,0,2,13,33,2,50,48,96%
0180,ADAMS-ARAPAHOE 28J,5361,LYN KNOLL ELEMENTARY SCHOOL,2ND,0,2,19,27,3,51,48,94%
0180,ADAMS-ARAPAHOE 28J,5361,LYN KNOLL ELEMENTARY SCHOOL,3RD,0,0,10,32,4,46,42,91%
0180,ADAMS-ARAPAHOE 28J,5361,LYN KNOLL ELEMENTARY SCHOOL,4TH,0,1,15,33,2,51,49,96%
0180,ADAMS-ARAPAHOE 28J,5361,LYN KNOLL ELEMENTARY SCHOOL,5TH,0,1,11,31,2,45,43,96%
0180,ADAMS-ARAPAHOE 28J,5361,LYN KNOLL ELEMENTARY SCHOOL,SCHOOL TOTAL,0,6,83,187,18,294,276,94%
0180,ADAMS-ARAPAHOE 28J,6068,MONTVIEW ELEMENTARY SCHOOL,PK,0,0,3,28,0,31,31,100%
0180,ADAMS-ARAPAHOE 28J,6068,MONTVIEW ELEMENTARY SCHOOL,KINDERGARTEN,1,1,8,54,7,71,64,90%
0180,ADAMS-ARAPAHOE 28J,6068,MONTVIEW ELEMENTARY SCHOOL,1ST,1,1,8,64,8,82,74,90%
0180,ADAMS-ARAPAHOE 28J,6068,MONTVIEW ELEMENTARY SCHOOL,2ND,1,2,6,48,6,63,57,90%
0180,ADAMS-ARAPAHOE 28J,6068,MONTVIEW ELEMENTARY SCHOOL,3RD,0,1,11,54,5,71,66,93%
0180,ADAMS-ARAPAHOE 28J,6068,MONTVIEW ELEMENTARY SCHOOL,4TH,1,0,16,48,7,72,65,90%
0180,ADAMS-ARAPAHOE 28J,6068,MONTVIEW ELEMENTARY SCHOOL,5TH,1,1,15,56,1,74,73,99%
0180,ADAMS-ARAPAHOE 28J,6068,MONTVIEW ELEMENTARY SCHOOL,SCHOOL TOTAL,5,6,67,352,34,464,430,93%
0180,ADAMS-ARAPAHOE 28J,6160,MRACHEK MIDDLE SCHOOL,6TH,4,18,104,116,97,339,242,71%
0180,ADAMS-ARAPAHOE 28J,6160,MRACHEK MIDDLE SCHOOL,7TH,3,26,94,111,66,300,234,78%
0180,ADAMS-ARAPAHOE 28J,6160,MRACHEK MIDDLE SCHOOL,8TH,3,22,110,128,86,349,263,75%
0180,ADAMS-ARAPAHOE 28J,6160,MRACHEK MIDDLE SCHOOL,SCHOOL TOTAL,10,66,308,355,249,988,739,75%
0180,ADAMS-ARAPAHOE 28J,6189,MURPHY CREEK K-8 SCHOOL,HALF DAY K,0,1,7,10,28,46,18,39%
0180,ADAMS-ARAPAHOE 28J,6189,MURPHY CREEK K-8 SCHOOL,KINDERGARTEN,0,0,15,9,26,50,24,48%
0180,ADAMS-ARAPAHOE 28J,6189,MURPHY CREEK K-8 SCHOOL,1ST,0,4,22,18,47,91,44,48%
0180,ADAMS-ARAPAHOE 28J,6189,MURPHY CREEK K-8 SCHOOL,2ND,3,1,18,13,37,72,35,49%
0180,ADAMS-ARAPAHOE 28J,6189,MURPHY CREEK K-8 SCHOOL,3RD,1,5,14,19,40,79,39,49%
0180,ADAMS-ARAPAHOE 28J,6189,MURPHY CREEK K-8 SCHOOL,4TH,1,6,13,21,42,83,41,49%
0180,ADAMS-ARAPAHOE 28J,6189,MURPHY CREEK K-8 SCHOOL,5TH,2,5,18,23,24,72,48,67%
0180,ADAMS-ARAPAHOE 28J,6189,MURPHY CREEK K-8 SCHOOL,6TH,0,6,16,18,36,76,40,53%
0180,ADAMS-ARAPAHOE 28J,6189,MURPHY CREEK K-8 SCHOOL,7TH,2,1,14,12,38,67,29,43%
0180,ADAMS-ARAPAHOE 28J,6189,MURPHY CREEK K-8 SCHOOL,8TH,1,2,16,10,24,53,29,55%
0180,ADAMS-ARAPAHOE 28J,6189,MURPHY CREEK K-8 SCHOOL,SCHOOL TOTAL,10,31,153,153,342,689,347,50%
0180,ADAMS-ARAPAHOE 28J,6219,NEW AMERICA SCHOOL,9TH,0,0,3,28,3,34,31,91%
0180,ADAMS-ARAPAHOE 28J,6219,NEW AMERICA SCHOOL,10TH,0,2,9,85,3,99,96,97%
0180,ADAMS-ARAPAHOE 28J,6219,NEW AMERICA SCHOOL,11TH,0,1,11,122,2,136,134,99%
0180,ADAMS-ARAPAHOE 28J,6219,NEW AMERICA SCHOOL,12TH,1,5,23,260,11,300,289,96%
0180,ADAMS-ARAPAHOE 28J,6219,NEW AMERICA SCHOOL,SCHOOL TOTAL,1,8,46,495,19,569,550,97%
0180,ADAMS-ARAPAHOE 28J,6310,NORTH MIDDLE SCHOOL,6TH,2,2,52,153,26,235,209,89%
0180,ADAMS-ARAPAHOE 28J,6310,NORTH MIDDLE SCHOOL,7TH,2,3,36,150,17,208,191,92%
0180,ADAMS-ARAPAHOE 28J,6310,NORTH MIDDLE SCHOOL,8TH,3,3,40,189,20,255,235,92%
0180,ADAMS-ARAPAHOE 28J,6310,NORTH MIDDLE SCHOOL,SCHOOL TOTAL,7,8,128,492,63,698,635,91%
0180,ADAMS-ARAPAHOE 28J,6546,OPTIONS SCHOOL,HALF DAY K,1,8,1,7,130,147,17,12%
0180,ADAMS-ARAPAHOE 28J,6546,OPTIONS SCHOOL,1ST,1,5,3,8,149,166,17,10%
0180,ADAMS-ARAPAHOE 28J,6546,OPTIONS SCHOOL,2ND,0,7,2,4,145,158,13,8%
0180,ADAMS-ARAPAHOE 28J,6546,OPTIONS SCHOOL,3RD,1,7,2,10,171,191,20,10%
0180,ADAMS-ARAPAHOE 28J,6546,OPTIONS SCHOOL,4TH,1,2,5,8,144,160,16,10%
0180,ADAMS-ARAPAHOE 28J,6546,OPTIONS SCHOOL,5TH,0,6,2,14,149,171,22,13%
0180,ADAMS-ARAPAHOE 28J,6546,OPTIONS SCHOOL,6TH,0,5,4,7,124,140,16,11%
0180,ADAMS-ARAPAHOE 28J,6546,OPTIONS SCHOOL,7TH,1,3,1,3,117,125,8,6%
0180,ADAMS-ARAPAHOE 28J,6546,OPTIONS SCHOOL,8TH,1,2,5,3,92,103,11,11%
0180,ADAMS-ARAPAHOE 28J,6546,OPTIONS SCHOOL,9TH,0,1,0,5,60,66,6,9%
0180,ADAMS-ARAPAHOE 28J,6546,OPTIONS SCHOOL,10TH,0,2,2,2,60,66,6,9%
0180,ADAMS-ARAPAHOE 28J,6546,OPTIONS SCHOOL,11TH,0,0,1,6,74,81,7,9%
0180,ADAMS-ARAPAHOE 28J,6546,OPTIONS SCHOOL,12TH,0,1,2,2,60,65,5,8%
0180,ADAMS-ARAPAHOE 28J,6546,OPTIONS SCHOOL,SCHOOL TOTAL,6,49,30,79,1475,1639,164,10%
0180,ADAMS-ARAPAHOE 28J,6728,PARIS ELEMENTARY SCHOOL,KINDERGARTEN,1,0,8,70,1,80,79,99%
0180,ADAMS-ARAPAHOE 28J,6728,PARIS ELEMENTARY SCHOOL,1ST,0,0,8,61,3,72,69,96%
0180,ADAMS-ARAPAHOE 28J,6728,PARIS ELEMENTARY SCHOOL,2ND,1,1,5,56,1,64,63,98%
0180,ADAMS-ARAPAHOE 28J,6728,PARIS ELEMENTARY SCHOOL,3RD,0,2,7,65,1,75,74,99%
0180,ADAMS-ARAPAHOE 28J,6728,PARIS ELEMENTARY SCHOOL,4TH,2,0,4,52,5,63,58,92%
0180,ADAMS-ARAPAHOE 28J,6728,PARIS ELEMENTARY SCHOOL,5TH,2,1,5,41,1,50,49,98%
0180,ADAMS-ARAPAHOE 28J,6728,PARIS ELEMENTARY SCHOOL,SCHOOL TOTAL,6,4,37,345,12,404,392,97%
0180,ADAMS-ARAPAHOE 28J,6758,PARK LANE ELEMENTARY SCHOOL,PK,0,0,10,41,5,56,51,91%
0180,ADAMS-ARAPAHOE 28J,6758,PARK LANE ELEMENTARY SCHOOL,KINDERGARTEN,1,3,12,28,4,48,44,92%
0180,ADAMS-ARAPAHOE 28J,6758,PARK LANE ELEMENTARY SCHOOL,1ST,2,0,15,34,3,54,51,94%
0180,ADAMS-ARAPAHOE 28J,6758,PARK LANE ELEMENTARY SCHOOL,2ND,0,2,10,36,7,55,48,87%
0180,ADAMS-ARAPAHOE 28J,6758,PARK LANE ELEMENTARY SCHOOL,3RD,0,3,13,31,8,55,47,85%
0180,ADAMS-ARAPAHOE 28J,6758,PARK LANE ELEMENTARY SCHOOL,4TH,0,4,12,30,4,50,46,92%
0180,ADAMS-ARAPAHOE 28J,6758,PARK LANE ELEMENTARY SCHOOL,5TH,0,1,8,28,4,41,37,90%
0180,ADAMS-ARAPAHOE 28J,6758,PARK LANE ELEMENTARY SCHOOL,SCHOOL TOTAL,3,13,80,228,35,359,324,90%
0180,ADAMS-ARAPAHOE 28J,6869,PEORIA ELEMENTARY SCHOOL,PK,0,0,1,28,2,31,29,94%
0180,ADAMS-ARAPAHOE 28J,6869,PEORIA ELEMENTARY SCHOOL,KINDERGARTEN,1,1,12,74,5,93,88,95%
0180,ADAMS-ARAPAHOE 28J,6869,PEORIA ELEMENTARY SCHOOL,1ST,0,2,11,70,7,90,83,92%
0180,ADAMS-ARAPAHOE 28J,6869,PEORIA ELEMENTARY SCHOOL,2ND,1,2,9,54,4,70,66,94%
0180,ADAMS-ARAPAHOE 28J,6869,PEORIA ELEMENTARY SCHOOL,3RD,1,3,9,60,7,80,73,91%
0180,ADAMS-ARAPAHOE 28J,6869,PEORIA ELEMENTARY SCHOOL,4TH,1,1,4,62,6,74,68,92%
0180,ADAMS-ARAPAHOE 28J,6869,PEORIA ELEMENTARY SCHOOL,5TH,1,1,11,49,3,65,62,95%
0180,ADAMS-ARAPAHOE 28J,6869,PEORIA ELEMENTARY SCHOOL,SCHOOL TOTAL,5,10,57,397,34,503,469,93%
0180,ADAMS-ARAPAHOE 28J,7232,AURORA QUEST ACADEMY,KINDERGARTEN,1,7,2,6,28,44,16,36%
0180,ADAMS-ARAPAHOE 28J,7232,AURORA QUEST ACADEMY,1ST,0,6,8,7,27,48,21,44%
0180,ADAMS-ARAPAHOE 28J,7232,AURORA QUEST ACADEMY,2ND,0,3,8,4,33,48,15,31%
0180,ADAMS-ARAPAHOE 28J,7232,AURORA QUEST ACADEMY,3RD,1,6,5,9,32,53,21,40%
0180,ADAMS-ARAPAHOE 28J,7232,AURORA QUEST ACADEMY,4TH,0,4,13,5,33,55,22,40%
0180,ADAMS-ARAPAHOE 28J,7232,AURORA QUEST ACADEMY,5TH,0,7,16,15,46,84,38,45%
0180,ADAMS-ARAPAHOE 28J,7232,AURORA QUEST ACADEMY,6TH,0,13,8,12,50,83,33,40%
0180,ADAMS-ARAPAHOE 28J,7232,AURORA QUEST ACADEMY,7TH,1,9,15,20,66,111,45,41%
0180,ADAMS-ARAPAHOE 28J,7232,AURORA QUEST ACADEMY,8TH,1,12,7,7,27,54,27,50%
0180,ADAMS-ARAPAHOE 28J,7232,AURORA QUEST ACADEMY,SCHOOL TOTAL,4,67,82,85,342,580,238,41%
0180,ADAMS-ARAPAHOE 28J,7250,RANGEVIEW HIGH SCHOOL,9TH,6,33,137,165,196,537,341,64%
0180,ADAMS-ARAPAHOE 28J,7250,RANGEVIEW HIGH SCHOOL,10TH,3,46,167,173,223,612,389,64%
0180,ADAMS-ARAPAHOE 28J,7250,RANGEVIEW HIGH SCHOOL,11TH,4,50,151,142,206,553,347,63%
0180,ADAMS-ARAPAHOE 28J,7250,RANGEVIEW HIGH SCHOOL,12TH,5,39,151,129,242,566,324,57%
0180,ADAMS-ARAPAHOE 28J,7250,RANGEVIEW HIGH SCHOOL,SCHOOL TOTAL,18,168,606,609,867,2268,1401,62%
0180,ADAMS-ARAPAHOE 28J,7558,SABLE ELEMENTARY SCHOOL,PK,0,3,4,18,1,26,25,96%
0180,ADAMS-ARAPAHOE 28J,7558,SABLE ELEMENTARY SCHOOL,HALF DAY K,0,2,5,16,4,27,23,85%
0180,ADAMS-ARAPAHOE 28J,7558,SABLE ELEMENTARY SCHOOL,KINDERGARTEN,0,4,5,28,3,40,37,93%
0180,ADAMS-ARAPAHOE 28J,7558,SABLE ELEMENTARY SCHOOL,1ST,1,7,23,39,6,76,70,92%
0180,ADAMS-ARAPAHOE 28J,7558,SABLE ELEMENTARY SCHOOL,2ND,0,5,15,49,9,78,69,88%
0180,ADAMS-ARAPAHOE 28J,7558,SABLE ELEMENTARY SCHOOL,3RD,0,7,20,43,8,78,70,90%
0180,ADAMS-ARAPAHOE 28J,7558,SABLE ELEMENTARY SCHOOL,4TH,0,5,17,46,8,76,68,89%
0180,ADAMS-ARAPAHOE 28J,7558,SABLE ELEMENTARY SCHOOL,5TH,0,3,16,51,8,78,70,90%
0180,ADAMS-ARAPAHOE 28J,7558,SABLE ELEMENTARY SCHOOL,SCHOOL TOTAL,1,36,105,290,47,479,432,90%
0180,ADAMS-ARAPAHOE 28J,7865,SIDE CREEK ELEMENTARY SCHOOL,PK,0,6,19,18,19,62,43,69%
0180,ADAMS-ARAPAHOE 28J,7865,SIDE CREEK ELEMENTARY SCHOOL,HALF DAY K,3,8,27,23,40,101,61,60%
0180,ADAMS-ARAPAHOE 28J,7865,SIDE CREEK ELEMENTARY SCHOOL,1ST,2,13,31,42,37,125,88,70%
0180,ADAMS-ARAPAHOE 28J,7865,SIDE CREEK ELEMENTARY SCHOOL,2ND,1,9,24,35,35,104,69,66%
0180,ADAMS-ARAPAHOE 28J,7865,SIDE CREEK ELEMENTARY SCHOOL,3RD,3,12,27,19,35,96,61,64%
0180,ADAMS-ARAPAHOE 28J,7865,SIDE CREEK ELEMENTARY SCHOOL,4TH,2,8,36,35,32,113,81,72%
0180,ADAMS-ARAPAHOE 28J,7865,SIDE CREEK ELEMENTARY SCHOOL,5TH,3,8,31,33,44,119,75,63%
0180,ADAMS-ARAPAHOE 28J,7865,SIDE CREEK ELEMENTARY SCHOOL,SCHOOL TOTAL,14,64,195,205,242,720,478,66%
0180,ADAMS-ARAPAHOE 28J,7932,SIXTH AVENUE ELEMENTARY SCHOOL,PK,0,2,6,46,2,56,54,96%
0180,ADAMS-ARAPAHOE 28J,7932,SIXTH AVENUE ELEMENTARY SCHOOL,KINDERGARTEN,1,5,35,69,8,118,110,93%
0180,ADAMS-ARAPAHOE 28J,7932,SIXTH AVENUE ELEMENTARY SCHOOL,1ST,0,3,26,62,6,97,91,94%
0180,ADAMS-ARAPAHOE 28J,7932,SIXTH AVENUE ELEMENTARY SCHOOL,2ND,0,7,23,69,7,106,99,93%
0180,ADAMS-ARAPAHOE 28J,7932,SIXTH AVENUE ELEMENTARY SCHOOL,3RD,0,3,21,72,13,109,96,88%
0180,ADAMS-ARAPAHOE 28J,7932,SIXTH AVENUE ELEMENTARY SCHOOL,4TH,1,3,16,61,8,89,81,91%
0180,ADAMS-ARAPAHOE 28J,7932,SIXTH AVENUE ELEMENTARY SCHOOL,5TH,0,1,22,55,10,88,78,89%
0180,ADAMS-ARAPAHOE 28J,7932,SIXTH AVENUE ELEMENTARY SCHOOL,SCHOOL TOTAL,2,24,149,434,54,663,609,92%
0180,ADAMS-ARAPAHOE 28J,8078,SOUTH MIDDLE SCHOOL,6TH,0,7,55,161,8,231,223,97%
0180,ADAMS-ARAPAHOE 28J,8078,SOUTH MIDDLE SCHOOL,7TH,1,3,40,124,19,187,168,90%
0180,ADAMS-ARAPAHOE 28J,8078,SOUTH MIDDLE SCHOOL,8TH,1,10,61,136,21,229,208,91%
0180,ADAMS-ARAPAHOE 28J,8078,SOUTH MIDDLE SCHOOL,SCHOOL TOTAL,2,20,156,421,48,647,599,93%
0180,ADAMS-ARAPAHOE 28J,8356,WILLIAM SMITH HIGH SCHOOL,9TH,2,4,13,17,25,61,36,59%
0180,ADAMS-ARAPAHOE 28J,8356,WILLIAM SMITH HIGH SCHOOL,10TH,1,2,12,31,26,72,46,64%
0180,ADAMS-ARAPAHOE 28J,8356,WILLIAM SMITH HIGH SCHOOL,11TH,1,2,9,11,36,59,23,39%
0180,ADAMS-ARAPAHOE 28J,8356,WILLIAM SMITH HIGH SCHOOL,12TH,2,4,17,19,32,74,42,57%
0180,ADAMS-ARAPAHOE 28J,8356,WILLIAM SMITH HIGH SCHOOL,SCHOOL TOTAL,6,12,51,78,119,266,147,55%
0180,ADAMS-ARAPAHOE 28J,8858,TOLLGATE ELEMENTARY SCHOOL,KINDERGARTEN,1,4,37,68,19,129,110,85%
0180,ADAMS-ARAPAHOE 28J,8858,TOLLGATE ELEMENTARY SCHOOL,1ST,0,3,48,57,18,126,108,86%
0180,ADAMS-ARAPAHOE 28J,8858,TOLLGATE ELEMENTARY SCHOOL,2ND,0,4,32,47,11,94,83,88%
0180,ADAMS-ARAPAHOE 28J,8858,TOLLGATE ELEMENTARY SCHOOL,3RD,2,6,27,50,13,98,85,87%
0180,ADAMS-ARAPAHOE 28J,8858,TOLLGATE ELEMENTARY SCHOOL,4TH,0,5,37,49,18,109,91,83%
0180,ADAMS-ARAPAHOE 28J,8858,TOLLGATE ELEMENTARY SCHOOL,5TH,4,4,23,42,14,87,73,84%
0180,ADAMS-ARAPAHOE 28J,8858,TOLLGATE ELEMENTARY SCHOOL,SCHOOL TOTAL,7,26,204,313,93,643,550,86%
0180,ADAMS-ARAPAHOE 28J,9056,VANGUARD CLASSICAL SCHOOL,HALF DAY K,0,1,8,32,17,58,41,71%
0180,ADAMS-ARAPAHOE 28J,9056,VANGUARD CLASSICAL SCHOOL,1ST,2,1,13,33,11,60,49,82%
0180,ADAMS-ARAPAHOE 28J,9056,VANGUARD CLASSICAL SCHOOL,2ND,0,1,10,35,15,61,46,75%
0180,ADAMS-ARAPAHOE 28J,9056,VANGUARD CLASSICAL SCHOOL,3RD,0,1,15,25,20,61,41,67%
0180,ADAMS-ARAPAHOE 28J,9056,VANGUARD CLASSICAL SCHOOL,4TH,1,2,7,36,13,59,46,78%
0180,ADAMS-ARAPAHOE 28J,9056,VANGUARD CLASSICAL SCHOOL,5TH,0,5,9,25,21,60,39,65%
0180,ADAMS-ARAPAHOE 28J,9056,VANGUARD CLASSICAL SCHOOL,6TH,1,2,8,30,15,56,41,73%
0180,ADAMS-ARAPAHOE 28J,9056,VANGUARD CLASSICAL SCHOOL,7TH,0,2,10,23,10,45,35,78%
0180,ADAMS-ARAPAHOE 28J,9056,VANGUARD CLASSICAL SCHOOL,8TH,0,0,8,23,8,39,31,79%
0180,ADAMS-ARAPAHOE 28J,9056,VANGUARD CLASSICAL SCHOOL,SCHOOL TOTAL,4,15,88,262,130,499,369,74%
0180,ADAMS-ARAPAHOE 28J,9059,VASSAR ELEMENTARY SCHOOL,HALF DAY K,1,7,21,22,20,71,51,72%
0180,ADAMS-ARAPAHOE 28J,9059,VASSAR ELEMENTARY SCHOOL,1ST,1,7,18,34,28,88,60,68%
0180,ADAMS-ARAPAHOE 28J,9059,VASSAR ELEMENTARY SCHOOL,2ND,1,9,23,31,31,95,64,67%
0180,ADAMS-ARAPAHOE 28J,9059,VASSAR ELEMENTARY SCHOOL,3RD,0,2,20,35,33,90,57,63%
0180,ADAMS-ARAPAHOE 28J,9059,VASSAR ELEMENTARY SCHOOL,4TH,0,4,29,31,28,92,64,70%
0180,ADAMS-ARAPAHOE 28J,9059,VASSAR ELEMENTARY SCHOOL,5TH,0,5,31,24,28,88,60,68%
0180,ADAMS-ARAPAHOE 28J,9059,VASSAR ELEMENTARY SCHOOL,SCHOOL TOTAL,3,34,142,177,168,524,356,68%
0180,ADAMS-ARAPAHOE 28J,9060,VAUGHN ELEMENTARY SCHOOL,PK,1,2,7,50,3,63,60,95%
0180,ADAMS-ARAPAHOE 28J,9060,VAUGHN ELEMENTARY SCHOOL,KINDERGARTEN,0,1,16,63,12,92,80,87%
0180,ADAMS-ARAPAHOE 28J,9060,VAUGHN ELEMENTARY SCHOOL,1ST,0,0,17,50,8,75,67,89%
0180,ADAMS-ARAPAHOE 28J,9060,VAUGHN ELEMENTARY SCHOOL,2ND,1,1,12,70,6,90,84,93%
0180,ADAMS-ARAPAHOE 28J,9060,VAUGHN ELEMENTARY SCHOOL,3RD,0,1,9,48,4,62,58,94%
0180,ADAMS-ARAPAHOE 28J,9060,VAUGHN ELEMENTARY SCHOOL,4TH,0,2,13,62,4,81,77,95%
0180,ADAMS-ARAPAHOE 28J,9060,VAUGHN ELEMENTARY SCHOOL,5TH,1,2,16,61,7,87,80,92%
0180,ADAMS-ARAPAHOE 28J,9060,VAUGHN ELEMENTARY SCHOOL,SCHOOL TOTAL,3,9,90,404,44,550,506,92%
0180,ADAMS-ARAPAHOE 28J,9140,VIRGINIA COURT ELEMENTARY SCHOOL,KINDERGARTEN,1,2,11,46,9,69,60,87%
0180,ADAMS-ARAPAHOE 28J,9140,VIRGINIA COURT ELEMENTARY SCHOOL,1ST,1,4,17,57,10,89,79,89%
0180,ADAMS-ARAPAHOE 28J,9140,VIRGINIA COURT ELEMENTARY SCHOOL,2ND,1,0,13,55,9,78,69,88%
0180,ADAMS-ARAPAHOE 28J,9140,VIRGINIA COURT ELEMENTARY SCHOOL,3RD,3,2,13,47,7,72,65,90%
0180,ADAMS-ARAPAHOE 28J,9140,VIRGINIA COURT ELEMENTARY SCHOOL,4TH,0,2,10,50,7,69,62,90%
0180,ADAMS-ARAPAHOE 28J,9140,VIRGINIA COURT ELEMENTARY SCHOOL,5TH,3,2,14,57,5,81,76,94%
0180,ADAMS-ARAPAHOE 28J,9140,VIRGINIA COURT ELEMENTARY SCHOOL,SCHOOL TOTAL,9,12,78,312,47,458,411,90%
0180,ADAMS-ARAPAHOE 28J,9396,AURORA WEST COLLEGE PREPARATORY ACADEMY,6TH,2,7,24,169,18,220,202,92%
0180,ADAMS-ARAPAHOE 28J,9396,AURORA WEST COLLEGE PREPARATORY ACADEMY,7TH,4,11,26,178,13,232,219,94%
0180,ADAMS-ARAPAHOE 28J,9396,AURORA WEST COLLEGE PREPARATORY ACADEMY,8TH,3,11,38,231,19,302,283,94%
0180,ADAMS-ARAPAHOE 28J,9396,AURORA WEST COLLEGE PREPARATORY ACADEMY,SCHOOL TOTAL,9,29,88,578,50,754,704,93%
0180,ADAMS-ARAPAHOE 28J,9514,WHEELING ELEMENTARY SCHOOL,KINDERGARTEN,0,3,17,80,12,112,100,89%
0180,ADAMS-ARAPAHOE 28J,9514,WHEELING ELEMENTARY SCHOOL,1ST,0,2,21,79,14,116,102,88%
0180,ADAMS-ARAPAHOE 28J,9514,WHEELING ELEMENTARY SCHOOL,2ND,0,4,21,61,12,98,86,88%
0180,ADAMS-ARAPAHOE 28J,9514,WHEELING ELEMENTARY SCHOOL,3RD,1,2,20,60,12,95,83,87%
0180,ADAMS-ARAPAHOE 28J,9514,WHEELING ELEMENTARY SCHOOL,4TH,0,8,22,69,11,110,99,90%
0180,ADAMS-ARAPAHOE 28J,9514,WHEELING ELEMENTARY SCHOOL,5TH,0,2,20,57,6,85,79,93%
0180,ADAMS-ARAPAHOE 28J,9514,WHEELING ELEMENTARY SCHOOL,SCHOOL TOTAL,1,21,121,406,67,616,549,89%
0180,ADAMS-ARAPAHOE 28J,9756,YALE ELEMENTARY SCHOOL,PK,0,2,11,15,3,31,28,90%
0180,ADAMS-ARAPAHOE 28J,9756,YALE ELEMENTARY SCHOOL,KINDERGARTEN,1,2,14,50,20,87,67,77%
0180,ADAMS-ARAPAHOE 28J,9756,YALE ELEMENTARY SCHOOL,1ST,2,4,19,40,18,83,65,78%
0180,ADAMS-ARAPAHOE 28J,9756,YALE ELEMENTARY SCHOOL,2ND,0,0,18,43,20,81,61,75%
0180,ADAMS-ARAPAHOE 28J,9756,YALE ELEMENTARY SCHOOL,3RD,1,2,21,39,18,81,63,78%
0180,ADAMS-ARAPAHOE 28J,9756,YALE ELEMENTARY SCHOOL,4TH,2,5,13,37,21,78,57,73%
0180,ADAMS-ARAPAHOE 28J,9756,YALE ELEMENTARY SCHOOL,5TH,1,2,21,42,20,86,66,77%
0180,ADAMS-ARAPAHOE 28J,9756,YALE ELEMENTARY SCHOOL,SCHOOL TOTAL,7,17,117,266,120,527,407,77%
0180,ADAMS-ARAPAHOE 28J,,DISTRICT TOTAL,,315,1731,7459,18792,8670,36967,28297,77%
0190,BYERS 32J,1168,BYERS ELEMENTARY SCHOOL,PK,0,0,0,2,36,38,2,5%
0190,BYERS 32J,1168,BYERS ELEMENTARY SCHOOL,KINDERGARTEN,0,1,0,5,20,26,6,23%
0190,BYERS 32J,1168,BYERS ELEMENTARY SCHOOL,1ST,0,0,0,3,31,34,3,9%
0190,BYERS 32J,1168,BYERS ELEMENTARY SCHOOL,2ND,0,0,0,5,24,29,5,17%
0190,BYERS 32J,1168,BYERS ELEMENTARY SCHOOL,3RD,0,2,0,4,32,38,6,16%
0190,BYERS 32J,1168,BYERS ELEMENTARY SCHOOL,4TH,0,0,0,1,22,23,1,4%
0190,BYERS 32J,1168,BYERS ELEMENTARY SCHOOL,5TH,1,0,0,1,36,38,2,5%
0190,BYERS 32J,1168,BYERS ELEMENTARY SCHOOL,6TH,0,0,0,4,26,30,4,13%
0190,BYERS 32J,1168,BYERS ELEMENTARY SCHOOL,SCHOOL TOTAL,1,3,0,25,227,256,29,11%
0190,BYERS 32J,1176,BYERS JUNIOR-SENIOR HIGH SCHOOL,7TH,0,1,0,3,44,48,4,8%
0190,BYERS 32J,1176,BYERS JUNIOR-SENIOR HIGH SCHOOL,8TH,0,0,1,8,34,43,9,21%
0190,BYERS 32J,1176,BYERS JUNIOR-SENIOR HIGH SCHOOL,9TH,0,0,1,2,32,35,3,9%
0190,BYERS 32J,1176,BYERS JUNIOR-SENIOR HIGH SCHOOL,10TH,0,0,2,2,30,34,4,12%
0190,BYERS 32J,1176,BYERS JUNIOR-SENIOR HIGH SCHOOL,11TH,0,0,0,2,30,32,2,6%
0190,BYERS 32J,1176,BYERS JUNIOR-SENIOR HIGH SCHOOL,12TH,0,1,4,3,24,32,8,25%
0190,BYERS 32J,1176,BYERS JUNIOR-SENIOR HIGH SCHOOL,SCHOOL TOTAL,0,2,8,20,194,224,30,13%
0190,BYERS 32J,,DISTRICT TOTAL,,1,5,8,45,421,480,59,12%
0220,ARCHULETA COUNTY 50 JT,0064,ARCHULETA COUNTY HIGH SCHOOL,10TH,0,0,0,1,0,1,1,100%
0220,ARCHULETA COUNTY 50 JT,0064,ARCHULETA COUNTY HIGH SCHOOL,11TH,0,0,0,6,2,8,6,75%
0220,ARCHULETA COUNTY 50 JT,0064,ARCHULETA COUNTY HIGH SCHOOL,12TH,1,0,0,8,16,25,9,36%
0220,ARCHULETA COUNTY 50 JT,0064,ARCHULETA COUNTY HIGH SCHOOL,SCHOOL TOTAL,1,0,0,15,18,34,16,47%
0220,ARCHULETA COUNTY 50 JT,6652,PAGOSA SPRINGS ELEMENTARY SCHOOL,HALF DAY K,1,0,1,7,33,42,9,21%
0220,ARCHULETA COUNTY 50 JT,6652,PAGOSA SPRINGS ELEMENTARY SCHOOL,KINDERGARTEN,2,0,2,21,41,66,25,38%
0220,ARCHULETA COUNTY 50 JT,6652,PAGOSA SPRINGS ELEMENTARY SCHOOL,1ST,2,2,0,40,73,117,44,38%
0220,ARCHULETA COUNTY 50 JT,6652,PAGOSA SPRINGS ELEMENTARY SCHOOL,2ND,4,3,0,43,53,103,50,49%
0220,ARCHULETA COUNTY 50 JT,6652,PAGOSA SPRINGS ELEMENTARY SCHOOL,3RD,2,0,1,28,77,108,31,29%
0220,ARCHULETA COUNTY 50 JT,6652,PAGOSA SPRINGS ELEMENTARY SCHOOL,4TH,2,2,0,44,69,117,48,41%
0220,ARCHULETA COUNTY 50 JT,6652,PAGOSA SPRINGS ELEMENTARY SCHOOL,SCHOOL TOTAL,13,7,4,183,346,553,207,37%
0220,ARCHULETA COUNTY 50 JT,6656,PAGOSA SPRINGS INTERMEDIATE SCHOOL,5TH,1,4,0,29,75,109,34,31%
0220,ARCHULETA COUNTY 50 JT,6656,PAGOSA SPRINGS INTERMEDIATE SCHOOL,6TH,0,2,1,23,77,103,26,25%
0220,ARCHULETA COUNTY 50 JT,6656,PAGOSA SPRINGS INTERMEDIATE SCHOOL,SCHOOL TOTAL,1,6,1,52,152,212,60,28%
0220,ARCHULETA COUNTY 50 JT,6657,PAGOSA SPRINGS JUNIOR HIGH SCHOOL,7TH,2,0,5,33,90,130,40,31%
0220,ARCHULETA COUNTY 50 JT,6657,PAGOSA SPRINGS JUNIOR HIGH SCHOOL,8TH,4,2,1,24,90,121,31,26%
0220,ARCHULETA COUNTY 50 JT,6657,PAGOSA SPRINGS JUNIOR HIGH SCHOOL,SCHOOL TOTAL,6,2,6,57,180,251,71,28%
0220,ARCHULETA COUNTY 50 JT,6658,PAGOSA SPRINGS HIGH SCHOOL,9TH,1,0,4,21,104,130,26,20%
0220,ARCHULETA COUNTY 50 JT,6658,PAGOSA SPRINGS HIGH SCHOOL,10TH,1,2,3,23,95,124,29,23%
0220,ARCHULETA COUNTY 50 JT,6658,PAGOSA SPRINGS HIGH SCHOOL,11TH,2,0,0,25,86,113,27,24%
0220,ARCHULETA COUNTY 50 JT,6658,PAGOSA SPRINGS HIGH SCHOOL,12TH,0,2,0,15,83,100,17,17%
0220,ARCHULETA COUNTY 50 JT,6658,PAGOSA SPRINGS HIGH SCHOOL,SCHOOL TOTAL,4,4,7,84,368,467,99,21%
0220,ARCHULETA COUNTY 50 JT,,DISTRICT TOTAL,,25,19,18,391,1064,1517,453,30%
0230,WALSH RE-1,9222,WALSH ELEMENTARY SCHOOL,PK,1,0,0,5,12,18,6,33%
0230,WALSH RE-1,9222,WALSH ELEMENTARY SCHOOL,KINDERGARTEN,0,0,0,1,6,7,1,14%
0230,WALSH RE-1,9222,WALSH ELEMENTARY SCHOOL,1ST,0,0,0,2,6,8,2,25%
0230,WALSH RE-1,9222,WALSH ELEMENTARY SCHOOL,2ND,0,0,0,1,11,12,1,8%
0230,WALSH RE-1,9222,WALSH ELEMENTARY SCHOOL,3RD,0,0,0,3,11,14,3,21%
0230,WALSH RE-1,9222,WALSH ELEMENTARY SCHOOL,4TH,0,0,0,2,6,8,2,25%
0230,WALSH RE-1,9222,WALSH ELEMENTARY SCHOOL,5TH,0,0,0,3,5,8,3,38%
0230,WALSH RE-1,9222,WALSH ELEMENTARY SCHOOL,6TH,0,0,0,3,11,14,3,21%
0230,WALSH RE-1,9222,WALSH ELEMENTARY SCHOOL,SCHOOL TOTAL,1,0,0,20,68,89,21,24%
0230,WALSH RE-1,9226,WALSH HIGH SCHOOL,7TH,0,0,0,1,12,13,1,8%
0230,WALSH RE-1,9226,WALSH HIGH SCHOOL,8TH,0,0,1,3,13,17,4,24%
0230,WALSH RE-1,9226,WALSH HIGH SCHOOL,9TH,0,0,1,1,11,13,2,15%
0230,WALSH RE-1,9226,WALSH HIGH SCHOOL,10TH,0,0,0,0,13,13,0,0%
0230,WALSH RE-1,9226,WALSH HIGH SCHOOL,11TH,0,0,0,1,9,10,1,10%
0230,WALSH RE-1,9226,WALSH HIGH SCHOOL,12TH,1,0,0,2,9,12,3,25%
0230,WALSH RE-1,9226,WALSH HIGH SCHOOL,SCHOOL TOTAL,1,0,2,8,67,78,11,14%
0230,WALSH RE-1,,DISTRICT TOTAL,,2,0,2,28,135,167,32,19%
0240,PRITCHETT RE-3,7174,PRITCHETT ELEMENTARY SCHOOL,PK,0,0,0,1,7,8,1,13%
0240,PRITCHETT RE-3,7174,PRITCHETT ELEMENTARY SCHOOL,KINDERGARTEN,0,0,0,1,4,5,1,20%
0240,PRITCHETT RE-3,7174,PRITCHETT ELEMENTARY SCHOOL,1ST,0,0,0,0,5,5,0,0%
0240,PRITCHETT RE-3,7174,PRITCHETT ELEMENTARY SCHOOL,2ND,0,0,0,0,7,7,0,0%
0240,PRITCHETT RE-3,7174,PRITCHETT ELEMENTARY SCHOOL,3RD,0,0,0,1,2,3,1,33%
0240,PRITCHETT RE-3,7174,PRITCHETT ELEMENTARY SCHOOL,4TH,0,0,0,0,5,5,0,0%
0240,PRITCHETT RE-3,7174,PRITCHETT ELEMENTARY SCHOOL,5TH,0,0,0,0,6,6,0,0%
0240,PRITCHETT RE-3,7174,PRITCHETT ELEMENTARY SCHOOL,SCHOOL TOTAL,0,0,0,3,36,39,3,8%
0240,PRITCHETT RE-3,7176,PRITCHETT MIDDLE SCHOOL,6TH,0,0,0,1,5,6,1,17%
0240,PRITCHETT RE-3,7176,PRITCHETT MIDDLE SCHOOL,7TH,0,0,0,0,5,5,0,0%
0240,PRITCHETT RE-3,7176,PRITCHETT MIDDLE SCHOOL,8TH,0,0,0,0,3,3,0,0%
0240,PRITCHETT RE-3,7176,PRITCHETT MIDDLE SCHOOL,SCHOOL TOTAL,0,0,0,1,13,14,1,7%
0240,PRITCHETT RE-3,7180,PRITCHETT HIGH SCHOOL,9TH,0,0,0,0,4,4,0,0%
0240,PRITCHETT RE-3,7180,PRITCHETT HIGH SCHOOL,10TH,0,0,0,2,7,9,2,22%
0240,PRITCHETT RE-3,7180,PRITCHETT HIGH SCHOOL,11TH,0,0,0,0,3,3,0,0%
0240,PRITCHETT RE-3,7180,PRITCHETT HIGH SCHOOL,12TH,0,0,0,0,3,3,0,0%
0240,PRITCHETT RE-3,7180,PRITCHETT HIGH SCHOOL,SCHOOL TOTAL,0,0,0,2,17,19,2,11%
0240,PRITCHETT RE-3,,DISTRICT TOTAL,,0,0,0,6,66,72,6,8%
0250,SPRINGFIELD RE-4,8160,SPRINGFIELD ELEMENTARY SCHOOL,PK,0,0,0,4,29,33,4,12%
0250,SPRINGFIELD RE-4,8160,SPRINGFIELD ELEMENTARY SCHOOL,KINDERGARTEN,1,1,1,1,15,19,4,21%
0250,SPRINGFIELD RE-4,8160,SPRINGFIELD ELEMENTARY SCHOOL,1ST,0,0,0,3,12,15,3,20%
0250,SPRINGFIELD RE-4,8160,SPRINGFIELD ELEMENTARY SCHOOL,2ND,0,0,0,3,12,15,3,20%
0250,SPRINGFIELD RE-4,8160,SPRINGFIELD ELEMENTARY SCHOOL,3RD,0,0,0,1,16,17,1,6%
0250,SPRINGFIELD RE-4,8160,SPRINGFIELD ELEMENTARY SCHOOL,4TH,0,1,0,0,17,18,1,6%
0250,SPRINGFIELD RE-4,8160,SPRINGFIELD ELEMENTARY SCHOOL,5TH,0,0,0,1,11,12,1,8%
0250,SPRINGFIELD RE-4,8160,SPRINGFIELD ELEMENTARY SCHOOL,6TH,0,0,1,2,23,26,3,12%
0250,SPRINGFIELD RE-4,8160,SPRINGFIELD ELEMENTARY SCHOOL,SCHOOL TOTAL,1,2,2,15,135,155,20,13%
0250,SPRINGFIELD RE-4,8164,SPRINGFIELD JUNIOR HIGH SCHOOL,7TH,0,0,1,1,21,23,2,9%
0250,SPRINGFIELD RE-4,8164,SPRINGFIELD JUNIOR HIGH SCHOOL,8TH,0,0,0,5,21,26,5,19%
0250,SPRINGFIELD RE-4,8164,SPRINGFIELD JUNIOR HIGH SCHOOL,SCHOOL TOTAL,0,0,1,6,42,49,7,14%
0250,SPRINGFIELD RE-4,8168,SPRINGFIELD HIGH SCHOOL,9TH,0,1,1,2,20,24,4,17%
0250,SPRINGFIELD RE-4,8168,SPRINGFIELD HIGH SCHOOL,10TH,0,0,0,4,18,22,4,18%
0250,SPRINGFIELD RE-4,8168,SPRINGFIELD HIGH SCHOOL,11TH,0,0,1,0,19,20,1,5%
0250,SPRINGFIELD RE-4,8168,SPRINGFIELD HIGH SCHOOL,12TH,1,0,0,2,27,30,3,10%
0250,SPRINGFIELD RE-4,8168,SPRINGFIELD HIGH SCHOOL,SCHOOL TOTAL,1,1,2,8,84,96,12,13%
0250,SPRINGFIELD RE-4,,DISTRICT TOTAL,,2,3,5,29,261,300,39,13%
0260,VILAS RE-5,1781,COLORADO ONLINE ACADEMY (COLA),11TH,0,0,0,0,1,1,0,0%
0260,VILAS RE-5,1781,COLORADO ONLINE ACADEMY (COLA),SCHOOL TOTAL,0,0,0,0,1,1,0,0%
0260,VILAS RE-5,9085,V.I.L.A.S. ONLINE SCHOOL,KINDERGARTEN,0,0,0,0,1,1,0,0%
0260,VILAS RE-5,9085,V.I.L.A.S. ONLINE SCHOOL,1ST,0,0,0,0,5,5,0,0%
0260,VILAS RE-5,9085,V.I.L.A.S. ONLINE SCHOOL,2ND,0,0,0,2,3,5,2,40%
0260,VILAS RE-5,9085,V.I.L.A.S. ONLINE SCHOOL,3RD,0,0,0,2,5,7,2,29%
0260,VILAS RE-5,9085,V.I.L.A.S. ONLINE SCHOOL,4TH,0,0,0,0,3,3,0,0%
0260,VILAS RE-5,9085,V.I.L.A.S. ONLINE SCHOOL,5TH,1,0,0,2,3,6,3,50%
0260,VILAS RE-5,9085,V.I.L.A.S. ONLINE SCHOOL,6TH,0,0,0,2,10,12,2,17%
0260,VILAS RE-5,9085,V.I.L.A.S. ONLINE SCHOOL,7TH,0,0,0,5,10,15,5,33%
0260,VILAS RE-5,9085,V.I.L.A.S. ONLINE SCHOOL,8TH,0,0,1,7,17,25,8,32%
0260,VILAS RE-5,9085,V.I.L.A.S. ONLINE SCHOOL,9TH,3,1,2,18,23,47,24,51%
0260,VILAS RE-5,9085,V.I.L.A.S. ONLINE SCHOOL,10TH,0,0,4,18,44,66,22,33%
0260,VILAS RE-5,9085,V.I.L.A.S. ONLINE SCHOOL,11TH,1,2,4,21,55,83,28,34%
0260,VILAS RE-5,9085,V.I.L.A.S. ONLINE SCHOOL,12TH,3,0,1,16,49,69,20,29%
0260,VILAS RE-5,9085,V.I.L.A.S. ONLINE SCHOOL,SCHOOL TOTAL,8,3,12,93,228,344,116,34%
0260,VILAS RE-5,9090,VILAS ELEMENTARY SCHOOL,PK,0,0,0,1,0,1,1,100%
0260,VILAS RE-5,9090,VILAS ELEMENTARY SCHOOL,KINDERGARTEN,0,0,0,3,1,4,3,75%
0260,VILAS RE-5,9090,VILAS ELEMENTARY SCHOOL,1ST,0,0,0,1,4,5,1,20%
0260,VILAS RE-5,9090,VILAS ELEMENTARY SCHOOL,2ND,0,0,0,1,3,4,1,25%
0260,VILAS RE-5,9090,VILAS ELEMENTARY SCHOOL,3RD,0,0,0,2,1,3,2,67%
0260,VILAS RE-5,9090,VILAS ELEMENTARY SCHOOL,4TH,0,0,0,3,2,5,3,60%
0260,VILAS RE-5,9090,VILAS ELEMENTARY SCHOOL,5TH,0,0,0,0,4,4,0,0%
0260,VILAS RE-5,9090,VILAS ELEMENTARY SCHOOL,6TH,0,0,0,0,3,3,0,0%
0260,VILAS RE-5,9090,VILAS ELEMENTARY SCHOOL,SCHOOL TOTAL,0,0,0,11,18,29,11,38%
0260,VILAS RE-5,9100,VILAS UNDIVIDED HIGH SCHOOL,7TH,0,0,0,4,6,10,4,40%
0260,VILAS RE-5,9100,VILAS UNDIVIDED HIGH SCHOOL,8TH,0,0,1,2,2,5,3,60%
0260,VILAS RE-5,9100,VILAS UNDIVIDED HIGH SCHOOL,9TH,0,0,0,1,2,3,1,33%
0260,VILAS RE-5,9100,VILAS UNDIVIDED HIGH SCHOOL,10TH,0,0,0,2,5,7,2,29%
0260,VILAS RE-5,9100,VILAS UNDIVIDED HIGH SCHOOL,11TH,0,0,0,1,4,5,1,20%
0260,VILAS RE-5,9100,VILAS UNDIVIDED HIGH SCHOOL,12TH,0,0,0,5,6,11,5,45%
0260,VILAS RE-5,9100,VILAS UNDIVIDED HIGH SCHOOL,SCHOOL TOTAL,0,0,1,15,25,41,16,39%
0260,VILAS RE-5,,DISTRICT TOTAL,,8,3,13,119,272,415,143,34%
0270,CAMPO RE-6,1248,CAMPO ELEMENTARY SCHOOL,PK,0,0,0,1,4,5,1,20%
0270,CAMPO RE-6,1248,CAMPO ELEMENTARY SCHOOL,KINDERGARTEN,0,0,0,0,3,3,0,0%
0270,CAMPO RE-6,1248,CAMPO ELEMENTARY SCHOOL,1ST,0,0,0,0,3,3,0,0%
0270,CAMPO RE-6,1248,CAMPO ELEMENTARY SCHOOL,2ND,0,0,0,0,2,2,0,0%
0270,CAMPO RE-6,1248,CAMPO ELEMENTARY SCHOOL,3RD,0,0,0,2,0,2,2,100%
0270,CAMPO RE-6,1248,CAMPO ELEMENTARY SCHOOL,4TH,0,0,0,0,5,5,0,0%
0270,CAMPO RE-6,1248,CAMPO ELEMENTARY SCHOOL,5TH,0,0,0,0,2,2,0,0%
0270,CAMPO RE-6,1248,CAMPO ELEMENTARY SCHOOL,SCHOOL TOTAL,0,0,0,3,19,22,3,14%
0270,CAMPO RE-6,1252,CAMPO UNDIVIDED HIGH SCHOOL,6TH,0,0,0,1,4,5,1,20%
0270,CAMPO RE-6,1252,CAMPO UNDIVIDED HIGH SCHOOL,7TH,0,0,0,0,5,5,0,0%
0270,CAMPO RE-6,1252,CAMPO UNDIVIDED HIGH SCHOOL,8TH,0,0,0,0,1,1,0,0%
0270,CAMPO RE-6,1252,CAMPO UNDIVIDED HIGH SCHOOL,9TH,0,0,0,1,1,2,1,50%
0270,CAMPO RE-6,1252,CAMPO UNDIVIDED HIGH SCHOOL,10TH,0,0,0,0,7,7,0,0%
0270,CAMPO RE-6,1252,CAMPO UNDIVIDED HIGH SCHOOL,11TH,0,0,0,1,4,5,1,20%
0270,CAMPO RE-6,1252,CAMPO UNDIVIDED HIGH SCHOOL,12TH,0,0,0,0,2,2,0,0%
0270,CAMPO RE-6,1252,CAMPO UNDIVIDED HIGH SCHOOL,SCHOOL TOTAL,0,0,0,3,24,27,3,11%
0270,CAMPO RE-6,,DISTRICT TOTAL,,0,0,0,6,43,49,6,12%
0290,LAS ANIMAS RE-1,1812,LAS ANIMAS ELEMENTARY SCHOOL,KINDERGARTEN,0,0,0,27,18,45,27,60%
0290,LAS ANIMAS RE-1,1812,LAS ANIMAS ELEMENTARY SCHOOL,1ST,0,0,0,30,27,57,30,53%
0290,LAS ANIMAS RE-1,1812,LAS ANIMAS ELEMENTARY SCHOOL,2ND,0,1,0,26,15,42,27,64%
0290,LAS ANIMAS RE-1,1812,LAS ANIMAS ELEMENTARY SCHOOL,3RD,0,0,1,26,21,48,27,56%
0290,LAS ANIMAS RE-1,1812,LAS ANIMAS ELEMENTARY SCHOOL,4TH,0,1,1,23,16,41,25,61%
0290,LAS ANIMAS RE-1,1812,LAS ANIMAS ELEMENTARY SCHOOL,5TH,1,2,1,24,13,41,28,68%
0290,LAS ANIMAS RE-1,1812,LAS ANIMAS ELEMENTARY SCHOOL,SCHOOL TOTAL,1,4,3,156,110,274,164,60%
0290,LAS ANIMAS RE-1,4495,JUMP START LEARNING CENTER,PK,1,0,0,26,25,52,27,52%
0290,LAS ANIMAS RE-1,4495,JUMP START LEARNING CENTER,SCHOOL TOTAL,1,0,0,26,25,52,27,52%
0290,LAS ANIMAS RE-1,4983,LAS ANIMAS A+ DISTANCE LEARNING SCHOOL,7TH,0,0,0,1,0,1,1,100%
0290,LAS ANIMAS RE-1,4983,LAS ANIMAS A+ DISTANCE LEARNING SCHOOL,9TH,0,0,0,1,1,2,1,50%
0290,LAS ANIMAS RE-1,4983,LAS ANIMAS A+ DISTANCE LEARNING SCHOOL,10TH,0,0,0,0,2,2,0,0%
0290,LAS ANIMAS RE-1,4983,LAS ANIMAS A+ DISTANCE LEARNING SCHOOL,12TH,0,0,0,0,1,1,0,0%
0290,LAS ANIMAS RE-1,4983,LAS ANIMAS A+ DISTANCE LEARNING SCHOOL,SCHOOL TOTAL,0,0,0,2,4,6,2,33%
0290,LAS ANIMAS RE-1,4986,LAS ANIMAS MIDDLE SCHOOL,6TH,0,0,0,20,14,34,20,59%
0290,LAS ANIMAS RE-1,4986,LAS ANIMAS MIDDLE SCHOOL,7TH,0,0,1,20,25,46,21,46%
0290,LAS ANIMAS RE-1,4986,LAS ANIMAS MIDDLE SCHOOL,8TH,0,1,0,14,17,32,15,47%
0290,LAS ANIMAS RE-1,4986,LAS ANIMAS MIDDLE SCHOOL,SCHOOL TOTAL,0,1,1,54,56,112,56,50%
0290,LAS ANIMAS RE-1,4990,LAS ANIMAS HIGH SCHOOL,9TH,0,0,1,20,25,46,21,46%
0290,LAS ANIMAS RE-1,4990,LAS ANIMAS HIGH SCHOOL,10TH,0,0,0,16,20,36,16,44%
0290,LAS ANIMAS RE-1,4990,LAS ANIMAS HIGH SCHOOL,11TH,0,2,0,18,22,42,20,48%
0290,LAS ANIMAS RE-1,4990,LAS ANIMAS HIGH SCHOOL,12TH,0,0,0,12,12,24,12,50%
0290,LAS ANIMAS RE-1,4990,LAS ANIMAS HIGH SCHOOL,SCHOOL TOTAL,0,2,1,66,79,148,69,47%
0290,LAS ANIMAS RE-1,,DISTRICT TOTAL,,2,7,5,304,274,592,318,54%
0310,MC CLAVE RE-2,5666,MC CLAVE ELEMENTARY SCHOOL,PK,0,0,0,10,10,20,10,50%
0310,MC CLAVE RE-2,5666,MC CLAVE ELEMENTARY SCHOOL,KINDERGARTEN,0,0,0,4,7,11,4,36%
0310,MC CLAVE RE-2,5666,MC CLAVE ELEMENTARY SCHOOL,1ST,1,0,0,4,11,16,5,31%
0310,MC CLAVE RE-2,5666,MC CLAVE ELEMENTARY SCHOOL,2ND,0,0,0,3,14,17,3,18%
0310,MC CLAVE RE-2,5666,MC CLAVE ELEMENTARY SCHOOL,3RD,0,0,0,7,17,24,7,29%
0310,MC CLAVE RE-2,5666,MC CLAVE ELEMENTARY SCHOOL,4TH,0,0,0,1,13,14,1,7%
0310,MC CLAVE RE-2,5666,MC CLAVE ELEMENTARY SCHOOL,5TH,0,0,1,5,17,23,6,26%
0310,MC CLAVE RE-2,5666,MC CLAVE ELEMENTARY SCHOOL,6TH,0,0,0,7,15,22,7,32%
0310,MC CLAVE RE-2,5666,MC CLAVE ELEMENTARY SCHOOL,SCHOOL TOTAL,1,0,1,41,104,147,43,29%
0310,MC CLAVE RE-2,5670,MC CLAVE UNDIVIDED HIGH SCHOOL,7TH,0,0,0,11,9,20,11,55%
0310,MC CLAVE RE-2,5670,MC CLAVE UNDIVIDED HIGH SCHOOL,8TH,0,0,0,6,14,20,6,30%
0310,MC CLAVE RE-2,5670,MC CLAVE UNDIVIDED HIGH SCHOOL,9TH,0,0,0,6,10,16,6,38%
0310,MC CLAVE RE-2,5670,MC CLAVE UNDIVIDED HIGH SCHOOL,10TH,0,0,0,8,14,22,8,36%
0310,MC CLAVE RE-2,5670,MC CLAVE UNDIVIDED HIGH SCHOOL,11TH,0,0,0,6,12,18,6,33%
0310,MC CLAVE RE-2,5670,MC CLAVE UNDIVIDED HIGH SCHOOL,12TH,0,0,0,4,12,16,4,25%
0310,MC CLAVE RE-2,5670,MC CLAVE UNDIVIDED HIGH SCHOOL,SCHOOL TOTAL,0,0,0,41,71,112,41,37%
0310,MC CLAVE RE-2,,DISTRICT TOTAL,,1,0,1,82,175,259,84,32%
0470,ST VRAIN VALLEY RE 1J,0060,LEGACY ELEMENTARY SCHOOL,PK,0,0,2,5,37,44,7,16%
0470,ST VRAIN VALLEY RE 1J,0060,LEGACY ELEMENTARY SCHOOL,HALF DAY K,1,2,0,15,52,70,18,26%
0470,ST VRAIN VALLEY RE 1J,0060,LEGACY ELEMENTARY SCHOOL,KINDERGARTEN,0,2,0,3,19,24,5,21%
0470,ST VRAIN VALLEY RE 1J,0060,LEGACY ELEMENTARY SCHOOL,1ST,0,1,1,13,61,76,15,20%
0470,ST VRAIN VALLEY RE 1J,0060,LEGACY ELEMENTARY SCHOOL,2ND,0,4,0,8,74,86,12,14%
0470,ST VRAIN VALLEY RE 1J,0060,LEGACY ELEMENTARY SCHOOL,3RD,0,3,1,12,63,79,16,20%
0470,ST VRAIN VALLEY RE 1J,0060,LEGACY ELEMENTARY SCHOOL,4TH,0,1,0,10,64,75,11,15%
0470,ST VRAIN VALLEY RE 1J,0060,LEGACY ELEMENTARY SCHOOL,5TH,1,4,0,16,56,77,21,27%
0470,ST VRAIN VALLEY RE 1J,0060,LEGACY ELEMENTARY SCHOOL,SCHOOL TOTAL,2,17,4,82,426,531,105,20%
0470,ST VRAIN VALLEY RE 1J,0061,ALPINE ELEMENTARY SCHOOL,PK,2,2,0,12,45,61,16,26%
0470,ST VRAIN VALLEY RE 1J,0061,ALPINE ELEMENTARY SCHOOL,KINDERGARTEN,0,3,2,12,60,77,17,22%
0470,ST VRAIN VALLEY RE 1J,0061,ALPINE ELEMENTARY SCHOOL,1ST,3,4,2,12,61,82,21,26%
0470,ST VRAIN VALLEY RE 1J,0061,ALPINE ELEMENTARY SCHOOL,2ND,1,6,0,17,46,70,24,34%
0470,ST VRAIN VALLEY RE 1J,0061,ALPINE ELEMENTARY SCHOOL,3RD,0,4,2,11,53,70,17,24%
0470,ST VRAIN VALLEY RE 1J,0061,ALPINE ELEMENTARY SCHOOL,4TH,0,5,2,11,57,75,18,24%
0470,ST VRAIN VALLEY RE 1J,0061,ALPINE ELEMENTARY SCHOOL,5TH,2,2,1,16,49,70,21,30%
0470,ST VRAIN VALLEY RE 1J,0061,ALPINE ELEMENTARY SCHOOL,SCHOOL TOTAL,8,26,9,91,371,505,134,27%
0470,ST VRAIN VALLEY RE 1J,0226,ALTONA MIDDLE SCHOOL,6TH,1,22,2,19,155,199,44,22%
0470,ST VRAIN VALLEY RE 1J,0226,ALTONA MIDDLE SCHOOL,7TH,0,22,6,27,178,233,55,24%
0470,ST VRAIN VALLEY RE 1J,0226,ALTONA MIDDLE SCHOOL,8TH,1,13,4,21,140,179,39,22%
0470,ST VRAIN VALLEY RE 1J,0226,ALTONA MIDDLE SCHOOL,SCHOOL TOTAL,2,57,12,67,473,611,138,23%
0470,ST VRAIN VALLEY RE 1J,0875,BLACK ROCK ELEMENTARY,PK,0,2,0,0,28,30,2,7%
0470,ST VRAIN VALLEY RE 1J,0875,BLACK ROCK ELEMENTARY,HALF DAY K,0,6,1,9,101,117,16,14%
0470,ST VRAIN VALLEY RE 1J,0875,BLACK ROCK ELEMENTARY,KINDERGARTEN,0,0,0,2,23,25,2,8%
0470,ST VRAIN VALLEY RE 1J,0875,BLACK ROCK ELEMENTARY,1ST,0,6,0,13,125,144,19,13%
0470,ST VRAIN VALLEY RE 1J,0875,BLACK ROCK ELEMENTARY,2ND,1,5,2,9,128,145,17,12%
0470,ST VRAIN VALLEY RE 1J,0875,BLACK ROCK ELEMENTARY,3RD,0,2,2,13,91,108,17,16%
0470,ST VRAIN VALLEY RE 1J,0875,BLACK ROCK ELEMENTARY,4TH,0,6,1,11,82,100,18,18%
0470,ST VRAIN VALLEY RE 1J,0875,BLACK ROCK ELEMENTARY,5TH,1,8,0,12,91,112,21,19%
0470,ST VRAIN VALLEY RE 1J,0875,BLACK ROCK ELEMENTARY,SCHOOL TOTAL,2,35,6,69,669,781,112,14%
0470,ST VRAIN VALLEY RE 1J,0878,BLUE MOUNTAIN ELEMENTARY,PK,0,7,0,5,31,43,12,28%
0470,ST VRAIN VALLEY RE 1J,0878,BLUE MOUNTAIN ELEMENTARY,HALF DAY K,0,4,0,3,42,49,7,14%
0470,ST VRAIN VALLEY RE 1J,0878,BLUE MOUNTAIN ELEMENTARY,KINDERGARTEN,0,1,0,1,23,25,2,8%
0470,ST VRAIN VALLEY RE 1J,0878,BLUE MOUNTAIN ELEMENTARY,1ST,0,6,1,5,58,70,12,17%
0470,ST VRAIN VALLEY RE 1J,0878,BLUE MOUNTAIN ELEMENTARY,2ND,0,10,1,5,50,66,16,24%
0470,ST VRAIN VALLEY RE 1J,0878,BLUE MOUNTAIN ELEMENTARY,3RD,0,5,1,2,48,56,8,14%
0470,ST VRAIN VALLEY RE 1J,0878,BLUE MOUNTAIN ELEMENTARY,4TH,0,10,0,5,48,63,15,24%
0470,ST VRAIN VALLEY RE 1J,0878,BLUE MOUNTAIN ELEMENTARY,5TH,0,5,2,3,47,57,10,18%
0470,ST VRAIN VALLEY RE 1J,0878,BLUE MOUNTAIN ELEMENTARY,SCHOOL TOTAL,0,48,5,29,347,429,82,19%
0470,ST VRAIN VALLEY RE 1J,1148,BURLINGTON ELEMENTARY SCHOOL,PK,0,2,0,11,21,34,13,38%
0470,ST VRAIN VALLEY RE 1J,1148,BURLINGTON ELEMENTARY SCHOOL,HALF DAY K,0,1,0,14,22,37,15,41%
0470,ST VRAIN VALLEY RE 1J,1148,BURLINGTON ELEMENTARY SCHOOL,KINDERGARTEN,0,0,1,2,23,26,3,12%
0470,ST VRAIN VALLEY RE 1J,1148,BURLINGTON ELEMENTARY SCHOOL,1ST,0,2,1,22,46,71,25,35%
0470,ST VRAIN VALLEY RE 1J,1148,BURLINGTON ELEMENTARY SCHOOL,2ND,0,2,0,24,56,82,26,32%
0470,ST VRAIN VALLEY RE 1J,1148,BURLINGTON ELEMENTARY SCHOOL,3RD,1,3,0,19,52,75,23,31%
0470,ST VRAIN VALLEY RE 1J,1148,BURLINGTON ELEMENTARY SCHOOL,4TH,0,2,1,18,54,75,21,28%
0470,ST VRAIN VALLEY RE 1J,1148,BURLINGTON ELEMENTARY SCHOOL,5TH,2,3,2,20,53,80,27,34%
0470,ST VRAIN VALLEY RE 1J,1148,BURLINGTON ELEMENTARY SCHOOL,SCHOOL TOTAL,3,15,5,130,327,480,153,32%
0470,ST VRAIN VALLEY RE 1J,1245,CENTENNIAL ELEMENTARY,PK,0,3,2,7,21,33,12,36%
0470,ST VRAIN VALLEY RE 1J,1245,CENTENNIAL ELEMENTARY,HALF DAY K,2,0,0,14,35,51,16,31%
0470,ST VRAIN VALLEY RE 1J,1245,CENTENNIAL ELEMENTARY,KINDERGARTEN,0,0,0,4,22,26,4,15%
0470,ST VRAIN VALLEY RE 1J,1245,CENTENNIAL ELEMENTARY,1ST,1,1,0,8,70,80,10,13%
0470,ST VRAIN VALLEY RE 1J,1245,CENTENNIAL ELEMENTARY,2ND,1,0,3,17,57,78,21,27%
0470,ST VRAIN VALLEY RE 1J,1245,CENTENNIAL ELEMENTARY,3RD,4,1,1,10,67,83,16,19%
0470,ST VRAIN VALLEY RE 1J,1245,CENTENNIAL ELEMENTARY,4TH,2,1,2,24,66,95,29,31%
0470,ST VRAIN VALLEY RE 1J,1245,CENTENNIAL ELEMENTARY,5TH,3,0,2,23,35,63,28,44%
0470,ST VRAIN VALLEY RE 1J,1245,CENTENNIAL ELEMENTARY,SCHOOL TOTAL,13,6,10,107,373,509,136,27%
0470,ST VRAIN VALLEY RE 1J,1284,CARBON VALLEY ACADEMY,PK,0,0,0,5,70,75,5,7%
0470,ST VRAIN VALLEY RE 1J,1284,CARBON VALLEY ACADEMY,HALF DAY K,0,0,1,1,37,39,2,5%
0470,ST VRAIN VALLEY RE 1J,1284,CARBON VALLEY ACADEMY,KINDERGARTEN,0,0,0,2,18,20,2,10%
0470,ST VRAIN VALLEY RE 1J,1284,CARBON VALLEY ACADEMY,1ST,1,0,0,7,56,64,8,13%
0470,ST VRAIN VALLEY RE 1J,1284,CARBON VALLEY ACADEMY,2ND,0,1,0,8,38,47,9,19%
0470,ST VRAIN VALLEY RE 1J,1284,CARBON VALLEY ACADEMY,3RD,0,1,0,1,38,40,2,5%
0470,ST VRAIN VALLEY RE 1J,1284,CARBON VALLEY ACADEMY,4TH,0,2,0,2,39,43,4,9%
0470,ST VRAIN VALLEY RE 1J,1284,CARBON VALLEY ACADEMY,5TH,0,0,1,2,34,37,3,8%
0470,ST VRAIN VALLEY RE 1J,1284,CARBON VALLEY ACADEMY,6TH,0,2,0,2,21,25,4,16%
0470,ST VRAIN VALLEY RE 1J,1284,CARBON VALLEY ACADEMY,7TH,0,0,0,5,12,17,5,29%
0470,ST VRAIN VALLEY RE 1J,1284,CARBON VALLEY ACADEMY,8TH,0,0,0,0,12,12,0,0%
0470,ST VRAIN VALLEY RE 1J,1284,CARBON VALLEY ACADEMY,9TH,0,0,0,3,11,14,3,21%
0470,ST VRAIN VALLEY RE 1J,1284,CARBON VALLEY ACADEMY,10TH,0,0,0,0,7,7,0,0%
0470,ST VRAIN VALLEY RE 1J,1284,CARBON VALLEY ACADEMY,SCHOOL TOTAL,1,6,2,38,393,440,47,11%
0470,ST VRAIN VALLEY RE 1J,1434,CENTRAL ELEMENTARY SCHOOL,PK,1,1,1,9,26,38,12,32%
0470,ST VRAIN VALLEY RE 1J,1434,CENTRAL ELEMENTARY SCHOOL,HALF DAY K,0,1,1,7,13,22,9,41%
0470,ST VRAIN VALLEY RE 1J,1434,CENTRAL ELEMENTARY SCHOOL,KINDERGARTEN,1,1,0,24,17,43,26,60%
0470,ST VRAIN VALLEY RE 1J,1434,CENTRAL ELEMENTARY SCHOOL,1ST,0,3,1,39,34,77,43,56%
0470,ST VRAIN VALLEY RE 1J,1434,CENTRAL ELEMENTARY SCHOOL,2ND,1,1,2,31,34,69,35,51%
0470,ST VRAIN VALLEY RE 1J,1434,CENTRAL ELEMENTARY SCHOOL,3RD,1,2,0,33,30,66,36,55%
0470,ST VRAIN VALLEY RE 1J,1434,CENTRAL ELEMENTARY SCHOOL,4TH,2,0,0,36,29,67,38,57%
0470,ST VRAIN VALLEY RE 1J,1434,CENTRAL ELEMENTARY SCHOOL,5TH,0,1,2,23,32,58,26,45%
0470,ST VRAIN VALLEY RE 1J,1434,CENTRAL ELEMENTARY SCHOOL,SCHOOL TOTAL,6,10,7,202,215,440,225,51%
0470,ST VRAIN VALLEY RE 1J,1844,COLUMBINE ELEMENTARY SCHOOL,PK,0,0,2,24,4,30,26,87%
0470,ST VRAIN VALLEY RE 1J,1844,COLUMBINE ELEMENTARY SCHOOL,KINDERGARTEN,0,0,1,58,8,67,59,88%
0470,ST VRAIN VALLEY RE 1J,1844,COLUMBINE ELEMENTARY SCHOOL,1ST,0,0,3,61,5,69,64,93%
0470,ST VRAIN VALLEY RE 1J,1844,COLUMBINE ELEMENTARY SCHOOL,2ND,0,1,0,44,8,53,45,85%
0470,ST VRAIN VALLEY RE 1J,1844,COLUMBINE ELEMENTARY SCHOOL,3RD,0,0,0,46,8,54,46,85%
0470,ST VRAIN VALLEY RE 1J,1844,COLUMBINE ELEMENTARY SCHOOL,4TH,0,1,1,46,7,55,48,87%
0470,ST VRAIN VALLEY RE 1J,1844,COLUMBINE ELEMENTARY SCHOOL,5TH,1,0,0,48,4,53,49,92%
0470,ST VRAIN VALLEY RE 1J,1844,COLUMBINE ELEMENTARY SCHOOL,SCHOOL TOTAL,1,2,7,327,44,381,337,88%
0470,ST VRAIN VALLEY RE 1J,2343,EAGLE CREST ELEMENTARY SCHOOL,PK,0,4,1,3,32,40,8,20%
0470,ST VRAIN VALLEY RE 1J,2343,EAGLE CREST ELEMENTARY SCHOOL,HALF DAY K,1,4,1,5,23,34,11,32%
0470,ST VRAIN VALLEY RE 1J,2343,EAGLE CREST ELEMENTARY SCHOOL,KINDERGARTEN,0,4,2,2,17,25,8,32%
0470,ST VRAIN VALLEY RE 1J,2343,EAGLE CREST ELEMENTARY SCHOOL,1ST,3,10,0,10,58,81,23,28%
0470,ST VRAIN VALLEY RE 1J,2343,EAGLE CREST ELEMENTARY SCHOOL,2ND,0,9,1,8,61,79,18,23%
0470,ST VRAIN VALLEY RE 1J,2343,EAGLE CREST ELEMENTARY SCHOOL,3RD,0,3,1,17,54,75,21,28%
0470,ST VRAIN VALLEY RE 1J,2343,EAGLE CREST ELEMENTARY SCHOOL,4TH,1,5,1,11,47,65,18,28%
0470,ST VRAIN VALLEY RE 1J,2343,EAGLE CREST ELEMENTARY SCHOOL,5TH,0,3,1,11,70,85,15,18%
0470,ST VRAIN VALLEY RE 1J,2343,EAGLE CREST ELEMENTARY SCHOOL,SCHOOL TOTAL,5,42,8,67,362,484,122,25%
0470,ST VRAIN VALLEY RE 1J,2758,ERIE ELEMENTARY SCHOOL,PK,1,2,0,4,39,46,7,15%
0470,ST VRAIN VALLEY RE 1J,2758,ERIE ELEMENTARY SCHOOL,HALF DAY K,0,1,1,5,71,78,7,9%
0470,ST VRAIN VALLEY RE 1J,2758,ERIE ELEMENTARY SCHOOL,KINDERGARTEN,0,0,0,2,22,24,2,8%
0470,ST VRAIN VALLEY RE 1J,2758,ERIE ELEMENTARY SCHOOL,1ST,0,5,0,8,91,104,13,13%
0470,ST VRAIN VALLEY RE 1J,2758,ERIE ELEMENTARY SCHOOL,2ND,0,2,2,8,67,79,12,15%
0470,ST VRAIN VALLEY RE 1J,2758,ERIE ELEMENTARY SCHOOL,3RD,0,2,4,8,77,91,14,15%
0470,ST VRAIN VALLEY RE 1J,2758,ERIE ELEMENTARY SCHOOL,4TH,2,3,1,17,73,96,23,24%
0470,ST VRAIN VALLEY RE 1J,2758,ERIE ELEMENTARY SCHOOL,5TH,1,0,1,10,59,71,12,17%
0470,ST VRAIN VALLEY RE 1J,2758,ERIE ELEMENTARY SCHOOL,SCHOOL TOTAL,4,15,9,62,499,589,90,15%
0470,ST VRAIN VALLEY RE 1J,2760,ERIE MIDDLE SCHOOL,6TH,1,7,1,20,140,169,29,17%
0470,ST VRAIN VALLEY RE 1J,2760,ERIE MIDDLE SCHOOL,7TH,0,5,0,20,142,167,25,15%
0470,ST VRAIN VALLEY RE 1J,2760,ERIE MIDDLE SCHOOL,8TH,2,4,1,24,127,158,31,20%
0470,ST VRAIN VALLEY RE 1J,2760,ERIE MIDDLE SCHOOL,SCHOOL TOTAL,3,16,2,64,409,494,85,17%
0470,ST VRAIN VALLEY RE 1J,2761,ERIE HIGH SCHOOL,9TH,0,9,2,26,155,192,37,19%
0470,ST VRAIN VALLEY RE 1J,2761,ERIE HIGH SCHOOL,10TH,2,7,4,25,140,178,38,21%
0470,ST VRAIN VALLEY RE 1J,2761,ERIE HIGH SCHOOL,11TH,3,8,4,21,152,188,36,19%
0470,ST VRAIN VALLEY RE 1J,2761,ERIE HIGH SCHOOL,12TH,1,10,5,10,115,141,26,18%
0470,ST VRAIN VALLEY RE 1J,2761,ERIE HIGH SCHOOL,SCHOOL TOTAL,6,34,15,82,562,699,137,20%
0470,ST VRAIN VALLEY RE 1J,2912,FALL RIVER ELEMENTARY SCHOOL,PK,0,6,0,3,33,42,9,21%
0470,ST VRAIN VALLEY RE 1J,2912,FALL RIVER ELEMENTARY SCHOOL,HALF DAY K,1,3,0,10,54,68,14,21%
0470,ST VRAIN VALLEY RE 1J,2912,FALL RIVER ELEMENTARY SCHOOL,1ST,1,5,0,9,72,87,15,17%
0470,ST VRAIN VALLEY RE 1J,2912,FALL RIVER ELEMENTARY SCHOOL,2ND,0,6,1,6,61,74,13,18%
0470,ST VRAIN VALLEY RE 1J,2912,FALL RIVER ELEMENTARY SCHOOL,3RD,1,5,1,10,67,84,17,20%
0470,ST VRAIN VALLEY RE 1J,2912,FALL RIVER ELEMENTARY SCHOOL,4TH,0,3,1,19,70,93,23,25%
0470,ST VRAIN VALLEY RE 1J,2912,FALL RIVER ELEMENTARY SCHOOL,5TH,0,4,2,8,81,95,14,15%
0470,ST VRAIN VALLEY RE 1J,2912,FALL RIVER ELEMENTARY SCHOOL,SCHOOL TOTAL,3,32,5,65,438,543,105,19%
0470,ST VRAIN VALLEY RE 1J,2964,FLAGSTAFF CHARTER ACADEMY,HALF DAY K,0,1,0,1,22,24,2,8%
0470,ST VRAIN VALLEY RE 1J,2964,FLAGSTAFF CHARTER ACADEMY,KINDERGARTEN,0,6,0,3,60,69,9,13%
0470,ST VRAIN VALLEY RE 1J,2964,FLAGSTAFF CHARTER ACADEMY,1ST,1,8,1,8,82,100,18,18%
0470,ST VRAIN VALLEY RE 1J,2964,FLAGSTAFF CHARTER ACADEMY,2ND,0,3,0,4,93,100,7,7%
0470,ST VRAIN VALLEY RE 1J,2964,FLAGSTAFF CHARTER ACADEMY,3RD,1,7,2,6,84,100,16,16%
0470,ST VRAIN VALLEY RE 1J,2964,FLAGSTAFF CHARTER ACADEMY,4TH,0,5,4,3,64,76,12,16%
0470,ST VRAIN VALLEY RE 1J,2964,FLAGSTAFF CHARTER ACADEMY,5TH,0,2,1,2,71,76,5,7%
0470,ST VRAIN VALLEY RE 1J,2964,FLAGSTAFF CHARTER ACADEMY,6TH,1,4,0,3,46,54,8,15%
0470,ST VRAIN VALLEY RE 1J,2964,FLAGSTAFF CHARTER ACADEMY,7TH,0,3,0,3,42,48,6,13%
0470,ST VRAIN VALLEY RE 1J,2964,FLAGSTAFF CHARTER ACADEMY,8TH,0,0,1,3,24,28,4,14%
0470,ST VRAIN VALLEY RE 1J,2964,FLAGSTAFF CHARTER ACADEMY,SCHOOL TOTAL,3,39,9,36,588,675,87,13%
0470,ST VRAIN VALLEY RE 1J,3192,FREDERICK ELEMENTARY SCHOOL,PK,2,0,0,16,20,38,18,47%
0470,ST VRAIN VALLEY RE 1J,3192,FREDERICK ELEMENTARY SCHOOL,HALF DAY K,0,3,0,14,25,42,17,40%
0470,ST VRAIN VALLEY RE 1J,3192,FREDERICK ELEMENTARY SCHOOL,KINDERGARTEN,0,1,0,31,9,41,32,78%
0470,ST VRAIN VALLEY RE 1J,3192,FREDERICK ELEMENTARY SCHOOL,1ST,1,0,0,62,39,102,63,62%
0470,ST VRAIN VALLEY RE 1J,3192,FREDERICK ELEMENTARY SCHOOL,2ND,0,1,0,33,39,73,34,47%
0470,ST VRAIN VALLEY RE 1J,3192,FREDERICK ELEMENTARY SCHOOL,3RD,2,3,2,41,37,85,48,56%
0470,ST VRAIN VALLEY RE 1J,3192,FREDERICK ELEMENTARY SCHOOL,4TH,2,0,1,45,46,94,48,51%
0470,ST VRAIN VALLEY RE 1J,3192,FREDERICK ELEMENTARY SCHOOL,5TH,1,1,1,44,25,72,47,65%
0470,ST VRAIN VALLEY RE 1J,3192,FREDERICK ELEMENTARY SCHOOL,SCHOOL TOTAL,8,9,4,286,240,547,307,56%
0470,ST VRAIN VALLEY RE 1J,3194,COAL RIDGE MIDDLE SCHOOL,6TH,4,7,1,79,183,274,91,33%
0470,ST VRAIN VALLEY RE 1J,3194,COAL RIDGE MIDDLE SCHOOL,7TH,1,7,3,88,191,290,99,34%
0470,ST VRAIN VALLEY RE 1J,3194,COAL RIDGE MIDDLE SCHOOL,8TH,0,8,2,68,155,233,78,33%
0470,ST VRAIN VALLEY RE 1J,3194,COAL RIDGE MIDDLE SCHOOL,SCHOOL TOTAL,5,22,6,235,529,797,268,34%
0470,ST VRAIN VALLEY RE 1J,3196,FREDERICK SENIOR HIGH SCHOOL,9TH,2,6,2,58,137,205,68,33%
0470,ST VRAIN VALLEY RE 1J,3196,FREDERICK SENIOR HIGH SCHOOL,10TH,4,4,2,51,151,212,61,29%
0470,ST VRAIN VALLEY RE 1J,3196,FREDERICK SENIOR HIGH SCHOOL,11TH,4,9,1,67,141,222,81,36%
0470,ST VRAIN VALLEY RE 1J,3196,FREDERICK SENIOR HIGH SCHOOL,12TH,1,5,2,60,152,220,68,31%
0470,ST VRAIN VALLEY RE 1J,3196,FREDERICK SENIOR HIGH SCHOOL,SCHOOL TOTAL,11,24,7,236,581,859,278,32%
0470,ST VRAIN VALLEY RE 1J,4202,HYGIENE ELEMENTARY SCHOOL,PK,0,1,0,1,38,40,2,5%
0470,ST VRAIN VALLEY RE 1J,4202,HYGIENE ELEMENTARY SCHOOL,HALF DAY K,0,0,0,5,20,25,5,20%
0470,ST VRAIN VALLEY RE 1J,4202,HYGIENE ELEMENTARY SCHOOL,KINDERGARTEN,0,0,0,2,23,25,2,8%
0470,ST VRAIN VALLEY RE 1J,4202,HYGIENE ELEMENTARY SCHOOL,1ST,0,1,1,6,38,46,8,17%
0470,ST VRAIN VALLEY RE 1J,4202,HYGIENE ELEMENTARY SCHOOL,2ND,1,5,1,11,59,77,18,23%
0470,ST VRAIN VALLEY RE 1J,4202,HYGIENE ELEMENTARY SCHOOL,3RD,0,5,0,9,60,74,14,19%
0470,ST VRAIN VALLEY RE 1J,4202,HYGIENE ELEMENTARY SCHOOL,4TH,0,2,1,2,64,69,5,7%
0470,ST VRAIN VALLEY RE 1J,4202,HYGIENE ELEMENTARY SCHOOL,5TH,0,4,0,2,63,69,6,9%
0470,ST VRAIN VALLEY RE 1J,4202,HYGIENE ELEMENTARY SCHOOL,SCHOOL TOTAL,1,18,3,38,365,425,60,14%
0470,ST VRAIN VALLEY RE 1J,4278,INDIAN PEAKS ELEMENTARY SCHOOL,PK,0,0,0,26,6,32,26,81%
0470,ST VRAIN VALLEY RE 1J,4278,INDIAN PEAKS ELEMENTARY SCHOOL,KINDERGARTEN,0,2,0,65,6,73,67,92%
0470,ST VRAIN VALLEY RE 1J,4278,INDIAN PEAKS ELEMENTARY SCHOOL,1ST,0,1,3,58,10,72,62,86%
0470,ST VRAIN VALLEY RE 1J,4278,INDIAN PEAKS ELEMENTARY SCHOOL,2ND,0,0,1,77,17,95,78,82%
0470,ST VRAIN VALLEY RE 1J,4278,INDIAN PEAKS ELEMENTARY SCHOOL,3RD,0,1,0,58,7,66,59,89%
0470,ST VRAIN VALLEY RE 1J,4278,INDIAN PEAKS ELEMENTARY SCHOOL,4TH,0,1,0,73,12,86,74,86%
0470,ST VRAIN VALLEY RE 1J,4278,INDIAN PEAKS ELEMENTARY SCHOOL,5TH,1,0,1,42,13,57,44,77%
0470,ST VRAIN VALLEY RE 1J,4278,INDIAN PEAKS ELEMENTARY SCHOOL,SCHOOL TOTAL,1,5,5,399,71,481,410,85%
0470,ST VRAIN VALLEY RE 1J,4333,IMAGINE CHARTER,HALF DAY K,0,1,1,4,44,50,6,12%
0470,ST VRAIN VALLEY RE 1J,4333,IMAGINE CHARTER,KINDERGARTEN,0,2,2,3,41,48,7,15%
0470,ST VRAIN VALLEY RE 1J,4333,IMAGINE CHARTER,1ST,1,3,2,7,67,80,13,16%
0470,ST VRAIN VALLEY RE 1J,4333,IMAGINE CHARTER,2ND,1,1,1,3,69,75,6,8%
0470,ST VRAIN VALLEY RE 1J,4333,IMAGINE CHARTER,3RD,0,0,2,6,44,52,8,15%
0470,ST VRAIN VALLEY RE 1J,4333,IMAGINE CHARTER,4TH,0,2,3,11,52,68,16,24%
0470,ST VRAIN VALLEY RE 1J,4333,IMAGINE CHARTER,5TH,0,1,0,8,44,53,9,17%
0470,ST VRAIN VALLEY RE 1J,4333,IMAGINE CHARTER,6TH,0,1,1,6,40,48,8,17%
0470,ST VRAIN VALLEY RE 1J,4333,IMAGINE CHARTER,7TH,1,2,1,9,33,46,13,28%
0470,ST VRAIN VALLEY RE 1J,4333,IMAGINE CHARTER,8TH,0,0,0,4,23,27,4,15%
0470,ST VRAIN VALLEY RE 1J,4333,IMAGINE CHARTER,SCHOOL TOTAL,3,13,13,61,457,547,90,16%
0470,ST VRAIN VALLEY RE 1J,5246,LOMA LINDA ELEMENTARY SCHOOL,PK,0,0,0,20,11,31,20,65%
0470,ST VRAIN VALLEY RE 1J,5246,LOMA LINDA ELEMENTARY SCHOOL,KINDERGARTEN,1,2,0,54,22,79,57,72%
0470,ST VRAIN VALLEY RE 1J,5246,LOMA LINDA ELEMENTARY SCHOOL,1ST,0,0,1,48,25,74,49,66%
0470,ST VRAIN VALLEY RE 1J,5246,LOMA LINDA ELEMENTARY SCHOOL,2ND,0,0,1,49,24,74,50,68%
0470,ST VRAIN VALLEY RE 1J,5246,LOMA LINDA ELEMENTARY SCHOOL,3RD,0,0,1,40,15,56,41,73%
0470,ST VRAIN VALLEY RE 1J,5246,LOMA LINDA ELEMENTARY SCHOOL,4TH,0,2,0,48,15,65,50,77%
0470,ST VRAIN VALLEY RE 1J,5246,LOMA LINDA ELEMENTARY SCHOOL,5TH,0,0,3,36,25,64,39,61%
0470,ST VRAIN VALLEY RE 1J,5246,LOMA LINDA ELEMENTARY SCHOOL,SCHOOL TOTAL,1,4,6,295,137,443,306,69%
0470,ST VRAIN VALLEY RE 1J,5282,LONGMONT HIGH SCHOOL,9TH,1,2,6,95,214,318,104,33%
0470,ST VRAIN VALLEY RE 1J,5282,LONGMONT HIGH SCHOOL,10TH,3,7,3,89,207,309,102,33%
0470,ST VRAIN VALLEY RE 1J,5282,LONGMONT HIGH SCHOOL,11TH,1,6,4,86,192,289,97,34%
0470,ST VRAIN VALLEY RE 1J,5282,LONGMONT HIGH SCHOOL,12TH,4,4,4,68,213,293,80,27%
0470,ST VRAIN VALLEY RE 1J,5282,LONGMONT HIGH SCHOOL,SCHOOL TOTAL,9,19,17,338,826,1209,383,32%
0470,ST VRAIN VALLEY RE 1J,5284,LONGMONT ESTATES ELEMENTARY SCHOOL,PK,0,6,1,7,46,60,14,23%
0470,ST VRAIN VALLEY RE 1J,5284,LONGMONT ESTATES ELEMENTARY SCHOOL,HALF DAY K,0,0,2,2,18,22,4,18%
0470,ST VRAIN VALLEY RE 1J,5284,LONGMONT ESTATES ELEMENTARY SCHOOL,KINDERGARTEN,0,3,3,8,34,48,14,29%
0470,ST VRAIN VALLEY RE 1J,5284,LONGMONT ESTATES ELEMENTARY SCHOOL,1ST,2,2,3,6,47,60,13,22%
0470,ST VRAIN VALLEY RE 1J,5284,LONGMONT ESTATES ELEMENTARY SCHOOL,2ND,0,5,3,12,57,77,20,26%
0470,ST VRAIN VALLEY RE 1J,5284,LONGMONT ESTATES ELEMENTARY SCHOOL,3RD,0,4,0,11,61,76,15,20%
0470,ST VRAIN VALLEY RE 1J,5284,LONGMONT ESTATES ELEMENTARY SCHOOL,4TH,0,7,2,11,54,74,20,27%
0470,ST VRAIN VALLEY RE 1J,5284,LONGMONT ESTATES ELEMENTARY SCHOOL,5TH,0,4,3,12,52,71,19,27%
0470,ST VRAIN VALLEY RE 1J,5284,LONGMONT ESTATES ELEMENTARY SCHOOL,SCHOOL TOTAL,2,31,17,69,369,488,119,24%
0470,ST VRAIN VALLEY RE 1J,5286,SUNSET MIDDLE SCHOOL,6TH,1,7,3,63,110,184,74,40%
0470,ST VRAIN VALLEY RE 1J,5286,SUNSET MIDDLE SCHOOL,7TH,1,4,2,58,141,206,65,32%
0470,ST VRAIN VALLEY RE 1J,5286,SUNSET MIDDLE SCHOOL,8TH,0,4,2,58,156,220,64,29%
0470,ST VRAIN VALLEY RE 1J,5286,SUNSET MIDDLE SCHOOL,SCHOOL TOTAL,2,15,7,179,407,610,203,33%
0470,ST VRAIN VALLEY RE 1J,5288,LONGS PEAK MIDDLE SCHOOL,6TH,2,2,4,76,58,142,84,59%
0470,ST VRAIN VALLEY RE 1J,5288,LONGS PEAK MIDDLE SCHOOL,7TH,1,4,0,79,81,165,84,51%
0470,ST VRAIN VALLEY RE 1J,5288,LONGS PEAK MIDDLE SCHOOL,8TH,6,4,2,81,67,160,93,58%
0470,ST VRAIN VALLEY RE 1J,5288,LONGS PEAK MIDDLE SCHOOL,SCHOOL TOTAL,9,10,6,236,206,467,261,56%
0470,ST VRAIN VALLEY RE 1J,5364,LYONS ELEMENTARY SCHOOL,PK,0,2,0,2,28,32,4,13%
0470,ST VRAIN VALLEY RE 1J,5364,LYONS ELEMENTARY SCHOOL,HALF DAY K,0,3,0,5,28,36,8,22%
0470,ST VRAIN VALLEY RE 1J,5364,LYONS ELEMENTARY SCHOOL,1ST,0,1,1,3,40,45,5,11%
0470,ST VRAIN VALLEY RE 1J,5364,LYONS ELEMENTARY SCHOOL,2ND,0,3,0,6,32,41,9,22%
0470,ST VRAIN VALLEY RE 1J,5364,LYONS ELEMENTARY SCHOOL,3RD,1,0,0,2,34,37,3,8%
0470,ST VRAIN VALLEY RE 1J,5364,LYONS ELEMENTARY SCHOOL,4TH,0,3,0,4,37,44,7,16%
0470,ST VRAIN VALLEY RE 1J,5364,LYONS ELEMENTARY SCHOOL,5TH,0,0,0,2,32,34,2,6%
0470,ST VRAIN VALLEY RE 1J,5364,LYONS ELEMENTARY SCHOOL,SCHOOL TOTAL,1,12,1,24,231,269,38,14%
0470,ST VRAIN VALLEY RE 1J,5368,LYONS MIDDLE/SENIOR HIGH SCHOOL,6TH,1,1,0,6,54,62,8,13%
0470,ST VRAIN VALLEY RE 1J,5368,LYONS MIDDLE/SENIOR HIGH SCHOOL,7TH,0,2,0,5,59,66,7,11%
0470,ST VRAIN VALLEY RE 1J,5368,LYONS MIDDLE/SENIOR HIGH SCHOOL,8TH,0,2,0,3,57,62,5,8%
0470,ST VRAIN VALLEY RE 1J,5368,LYONS MIDDLE/SENIOR HIGH SCHOOL,9TH,0,0,0,1,66,67,1,1%
0470,ST VRAIN VALLEY RE 1J,5368,LYONS MIDDLE/SENIOR HIGH SCHOOL,10TH,1,0,1,5,45,52,7,13%
0470,ST VRAIN VALLEY RE 1J,5368,LYONS MIDDLE/SENIOR HIGH SCHOOL,11TH,1,2,0,4,70,77,7,9%
0470,ST VRAIN VALLEY RE 1J,5368,LYONS MIDDLE/SENIOR HIGH SCHOOL,12TH,0,0,1,4,50,55,5,9%
0470,ST VRAIN VALLEY RE 1J,5368,LYONS MIDDLE/SENIOR HIGH SCHOOL,SCHOOL TOTAL,3,7,2,28,401,441,40,9%
0470,ST VRAIN VALLEY RE 1J,5722,MEAD HIGH SCHOOL,9TH,0,4,0,40,161,205,44,21%
0470,ST VRAIN VALLEY RE 1J,5722,MEAD HIGH SCHOOL,10TH,0,4,2,20,99,125,26,21%
0470,ST VRAIN VALLEY RE 1J,5722,MEAD HIGH SCHOOL,SCHOOL TOTAL,0,8,2,60,260,330,70,21%
0470,ST VRAIN VALLEY RE 1J,5726,MEAD ELEMENTARY SCHOOL,PK,0,0,0,1,39,40,1,3%
0470,ST VRAIN VALLEY RE 1J,5726,MEAD ELEMENTARY SCHOOL,HALF DAY K,0,0,0,6,27,33,6,18%
0470,ST VRAIN VALLEY RE 1J,5726,MEAD ELEMENTARY SCHOOL,KINDERGARTEN,0,0,0,4,42,46,4,9%
0470,ST VRAIN VALLEY RE 1J,5726,MEAD ELEMENTARY SCHOOL,1ST,0,1,1,9,73,84,11,13%
0470,ST VRAIN VALLEY RE 1J,5726,MEAD ELEMENTARY SCHOOL,2ND,2,1,0,7,48,58,10,17%
0470,ST VRAIN VALLEY RE 1J,5726,MEAD ELEMENTARY SCHOOL,3RD,0,5,1,9,65,80,15,19%
0470,ST VRAIN VALLEY RE 1J,5726,MEAD ELEMENTARY SCHOOL,4TH,0,2,0,11,71,84,13,15%
0470,ST VRAIN VALLEY RE 1J,5726,MEAD ELEMENTARY SCHOOL,5TH,0,1,0,13,81,95,14,15%
0470,ST VRAIN VALLEY RE 1J,5726,MEAD ELEMENTARY SCHOOL,SCHOOL TOTAL,2,10,2,60,446,520,74,14%
0470,ST VRAIN VALLEY RE 1J,5730,MEAD MIDDLE SCHOOL,6TH,1,4,2,13,105,125,20,16%
0470,ST VRAIN VALLEY RE 1J,5730,MEAD MIDDLE SCHOOL,7TH,0,2,1,13,114,130,16,12%
0470,ST VRAIN VALLEY RE 1J,5730,MEAD MIDDLE SCHOOL,8TH,0,4,1,14,99,118,19,16%
0470,ST VRAIN VALLEY RE 1J,5730,MEAD MIDDLE SCHOOL,SCHOOL TOTAL,1,10,4,40,318,373,55,15%
0470,ST VRAIN VALLEY RE 1J,6156,MOUNTAIN VIEW ELEMENTARY SCHOOL,PK,0,2,1,26,20,49,29,59%
0470,ST VRAIN VALLEY RE 1J,6156,MOUNTAIN VIEW ELEMENTARY SCHOOL,KINDERGARTEN,2,0,2,18,34,56,22,39%
0470,ST VRAIN VALLEY RE 1J,6156,MOUNTAIN VIEW ELEMENTARY SCHOOL,1ST,2,0,3,30,25,60,35,58%
0470,ST VRAIN VALLEY RE 1J,6156,MOUNTAIN VIEW ELEMENTARY SCHOOL,2ND,1,1,1,29,25,57,32,56%
0470,ST VRAIN VALLEY RE 1J,6156,MOUNTAIN VIEW ELEMENTARY SCHOOL,3RD,1,2,1,24,27,55,28,51%
0470,ST VRAIN VALLEY RE 1J,6156,MOUNTAIN VIEW ELEMENTARY SCHOOL,4TH,1,1,0,27,18,47,29,62%
0470,ST VRAIN VALLEY RE 1J,6156,MOUNTAIN VIEW ELEMENTARY SCHOOL,5TH,1,3,2,19,19,44,25,57%
0470,ST VRAIN VALLEY RE 1J,6156,MOUNTAIN VIEW ELEMENTARY SCHOOL,SCHOOL TOTAL,8,9,10,173,168,368,200,54%
0470,ST VRAIN VALLEY RE 1J,6274,NIWOT ELEMENTARY SCHOOL,PK,0,1,0,5,40,46,6,13%
0470,ST VRAIN VALLEY RE 1J,6274,NIWOT ELEMENTARY SCHOOL,KINDERGARTEN,0,3,1,2,66,72,6,8%
0470,ST VRAIN VALLEY RE 1J,6274,NIWOT ELEMENTARY SCHOOL,1ST,0,5,1,4,70,80,10,13%
0470,ST VRAIN VALLEY RE 1J,6274,NIWOT ELEMENTARY SCHOOL,2ND,0,5,1,1,72,79,7,9%
0470,ST VRAIN VALLEY RE 1J,6274,NIWOT ELEMENTARY SCHOOL,3RD,0,7,1,5,65,78,13,17%
0470,ST VRAIN VALLEY RE 1J,6274,NIWOT ELEMENTARY SCHOOL,4TH,1,6,2,5,57,71,14,20%
0470,ST VRAIN VALLEY RE 1J,6274,NIWOT ELEMENTARY SCHOOL,5TH,0,3,1,3,71,78,7,9%
0470,ST VRAIN VALLEY RE 1J,6274,NIWOT ELEMENTARY SCHOOL,SCHOOL TOTAL,1,30,7,25,441,504,63,13%
0470,ST VRAIN VALLEY RE 1J,6276,NIWOT HIGH SCHOOL,9TH,1,32,6,48,218,305,87,29%
0470,ST VRAIN VALLEY RE 1J,6276,NIWOT HIGH SCHOOL,10TH,3,16,1,46,258,324,66,20%
0470,ST VRAIN VALLEY RE 1J,6276,NIWOT HIGH SCHOOL,11TH,1,18,5,65,247,336,89,26%
0470,ST VRAIN VALLEY RE 1J,6276,NIWOT HIGH SCHOOL,12TH,2,20,1,47,274,344,70,20%
0470,ST VRAIN VALLEY RE 1J,6276,NIWOT HIGH SCHOOL,SCHOOL TOTAL,7,86,13,206,997,1309,312,24%
0470,ST VRAIN VALLEY RE 1J,6344,HERITAGE MIDDLE SCHOOL,6TH,2,3,1,87,39,132,93,70%
0470,ST VRAIN VALLEY RE 1J,6344,HERITAGE MIDDLE SCHOOL,7TH,0,1,3,113,36,153,117,76%
0470,ST VRAIN VALLEY RE 1J,6344,HERITAGE MIDDLE SCHOOL,8TH,3,2,1,112,20,138,118,86%
0470,ST VRAIN VALLEY RE 1J,6344,HERITAGE MIDDLE SCHOOL,SCHOOL TOTAL,5,6,5,312,95,423,328,78%
0470,ST VRAIN VALLEY RE 1J,6404,NORTHRIDGE ELEMENTARY SCHOOL,PK,0,0,1,21,2,24,22,92%
0470,ST VRAIN VALLEY RE 1J,6404,NORTHRIDGE ELEMENTARY SCHOOL,KINDERGARTEN,1,0,0,57,20,78,58,74%
0470,ST VRAIN VALLEY RE 1J,6404,NORTHRIDGE ELEMENTARY SCHOOL,1ST,0,0,1,50,20,71,51,72%
0470,ST VRAIN VALLEY RE 1J,6404,NORTHRIDGE ELEMENTARY SCHOOL,2ND,0,0,0,49,12,61,49,80%
0470,ST VRAIN VALLEY RE 1J,6404,NORTHRIDGE ELEMENTARY SCHOOL,3RD,1,0,2,57,13,73,60,82%
0470,ST VRAIN VALLEY RE 1J,6404,NORTHRIDGE ELEMENTARY SCHOOL,4TH,0,1,0,34,13,48,35,73%
0470,ST VRAIN VALLEY RE 1J,6404,NORTHRIDGE ELEMENTARY SCHOOL,5TH,0,0,1,38,19,58,39,67%
0470,ST VRAIN VALLEY RE 1J,6404,NORTHRIDGE ELEMENTARY SCHOOL,SCHOOL TOTAL,2,1,5,306,99,413,314,76%
0470,ST VRAIN VALLEY RE 1J,6498,OLDE COLUMBINE HIGH SCHOOL,9TH,0,0,1,0,2,3,1,33%
0470,ST VRAIN VALLEY RE 1J,6498,OLDE COLUMBINE HIGH SCHOOL,10TH,1,0,1,8,6,16,10,63%
0470,ST VRAIN VALLEY RE 1J,6498,OLDE COLUMBINE HIGH SCHOOL,11TH,0,0,0,3,17,20,3,15%
0470,ST VRAIN VALLEY RE 1J,6498,OLDE COLUMBINE HIGH SCHOOL,12TH,2,0,0,22,42,66,24,36%
0470,ST VRAIN VALLEY RE 1J,6498,OLDE COLUMBINE HIGH SCHOOL,SCHOOL TOTAL,3,0,2,33,67,105,38,36%
0470,ST VRAIN VALLEY RE 1J,6499,ADULT EDUCATION/LINCOLN CENTER,11TH,0,0,0,1,0,1,1,100%
0470,ST VRAIN VALLEY RE 1J,6499,ADULT EDUCATION/LINCOLN CENTER,12TH,3,5,3,103,86,200,114,57%
0470,ST VRAIN VALLEY RE 1J,6499,ADULT EDUCATION/LINCOLN CENTER,SCHOOL TOTAL,3,5,3,104,86,201,115,57%
0470,ST VRAIN VALLEY RE 1J,7157,PRAIRIE RIDGE ELEMENTARY SCHOOL,PK,0,0,0,9,35,44,9,20%
0470,ST VRAIN VALLEY RE 1J,7157,PRAIRIE RIDGE ELEMENTARY SCHOOL,HALF DAY K,0,1,0,9,36,46,10,22%
0470,ST VRAIN VALLEY RE 1J,7157,PRAIRIE RIDGE ELEMENTARY SCHOOL,KINDERGARTEN,0,0,1,0,24,25,1,4%
0470,ST VRAIN VALLEY RE 1J,7157,PRAIRIE RIDGE ELEMENTARY SCHOOL,1ST,0,0,0,6,40,46,6,13%
0470,ST VRAIN VALLEY RE 1J,7157,PRAIRIE RIDGE ELEMENTARY SCHOOL,2ND,0,3,0,13,56,72,16,22%
0470,ST VRAIN VALLEY RE 1J,7157,PRAIRIE RIDGE ELEMENTARY SCHOOL,3RD,0,2,1,7,45,55,10,18%
0470,ST VRAIN VALLEY RE 1J,7157,PRAIRIE RIDGE ELEMENTARY SCHOOL,4TH,0,0,1,7,39,47,8,17%
0470,ST VRAIN VALLEY RE 1J,7157,PRAIRIE RIDGE ELEMENTARY SCHOOL,5TH,0,3,0,4,37,44,7,16%
0470,ST VRAIN VALLEY RE 1J,7157,PRAIRIE RIDGE ELEMENTARY SCHOOL,SCHOOL TOTAL,0,9,3,55,312,379,67,18%
0470,ST VRAIN VALLEY RE 1J,7464,ROCKY MOUNTAIN ELEMENTARY SCHOOL,PK,0,0,0,30,10,40,30,75%
0470,ST VRAIN VALLEY RE 1J,7464,ROCKY MOUNTAIN ELEMENTARY SCHOOL,KINDERGARTEN,0,0,1,70,7,78,71,91%
0470,ST VRAIN VALLEY RE 1J,7464,ROCKY MOUNTAIN ELEMENTARY SCHOOL,1ST,0,0,0,56,6,62,56,90%
0470,ST VRAIN VALLEY RE 1J,7464,ROCKY MOUNTAIN ELEMENTARY SCHOOL,2ND,1,1,0,58,5,65,60,92%
0470,ST VRAIN VALLEY RE 1J,7464,ROCKY MOUNTAIN ELEMENTARY SCHOOL,3RD,1,0,0,52,6,59,53,90%
0470,ST VRAIN VALLEY RE 1J,7464,ROCKY MOUNTAIN ELEMENTARY SCHOOL,4TH,1,0,1,53,7,62,55,89%
0470,ST VRAIN VALLEY RE 1J,7464,ROCKY MOUNTAIN ELEMENTARY SCHOOL,5TH,0,0,0,47,10,57,47,82%
0470,ST VRAIN VALLEY RE 1J,7464,ROCKY MOUNTAIN ELEMENTARY SCHOOL,SCHOOL TOTAL,3,1,2,366,51,423,372,88%
0470,ST VRAIN VALLEY RE 1J,7565,ST. VRAIN COMMUNITY MONTOSSORI SCHOOL,PK,0,1,0,2,19,22,3,14%
0470,ST VRAIN VALLEY RE 1J,7565,ST. VRAIN COMMUNITY MONTOSSORI SCHOOL,HALF DAY K,1,1,0,3,11,16,5,31%
0470,ST VRAIN VALLEY RE 1J,7565,ST. VRAIN COMMUNITY MONTOSSORI SCHOOL,KINDERGARTEN,0,1,2,2,15,20,5,25%
0470,ST VRAIN VALLEY RE 1J,7565,ST. VRAIN COMMUNITY MONTOSSORI SCHOOL,1ST,1,2,0,6,19,28,9,32%
0470,ST VRAIN VALLEY RE 1J,7565,ST. VRAIN COMMUNITY MONTOSSORI SCHOOL,2ND,0,2,0,0,21,23,2,9%
0470,ST VRAIN VALLEY RE 1J,7565,ST. VRAIN COMMUNITY MONTOSSORI SCHOOL,SCHOOL TOTAL,2,7,2,13,85,109,24,22%
0470,ST VRAIN VALLEY RE 1J,7584,SANBORN ELEMENTARY SCHOOL,PK,1,0,0,8,25,34,9,26%
0470,ST VRAIN VALLEY RE 1J,7584,SANBORN ELEMENTARY SCHOOL,HALF DAY K,2,1,0,15,27,45,18,40%
0470,ST VRAIN VALLEY RE 1J,7584,SANBORN ELEMENTARY SCHOOL,KINDERGARTEN,1,1,0,4,18,24,6,25%
0470,ST VRAIN VALLEY RE 1J,7584,SANBORN ELEMENTARY SCHOOL,1ST,0,3,1,12,35,51,16,31%
0470,ST VRAIN VALLEY RE 1J,7584,SANBORN ELEMENTARY SCHOOL,2ND,0,3,0,18,49,70,21,30%
0470,ST VRAIN VALLEY RE 1J,7584,SANBORN ELEMENTARY SCHOOL,3RD,2,3,2,10,50,67,17,25%
0470,ST VRAIN VALLEY RE 1J,7584,SANBORN ELEMENTARY SCHOOL,4TH,1,1,0,12,53,67,14,21%
0470,ST VRAIN VALLEY RE 1J,7584,SANBORN ELEMENTARY SCHOOL,5TH,3,1,0,15,53,72,19,26%
0470,ST VRAIN VALLEY RE 1J,7584,SANBORN ELEMENTARY SCHOOL,SCHOOL TOTAL,10,13,3,94,310,430,120,28%
0470,ST VRAIN VALLEY RE 1J,7789,SILVER CREEK HIGH SCHOOL,9TH,3,10,8,31,182,234,52,22%
0470,ST VRAIN VALLEY RE 1J,7789,SILVER CREEK HIGH SCHOOL,10TH,2,9,6,42,217,276,59,21%
0470,ST VRAIN VALLEY RE 1J,7789,SILVER CREEK HIGH SCHOOL,11TH,2,9,2,33,256,302,46,15%
0470,ST VRAIN VALLEY RE 1J,7789,SILVER CREEK HIGH SCHOOL,12TH,2,8,3,27,225,265,40,15%
0470,ST VRAIN VALLEY RE 1J,7789,SILVER CREEK HIGH SCHOOL,SCHOOL TOTAL,9,36,19,133,880,1077,197,18%
0470,ST VRAIN VALLEY RE 1J,7954,SKYLINE HIGH SCHOOL,9TH,2,15,5,141,136,299,163,55%
0470,ST VRAIN VALLEY RE 1J,7954,SKYLINE HIGH SCHOOL,10TH,3,12,6,160,102,283,181,64%
0470,ST VRAIN VALLEY RE 1J,7954,SKYLINE HIGH SCHOOL,11TH,3,10,4,149,208,374,166,44%
0470,ST VRAIN VALLEY RE 1J,7954,SKYLINE HIGH SCHOOL,12TH,4,8,5,112,166,295,129,44%
0470,ST VRAIN VALLEY RE 1J,7954,SKYLINE HIGH SCHOOL,SCHOOL TOTAL,12,45,20,562,612,1251,639,51%
0470,ST VRAIN VALLEY RE 1J,8140,SPANGLER ELEMENTARY SCHOOL,PK,0,0,0,28,0,28,28,100%
0470,ST VRAIN VALLEY RE 1J,8140,SPANGLER ELEMENTARY SCHOOL,KINDERGARTEN,0,1,0,67,6,74,68,92%
0470,ST VRAIN VALLEY RE 1J,8140,SPANGLER ELEMENTARY SCHOOL,1ST,1,0,1,59,8,69,61,88%
0470,ST VRAIN VALLEY RE 1J,8140,SPANGLER ELEMENTARY SCHOOL,2ND,1,0,0,54,13,68,55,81%
0470,ST VRAIN VALLEY RE 1J,8140,SPANGLER ELEMENTARY SCHOOL,3RD,3,1,1,43,11,59,48,81%
0470,ST VRAIN VALLEY RE 1J,8140,SPANGLER ELEMENTARY SCHOOL,4TH,0,0,0,44,11,55,44,80%
0470,ST VRAIN VALLEY RE 1J,8140,SPANGLER ELEMENTARY SCHOOL,5TH,2,0,0,53,6,61,55,90%
0470,ST VRAIN VALLEY RE 1J,8140,SPANGLER ELEMENTARY SCHOOL,SCHOOL TOTAL,7,2,2,348,55,414,359,87%
0470,ST VRAIN VALLEY RE 1J,8903,TRAIL RIDGE MIDDLE SCHOOL,6TH,3,10,3,97,103,216,113,52%
0470,ST VRAIN VALLEY RE 1J,8903,TRAIL RIDGE MIDDLE SCHOOL,7TH,4,11,2,112,105,234,129,55%
0470,ST VRAIN VALLEY RE 1J,8903,TRAIL RIDGE MIDDLE SCHOOL,8TH,2,9,3,77,123,214,91,43%
0470,ST VRAIN VALLEY RE 1J,8903,TRAIL RIDGE MIDDLE SCHOOL,SCHOOL TOTAL,9,30,8,286,331,664,333,50%
0470,ST VRAIN VALLEY RE 1J,8927,TWIN PEAKS CHARTER ACADEMY,HALF DAY K,0,6,1,4,29,40,11,28%
0470,ST VRAIN VALLEY RE 1J,8927,TWIN PEAKS CHARTER ACADEMY,KINDERGARTEN,0,6,0,2,18,26,8,31%
0470,ST VRAIN VALLEY RE 1J,8927,TWIN PEAKS CHARTER ACADEMY,1ST,0,23,0,11,41,75,34,45%
0470,ST VRAIN VALLEY RE 1J,8927,TWIN PEAKS CHARTER ACADEMY,2ND,1,14,1,12,50,78,28,36%
0470,ST VRAIN VALLEY RE 1J,8927,TWIN PEAKS CHARTER ACADEMY,3RD,2,17,2,11,46,78,32,41%
0470,ST VRAIN VALLEY RE 1J,8927,TWIN PEAKS CHARTER ACADEMY,4TH,3,21,2,12,40,78,38,49%
0470,ST VRAIN VALLEY RE 1J,8927,TWIN PEAKS CHARTER ACADEMY,5TH,0,8,1,16,51,76,25,33%
0470,ST VRAIN VALLEY RE 1J,8927,TWIN PEAKS CHARTER ACADEMY,6TH,0,10,1,17,39,67,28,42%
0470,ST VRAIN VALLEY RE 1J,8927,TWIN PEAKS CHARTER ACADEMY,7TH,0,6,1,7,45,59,14,24%
0470,ST VRAIN VALLEY RE 1J,8927,TWIN PEAKS CHARTER ACADEMY,8TH,0,10,0,6,38,54,16,30%
0470,ST VRAIN VALLEY RE 1J,8927,TWIN PEAKS CHARTER ACADEMY,SCHOOL TOTAL,6,121,9,98,397,631,234,37%
0470,ST VRAIN VALLEY RE 1J,9430,WESTVIEW MIDDLE SCHOOL,6TH,1,11,1,26,174,213,39,18%
0470,ST VRAIN VALLEY RE 1J,9430,WESTVIEW MIDDLE SCHOOL,7TH,3,4,2,39,148,196,48,24%
0470,ST VRAIN VALLEY RE 1J,9430,WESTVIEW MIDDLE SCHOOL,8TH,1,6,0,20,190,217,27,12%
0470,ST VRAIN VALLEY RE 1J,9430,WESTVIEW MIDDLE SCHOOL,SCHOOL TOTAL,5,21,3,85,512,626,114,18%
0470,ST VRAIN VALLEY RE 1J,,DISTRICT TOTAL,,213,1039,333,7301,17838,26724,8886,33%
0480,BOULDER VALLEY RE 2,0000,NOT IN A SCHOOL,PK,0,4,2,13,54,73,19,26%
0480,BOULDER VALLEY RE 2,0000,NOT IN A SCHOOL,SCHOOL TOTAL,0,4,2,13,54,73,19,26%
0480,BOULDER VALLEY RE 2,0125,ARAPAHOE RIDGE HIGH SCHOOL,9TH,0,1,0,1,1,3,2,67%
0480,BOULDER VALLEY RE 2,0125,ARAPAHOE RIDGE HIGH SCHOOL,10TH,0,1,0,10,6,17,11,65%
0480,BOULDER VALLEY RE 2,0125,ARAPAHOE RIDGE HIGH SCHOOL,11TH,1,1,0,29,23,54,31,57%
0480,BOULDER VALLEY RE 2,0125,ARAPAHOE RIDGE HIGH SCHOOL,12TH,1,3,0,52,46,102,56,55%
0480,BOULDER VALLEY RE 2,0125,ARAPAHOE RIDGE HIGH SCHOOL,SCHOOL TOTAL,2,6,0,92,76,176,100,57%
0480,BOULDER VALLEY RE 2,0441,ASPEN CREEK K-8 SCHOOL,HALF DAY K,1,3,1,8,64,77,13,17%
0480,BOULDER VALLEY RE 2,0441,ASPEN CREEK K-8 SCHOOL,1ST,0,5,1,7,69,82,13,16%
0480,BOULDER VALLEY RE 2,0441,ASPEN CREEK K-8 SCHOOL,2ND,2,7,1,5,73,88,15,17%
0480,BOULDER VALLEY RE 2,0441,ASPEN CREEK K-8 SCHOOL,3RD,0,2,0,6,66,74,8,11%
0480,BOULDER VALLEY RE 2,0441,ASPEN CREEK K-8 SCHOOL,4TH,0,11,1,2,73,87,14,16%
0480,BOULDER VALLEY RE 2,0441,ASPEN CREEK K-8 SCHOOL,5TH,0,4,0,5,75,84,9,11%
0480,BOULDER VALLEY RE 2,0441,ASPEN CREEK K-8 SCHOOL,6TH,1,7,3,12,123,146,23,16%
0480,BOULDER VALLEY RE 2,0441,ASPEN CREEK K-8 SCHOOL,7TH,0,7,2,8,127,144,17,12%
0480,BOULDER VALLEY RE 2,0441,ASPEN CREEK K-8 SCHOOL,8TH,0,7,2,13,115,137,22,16%
0480,BOULDER VALLEY RE 2,0441,ASPEN CREEK K-8 SCHOOL,SCHOOL TOTAL,4,53,11,66,785,919,134,15%
0480,BOULDER VALLEY RE 2,0652,BEAR CREEK ELEMENTARY SCHOOL,HALF DAY K,0,8,1,2,33,44,11,25%
0480,BOULDER VALLEY RE 2,0652,BEAR CREEK ELEMENTARY SCHOOL,1ST,0,2,1,2,54,59,5,8%
0480,BOULDER VALLEY RE 2,0652,BEAR CREEK ELEMENTARY SCHOOL,2ND,1,7,0,2,43,53,10,19%
0480,BOULDER VALLEY RE 2,0652,BEAR CREEK ELEMENTARY SCHOOL,3RD,1,10,3,4,53,71,18,25%
0480,BOULDER VALLEY RE 2,0652,BEAR CREEK ELEMENTARY SCHOOL,4TH,0,9,0,3,61,73,12,16%
0480,BOULDER VALLEY RE 2,0652,BEAR CREEK ELEMENTARY SCHOOL,5TH,1,10,0,2,39,52,13,25%
0480,BOULDER VALLEY RE 2,0652,BEAR CREEK ELEMENTARY SCHOOL,SCHOOL TOTAL,3,46,5,15,283,352,69,20%
0480,BOULDER VALLEY RE 2,0872,BIRCH ELEMENTARY SCHOOL,PK,0,1,1,16,9,27,18,67%
0480,BOULDER VALLEY RE 2,0872,BIRCH ELEMENTARY SCHOOL,HALF DAY K,3,0,1,9,43,56,13,23%
0480,BOULDER VALLEY RE 2,0872,BIRCH ELEMENTARY SCHOOL,1ST,2,5,1,11,48,67,19,28%
0480,BOULDER VALLEY RE 2,0872,BIRCH ELEMENTARY SCHOOL,2ND,0,4,1,11,57,73,16,22%
0480,BOULDER VALLEY RE 2,0872,BIRCH ELEMENTARY SCHOOL,3RD,0,3,1,20,45,69,24,35%
0480,BOULDER VALLEY RE 2,0872,BIRCH ELEMENTARY SCHOOL,4TH,0,1,2,11,59,73,14,19%
0480,BOULDER VALLEY RE 2,0872,BIRCH ELEMENTARY SCHOOL,5TH,0,5,2,7,51,65,14,22%
0480,BOULDER VALLEY RE 2,0872,BIRCH ELEMENTARY SCHOOL,SCHOOL TOTAL,5,19,9,85,312,430,118,27%
0480,BOULDER VALLEY RE 2,0919,BOULDER COMMUNITY SCHOOL/INTEGRATED STUDIES,HALF DAY K,0,3,1,0,42,46,4,9%
0480,BOULDER VALLEY RE 2,0919,BOULDER COMMUNITY SCHOOL/INTEGRATED STUDIES,1ST,0,0,1,3,43,47,4,9%
0480,BOULDER VALLEY RE 2,0919,BOULDER COMMUNITY SCHOOL/INTEGRATED STUDIES,2ND,0,3,1,3,43,50,7,14%
0480,BOULDER VALLEY RE 2,0919,BOULDER COMMUNITY SCHOOL/INTEGRATED STUDIES,3RD,0,2,3,1,42,48,6,13%
0480,BOULDER VALLEY RE 2,0919,BOULDER COMMUNITY SCHOOL/INTEGRATED STUDIES,4TH,0,2,2,1,44,49,5,10%
0480,BOULDER VALLEY RE 2,0919,BOULDER COMMUNITY SCHOOL/INTEGRATED STUDIES,5TH,0,0,1,2,41,44,3,7%
0480,BOULDER VALLEY RE 2,0919,BOULDER COMMUNITY SCHOOL/INTEGRATED STUDIES,SCHOOL TOTAL,0,10,9,10,255,284,29,10%
0480,BOULDER VALLEY RE 2,0924,BOULDER HIGH SCHOOL,9TH,4,30,8,81,333,456,123,27%
0480,BOULDER VALLEY RE 2,0924,BOULDER HIGH SCHOOL,10TH,2,22,11,70,340,445,105,24%
0480,BOULDER VALLEY RE 2,0924,BOULDER HIGH SCHOOL,11TH,0,20,10,65,332,427,95,22%
0480,BOULDER VALLEY RE 2,0924,BOULDER HIGH SCHOOL,12TH,2,23,7,70,354,456,102,22%
0480,BOULDER VALLEY RE 2,0924,BOULDER HIGH SCHOOL,SCHOOL TOTAL,8,95,36,286,1359,1784,425,24%
0480,BOULDER VALLEY RE 2,0934,BOULDER PREP CHARTER HIGH SCHOOL,9TH,0,0,0,2,0,2,2,100%
0480,BOULDER VALLEY RE 2,0934,BOULDER PREP CHARTER HIGH SCHOOL,10TH,7,1,0,10,10,28,18,64%
0480,BOULDER VALLEY RE 2,0934,BOULDER PREP CHARTER HIGH SCHOOL,11TH,6,1,1,22,26,56,30,54%
0480,BOULDER VALLEY RE 2,0934,BOULDER PREP CHARTER HIGH SCHOOL,12TH,10,3,3,27,29,72,43,60%
0480,BOULDER VALLEY RE 2,0934,BOULDER PREP CHARTER HIGH SCHOOL,SCHOOL TOTAL,23,5,4,61,65,158,93,59%
0480,BOULDER VALLEY RE 2,1066,BROOMFIELD HEIGHTS MIDDLE SCHOOL,6TH,2,13,5,28,121,169,48,28%
0480,BOULDER VALLEY RE 2,1066,BROOMFIELD HEIGHTS MIDDLE SCHOOL,7TH,1,11,4,27,130,173,43,25%
0480,BOULDER VALLEY RE 2,1066,BROOMFIELD HEIGHTS MIDDLE SCHOOL,8TH,0,11,0,26,151,188,37,20%
0480,BOULDER VALLEY RE 2,1066,BROOMFIELD HEIGHTS MIDDLE SCHOOL,SCHOOL TOTAL,3,35,9,81,402,530,128,24%
0480,BOULDER VALLEY RE 2,1070,BROOMFIELD HIGH SCHOOL,9TH,4,23,3,45,284,359,75,21%
0480,BOULDER VALLEY RE 2,1070,BROOMFIELD HIGH SCHOOL,10TH,6,11,3,39,275,334,59,18%
0480,BOULDER VALLEY RE 2,1070,BROOMFIELD HIGH SCHOOL,11TH,3,19,10,34,279,345,66,19%
0480,BOULDER VALLEY RE 2,1070,BROOMFIELD HIGH SCHOOL,12TH,2,21,5,35,299,362,63,17%
0480,BOULDER VALLEY RE 2,1070,BROOMFIELD HIGH SCHOOL,SCHOOL TOTAL,15,74,21,153,1137,1400,263,19%
0480,BOULDER VALLEY RE 2,1136,MANHATTAN MIDDLE SCHOOL OF THE ARTS AND ACADEMICS,6TH,3,13,5,23,124,168,44,26%
0480,BOULDER VALLEY RE 2,1136,MANHATTAN MIDDLE SCHOOL OF THE ARTS AND ACADEMICS,7TH,2,11,0,29,137,179,42,23%
0480,BOULDER VALLEY RE 2,1136,MANHATTAN MIDDLE SCHOOL OF THE ARTS AND ACADEMICS,8TH,1,8,3,31,108,151,43,28%
0480,BOULDER VALLEY RE 2,1136,MANHATTAN MIDDLE SCHOOL OF THE ARTS AND ACADEMICS,SCHOOL TOTAL,6,32,8,83,369,498,129,26%
0480,BOULDER VALLEY RE 2,1352,CASEY MIDDLE SCHOOL,6TH,1,6,3,58,87,155,68,44%
0480,BOULDER VALLEY RE 2,1352,CASEY MIDDLE SCHOOL,7TH,0,6,0,41,30,77,47,61%
0480,BOULDER VALLEY RE 2,1352,CASEY MIDDLE SCHOOL,8TH,0,4,7,46,60,117,57,49%
0480,BOULDER VALLEY RE 2,1352,CASEY MIDDLE SCHOOL,SCHOOL TOTAL,1,16,10,145,177,349,172,49%
0480,BOULDER VALLEY RE 2,1380,CENTAURUS HIGH SCHOOL,9TH,2,15,8,65,167,257,90,35%
0480,BOULDER VALLEY RE 2,1380,CENTAURUS HIGH SCHOOL,10TH,4,10,6,88,172,280,108,39%
0480,BOULDER VALLEY RE 2,1380,CENTAURUS HIGH SCHOOL,11TH,4,9,6,73,153,245,92,38%
0480,BOULDER VALLEY RE 2,1380,CENTAURUS HIGH SCHOOL,12TH,2,1,2,85,204,294,90,31%
0480,BOULDER VALLEY RE 2,1380,CENTAURUS HIGH SCHOOL,SCHOOL TOTAL,12,35,22,311,696,1076,380,35%
0480,BOULDER VALLEY RE 2,1390,CENTENNIAL MIDDLE SCHOOL,6TH,2,8,5,50,146,211,65,31%
0480,BOULDER VALLEY RE 2,1390,CENTENNIAL MIDDLE SCHOOL,7TH,1,11,3,35,154,204,50,25%
0480,BOULDER VALLEY RE 2,1390,CENTENNIAL MIDDLE SCHOOL,8TH,1,16,2,37,156,212,56,26%
0480,BOULDER VALLEY RE 2,1390,CENTENNIAL MIDDLE SCHOOL,SCHOOL TOTAL,4,35,10,122,456,627,171,27%
0480,BOULDER VALLEY RE 2,1725,COAL CREEK ELEMENTARY SCHOOL,HALF DAY K,1,4,0,2,55,62,7,11%
0480,BOULDER VALLEY RE 2,1725,COAL CREEK ELEMENTARY SCHOOL,1ST,0,4,2,5,68,79,11,14%
0480,BOULDER VALLEY RE 2,1725,COAL CREEK ELEMENTARY SCHOOL,2ND,1,4,2,1,77,85,8,9%
0480,BOULDER VALLEY RE 2,1725,COAL CREEK ELEMENTARY SCHOOL,3RD,0,0,0,4,77,81,4,5%
0480,BOULDER VALLEY RE 2,1725,COAL CREEK ELEMENTARY SCHOOL,4TH,0,1,1,3,65,70,5,7%
0480,BOULDER VALLEY RE 2,1725,COAL CREEK ELEMENTARY SCHOOL,5TH,1,0,1,3,66,71,5,7%
0480,BOULDER VALLEY RE 2,1725,COAL CREEK ELEMENTARY SCHOOL,SCHOOL TOTAL,3,13,6,18,408,448,40,9%
0480,BOULDER VALLEY RE 2,1842,COLUMBINE ELEMENTARY SCHOOL,PK,1,0,0,31,13,45,32,71%
0480,BOULDER VALLEY RE 2,1842,COLUMBINE ELEMENTARY SCHOOL,KINDERGARTEN,0,4,0,40,12,56,44,79%
0480,BOULDER VALLEY RE 2,1842,COLUMBINE ELEMENTARY SCHOOL,1ST,0,5,0,47,10,62,52,84%
0480,BOULDER VALLEY RE 2,1842,COLUMBINE ELEMENTARY SCHOOL,2ND,1,2,0,49,9,61,52,85%
0480,BOULDER VALLEY RE 2,1842,COLUMBINE ELEMENTARY SCHOOL,3RD,0,3,0,50,6,59,53,90%
0480,BOULDER VALLEY RE 2,1842,COLUMBINE ELEMENTARY SCHOOL,4TH,0,1,3,57,6,67,61,91%
0480,BOULDER VALLEY RE 2,1842,COLUMBINE ELEMENTARY SCHOOL,5TH,1,1,0,42,10,54,44,81%
0480,BOULDER VALLEY RE 2,1842,COLUMBINE ELEMENTARY SCHOOL,SCHOOL TOTAL,3,16,3,316,66,404,338,84%
0480,BOULDER VALLEY RE 2,1883,COMMUNITY MONTESSORI SCHOOL,PK,2,11,1,8,48,70,22,31%
0480,BOULDER VALLEY RE 2,1883,COMMUNITY MONTESSORI SCHOOL,HALF DAY K,0,10,0,7,23,40,17,43%
0480,BOULDER VALLEY RE 2,1883,COMMUNITY MONTESSORI SCHOOL,1ST,0,4,2,7,31,44,13,30%
0480,BOULDER VALLEY RE 2,1883,COMMUNITY MONTESSORI SCHOOL,2ND,0,7,0,9,30,46,16,35%
0480,BOULDER VALLEY RE 2,1883,COMMUNITY MONTESSORI SCHOOL,3RD,0,4,0,9,25,38,13,34%
0480,BOULDER VALLEY RE 2,1883,COMMUNITY MONTESSORI SCHOOL,4TH,0,3,0,7,32,42,10,24%
0480,BOULDER VALLEY RE 2,1883,COMMUNITY MONTESSORI SCHOOL,5TH,0,4,1,2,19,26,7,27%
0480,BOULDER VALLEY RE 2,1883,COMMUNITY MONTESSORI SCHOOL,SCHOOL TOTAL,2,43,4,49,208,306,98,32%
0480,BOULDER VALLEY RE 2,1996,CREST VIEW ELEMENTARY SCHOOL,HALF DAY K,1,5,4,21,73,104,31,30%
0480,BOULDER VALLEY RE 2,1996,CREST VIEW ELEMENTARY SCHOOL,1ST,1,11,3,9,74,98,24,24%
0480,BOULDER VALLEY RE 2,1996,CREST VIEW ELEMENTARY SCHOOL,2ND,0,10,1,19,79,109,30,28%
0480,BOULDER VALLEY RE 2,1996,CREST VIEW ELEMENTARY SCHOOL,3RD,0,7,0,20,66,93,27,29%
0480,BOULDER VALLEY RE 2,1996,CREST VIEW ELEMENTARY SCHOOL,4TH,0,8,4,23,71,106,35,33%
0480,BOULDER VALLEY RE 2,1996,CREST VIEW ELEMENTARY SCHOOL,5TH,0,11,0,12,60,83,23,28%
0480,BOULDER VALLEY RE 2,1996,CREST VIEW ELEMENTARY SCHOOL,SCHOOL TOTAL,2,52,12,104,423,593,170,29%
0480,BOULDER VALLEY RE 2,2240,DOUGLASS ELEMENTARY SCHOOL,HALF DAY K,0,2,1,3,69,75,6,8%
0480,BOULDER VALLEY RE 2,2240,DOUGLASS ELEMENTARY SCHOOL,1ST,0,4,0,1,61,66,5,8%
0480,BOULDER VALLEY RE 2,2240,DOUGLASS ELEMENTARY SCHOOL,2ND,0,4,0,0,59,63,4,6%
0480,BOULDER VALLEY RE 2,2240,DOUGLASS ELEMENTARY SCHOOL,3RD,0,3,0,1,66,70,4,6%
0480,BOULDER VALLEY RE 2,2240,DOUGLASS ELEMENTARY SCHOOL,4TH,0,5,0,2,67,74,7,9%
0480,BOULDER VALLEY RE 2,2240,DOUGLASS ELEMENTARY SCHOOL,5TH,0,3,0,1,71,75,4,5%
0480,BOULDER VALLEY RE 2,2240,DOUGLASS ELEMENTARY SCHOOL,SCHOOL TOTAL,0,21,1,8,393,423,30,7%
0480,BOULDER VALLEY RE 2,2552,EISENHOWER ELEMENTARY SCHOOL,HALF DAY K,0,5,1,9,49,64,15,23%
0480,BOULDER VALLEY RE 2,2552,EISENHOWER ELEMENTARY SCHOOL,1ST,0,6,0,10,53,69,16,23%
0480,BOULDER VALLEY RE 2,2552,EISENHOWER ELEMENTARY SCHOOL,2ND,0,6,0,16,51,73,22,30%
0480,BOULDER VALLEY RE 2,2552,EISENHOWER ELEMENTARY SCHOOL,3RD,1,13,1,13,58,86,28,33%
0480,BOULDER VALLEY RE 2,2552,EISENHOWER ELEMENTARY SCHOOL,4TH,1,4,2,16,52,75,23,31%
0480,BOULDER VALLEY RE 2,2552,EISENHOWER ELEMENTARY SCHOOL,5TH,1,5,0,9,63,78,15,19%
0480,BOULDER VALLEY RE 2,2552,EISENHOWER ELEMENTARY SCHOOL,SCHOOL TOTAL,3,39,4,73,326,445,119,27%
0480,BOULDER VALLEY RE 2,2589,ELDORADO K-8 SCHOOL,HALF DAY K,0,18,2,3,58,81,23,28%
0480,BOULDER VALLEY RE 2,2589,ELDORADO K-8 SCHOOL,1ST,0,17,1,5,57,80,23,29%
0480,BOULDER VALLEY RE 2,2589,ELDORADO K-8 SCHOOL,2ND,1,15,2,4,69,91,22,24%
0480,BOULDER VALLEY RE 2,2589,ELDORADO K-8 SCHOOL,3RD,0,13,2,3,70,88,18,20%
0480,BOULDER VALLEY RE 2,2589,ELDORADO K-8 SCHOOL,4TH,0,13,1,5,60,79,19,24%
0480,BOULDER VALLEY RE 2,2589,ELDORADO K-8 SCHOOL,5TH,1,6,1,7,61,76,15,20%
0480,BOULDER VALLEY RE 2,2589,ELDORADO K-8 SCHOOL,6TH,1,22,3,10,125,161,36,22%
0480,BOULDER VALLEY RE 2,2589,ELDORADO K-8 SCHOOL,7TH,0,17,0,7,133,157,24,15%
0480,BOULDER VALLEY RE 2,2589,ELDORADO K-8 SCHOOL,8TH,1,25,2,6,136,170,34,20%
0480,BOULDER VALLEY RE 2,2589,ELDORADO K-8 SCHOOL,SCHOOL TOTAL,4,146,14,50,769,983,214,22%
0480,BOULDER VALLEY RE 2,2702,EMERALD ELEMENTARY SCHOOL,PK,1,4,1,6,15,27,12,44%
0480,BOULDER VALLEY RE 2,2702,EMERALD ELEMENTARY SCHOOL,HALF DAY K,0,5,0,29,27,61,34,56%
0480,BOULDER VALLEY RE 2,2702,EMERALD ELEMENTARY SCHOOL,1ST,0,3,0,30,31,64,33,52%
0480,BOULDER VALLEY RE 2,2702,EMERALD ELEMENTARY SCHOOL,2ND,0,7,0,36,19,62,43,69%
0480,BOULDER VALLEY RE 2,2702,EMERALD ELEMENTARY SCHOOL,3RD,0,2,1,30,24,57,33,58%
0480,BOULDER VALLEY RE 2,2702,EMERALD ELEMENTARY SCHOOL,4TH,0,6,1,23,33,63,30,48%
0480,BOULDER VALLEY RE 2,2702,EMERALD ELEMENTARY SCHOOL,5TH,0,6,0,23,18,47,29,62%
0480,BOULDER VALLEY RE 2,2702,EMERALD ELEMENTARY SCHOOL,SCHOOL TOTAL,1,33,3,177,167,381,214,56%
0480,BOULDER VALLEY RE 2,2892,FAIRVIEW HIGH SCHOOL,9TH,1,56,6,29,393,485,92,19%
0480,BOULDER VALLEY RE 2,2892,FAIRVIEW HIGH SCHOOL,10TH,2,66,7,26,379,480,101,21%
0480,BOULDER VALLEY RE 2,2892,FAIRVIEW HIGH SCHOOL,11TH,2,42,7,27,383,461,78,17%
0480,BOULDER VALLEY RE 2,2892,FAIRVIEW HIGH SCHOOL,12TH,0,40,5,40,400,485,85,18%
0480,BOULDER VALLEY RE 2,2892,FAIRVIEW HIGH SCHOOL,SCHOOL TOTAL,5,204,25,122,1555,1911,356,19%
0480,BOULDER VALLEY RE 2,2940,FIRESIDE ELEMENTARY SCHOOL,PK,0,2,1,5,21,29,8,28%
0480,BOULDER VALLEY RE 2,2940,FIRESIDE ELEMENTARY SCHOOL,HALF DAY K,0,11,0,10,57,78,21,27%
0480,BOULDER VALLEY RE 2,2940,FIRESIDE ELEMENTARY SCHOOL,1ST,0,6,0,6,53,65,12,18%
0480,BOULDER VALLEY RE 2,2940,FIRESIDE ELEMENTARY SCHOOL,2ND,0,11,1,10,38,60,22,37%
0480,BOULDER VALLEY RE 2,2940,FIRESIDE ELEMENTARY SCHOOL,3RD,0,5,3,8,52,68,16,24%
0480,BOULDER VALLEY RE 2,2940,FIRESIDE ELEMENTARY SCHOOL,4TH,0,7,1,10,45,63,18,29%
0480,BOULDER VALLEY RE 2,2940,FIRESIDE ELEMENTARY SCHOOL,5TH,0,7,1,12,64,84,20,24%
0480,BOULDER VALLEY RE 2,2940,FIRESIDE ELEMENTARY SCHOOL,SCHOOL TOTAL,0,49,7,61,330,447,117,26%
0480,BOULDER VALLEY RE 2,2970,FLATIRONS ELEMENTARY SCHOOL,HALF DAY K,0,3,1,0,44,48,4,8%
0480,BOULDER VALLEY RE 2,2970,FLATIRONS ELEMENTARY SCHOOL,1ST,0,3,1,1,41,46,5,11%
0480,BOULDER VALLEY RE 2,2970,FLATIRONS ELEMENTARY SCHOOL,2ND,0,3,0,1,36,40,4,10%
0480,BOULDER VALLEY RE 2,2970,FLATIRONS ELEMENTARY SCHOOL,3RD,0,2,2,1,40,45,5,11%
0480,BOULDER VALLEY RE 2,2970,FLATIRONS ELEMENTARY SCHOOL,4TH,0,2,2,1,40,45,5,11%
0480,BOULDER VALLEY RE 2,2970,FLATIRONS ELEMENTARY SCHOOL,5TH,0,0,1,1,46,48,2,4%
0480,BOULDER VALLEY RE 2,2970,FLATIRONS ELEMENTARY SCHOOL,SCHOOL TOTAL,0,13,7,5,247,272,25,9%
0480,BOULDER VALLEY RE 2,3022,FOOTHILL ELEMENTARY SCHOOL,HALF DAY K,0,3,0,10,84,97,13,13%
0480,BOULDER VALLEY RE 2,3022,FOOTHILL ELEMENTARY SCHOOL,1ST,0,3,0,9,70,82,12,15%
0480,BOULDER VALLEY RE 2,3022,FOOTHILL ELEMENTARY SCHOOL,2ND,0,8,0,9,73,90,17,19%
0480,BOULDER VALLEY RE 2,3022,FOOTHILL ELEMENTARY SCHOOL,3RD,1,8,1,4,91,105,14,13%
0480,BOULDER VALLEY RE 2,3022,FOOTHILL ELEMENTARY SCHOOL,4TH,1,3,1,7,89,101,12,12%
0480,BOULDER VALLEY RE 2,3022,FOOTHILL ELEMENTARY SCHOOL,5TH,0,4,1,5,87,97,10,10%
0480,BOULDER VALLEY RE 2,3022,FOOTHILL ELEMENTARY SCHOOL,SCHOOL TOTAL,2,29,3,44,494,572,78,14%
0480,BOULDER VALLEY RE 2,3488,GOLD HILL ELEMENTARY SCHOOL,HALF DAY K,0,0,0,0,8,8,0,0%
0480,BOULDER VALLEY RE 2,3488,GOLD HILL ELEMENTARY SCHOOL,1ST,0,0,0,0,4,4,0,0%
0480,BOULDER VALLEY RE 2,3488,GOLD HILL ELEMENTARY SCHOOL,2ND,0,1,0,0,1,2,1,50%
0480,BOULDER VALLEY RE 2,3488,GOLD HILL ELEMENTARY SCHOOL,3RD,0,0,0,0,3,3,0,0%
0480,BOULDER VALLEY RE 2,3488,GOLD HILL ELEMENTARY SCHOOL,4TH,0,0,0,0,2,2,0,0%
0480,BOULDER VALLEY RE 2,3488,GOLD HILL ELEMENTARY SCHOOL,5TH,0,0,0,0,2,2,0,0%
0480,BOULDER VALLEY RE 2,3488,GOLD HILL ELEMENTARY SCHOOL,SCHOOL TOTAL,0,1,0,0,20,21,1,5%
0480,BOULDER VALLEY RE 2,3499,HALCYON SCHOOL (SPECIAL EDUCATION),6TH,0,0,0,1,2,3,1,33%
0480,BOULDER VALLEY RE 2,3499,HALCYON SCHOOL (SPECIAL EDUCATION),7TH,0,0,1,0,2,3,1,33%
0480,BOULDER VALLEY RE 2,3499,HALCYON SCHOOL (SPECIAL EDUCATION),8TH,1,0,2,1,2,6,4,67%
0480,BOULDER VALLEY RE 2,3499,HALCYON SCHOOL (SPECIAL EDUCATION),9TH,0,1,1,0,4,6,2,33%
0480,BOULDER VALLEY RE 2,3499,HALCYON SCHOOL (SPECIAL EDUCATION),10TH,0,0,0,1,4,5,1,20%
0480,BOULDER VALLEY RE 2,3499,HALCYON SCHOOL (SPECIAL EDUCATION),11TH,0,0,0,1,3,4,1,25%
0480,BOULDER VALLEY RE 2,3499,HALCYON SCHOOL (SPECIAL EDUCATION),12TH,0,0,0,0,1,1,0,0%
0480,BOULDER VALLEY RE 2,3499,HALCYON SCHOOL (SPECIAL EDUCATION),SCHOOL TOTAL,1,1,4,4,18,28,10,36%
0480,BOULDER VALLEY RE 2,3882,HEATHERWOOD ELEMENTARY SCHOOL,PK,0,0,0,0,5,5,0,0%
0480,BOULDER VALLEY RE 2,3882,HEATHERWOOD ELEMENTARY SCHOOL,HALF DAY K,3,6,2,2,45,58,13,22%
0480,BOULDER VALLEY RE 2,3882,HEATHERWOOD ELEMENTARY SCHOOL,1ST,0,8,0,7,62,77,15,19%
0480,BOULDER VALLEY RE 2,3882,HEATHERWOOD ELEMENTARY SCHOOL,2ND,0,3,0,5,52,60,8,13%
0480,BOULDER VALLEY RE 2,3882,HEATHERWOOD ELEMENTARY SCHOOL,3RD,0,4,2,2,52,60,8,13%
0480,BOULDER VALLEY RE 2,3882,HEATHERWOOD ELEMENTARY SCHOOL,4TH,0,1,1,5,47,54,7,13%
0480,BOULDER VALLEY RE 2,3882,HEATHERWOOD ELEMENTARY SCHOOL,5TH,1,4,1,3,42,51,9,18%
0480,BOULDER VALLEY RE 2,3882,HEATHERWOOD ELEMENTARY SCHOOL,SCHOOL TOTAL,4,26,6,24,305,365,60,16%
0480,BOULDER VALLEY RE 2,3940,HIGH PEAKS ELEMENTARY SCHOOL,PK,0,3,1,11,13,28,15,54%
0480,BOULDER VALLEY RE 2,3940,HIGH PEAKS ELEMENTARY SCHOOL,HALF DAY K,0,3,0,7,35,45,10,22%
0480,BOULDER VALLEY RE 2,3940,HIGH PEAKS ELEMENTARY SCHOOL,1ST,0,7,0,6,33,46,13,28%
0480,BOULDER VALLEY RE 2,3940,HIGH PEAKS ELEMENTARY SCHOOL,2ND,0,11,1,2,31,45,14,31%
0480,BOULDER VALLEY RE 2,3940,HIGH PEAKS ELEMENTARY SCHOOL,3RD,0,8,0,3,39,50,11,22%
0480,BOULDER VALLEY RE 2,3940,HIGH PEAKS ELEMENTARY SCHOOL,4TH,0,6,1,2,47,56,9,16%
0480,BOULDER VALLEY RE 2,3940,HIGH PEAKS ELEMENTARY SCHOOL,5TH,0,10,1,2,37,50,13,26%
0480,BOULDER VALLEY RE 2,3940,HIGH PEAKS ELEMENTARY SCHOOL,SCHOOL TOTAL,0,48,4,33,235,320,85,27%
0480,BOULDER VALLEY RE 2,4386,JAMESTOWN ELEMENTARY SCHOOL,HALF DAY K,0,1,0,0,6,7,1,14%
0480,BOULDER VALLEY RE 2,4386,JAMESTOWN ELEMENTARY SCHOOL,1ST,0,0,0,0,3,3,0,0%
0480,BOULDER VALLEY RE 2,4386,JAMESTOWN ELEMENTARY SCHOOL,2ND,0,0,0,0,3,3,0,0%
0480,BOULDER VALLEY RE 2,4386,JAMESTOWN ELEMENTARY SCHOOL,3RD,0,0,0,0,7,7,0,0%
0480,BOULDER VALLEY RE 2,4386,JAMESTOWN ELEMENTARY SCHOOL,4TH,0,0,0,0,4,4,0,0%
0480,BOULDER VALLEY RE 2,4386,JAMESTOWN ELEMENTARY SCHOOL,5TH,0,0,0,0,3,3,0,0%
0480,BOULDER VALLEY RE 2,4386,JAMESTOWN ELEMENTARY SCHOOL,SCHOOL TOTAL,0,1,0,0,26,27,1,4%
0480,BOULDER VALLEY RE 2,4496,JUSTICE HIGH CHARTER SCHOOL,8TH,0,0,0,1,0,1,1,100%
0480,BOULDER VALLEY RE 2,4496,JUSTICE HIGH CHARTER SCHOOL,9TH,0,0,0,4,3,7,4,57%
0480,BOULDER VALLEY RE 2,4496,JUSTICE HIGH CHARTER SCHOOL,10TH,0,2,2,14,9,27,18,67%
0480,BOULDER VALLEY RE 2,4496,JUSTICE HIGH CHARTER SCHOOL,11TH,0,1,0,34,8,43,35,81%
0480,BOULDER VALLEY RE 2,4496,JUSTICE HIGH CHARTER SCHOOL,12TH,2,1,2,27,14,46,32,70%
0480,BOULDER VALLEY RE 2,4496,JUSTICE HIGH CHARTER SCHOOL,SCHOOL TOTAL,2,4,4,80,34,124,90,73%
0480,BOULDER VALLEY RE 2,4792,KOHL ELEMENTARY SCHOOL,PK,2,5,1,12,21,41,20,49%
0480,BOULDER VALLEY RE 2,4792,KOHL ELEMENTARY SCHOOL,HALF DAY K,0,3,1,9,49,62,13,21%
0480,BOULDER VALLEY RE 2,4792,KOHL ELEMENTARY SCHOOL,1ST,0,4,1,4,61,70,9,13%
0480,BOULDER VALLEY RE 2,4792,KOHL ELEMENTARY SCHOOL,2ND,0,2,1,9,67,79,12,15%
0480,BOULDER VALLEY RE 2,4792,KOHL ELEMENTARY SCHOOL,3RD,2,6,0,6,58,72,14,19%
0480,BOULDER VALLEY RE 2,4792,KOHL ELEMENTARY SCHOOL,4TH,1,4,1,8,77,91,14,15%
0480,BOULDER VALLEY RE 2,4792,KOHL ELEMENTARY SCHOOL,5TH,1,3,1,5,61,71,10,14%
0480,BOULDER VALLEY RE 2,4792,KOHL ELEMENTARY SCHOOL,SCHOOL TOTAL,6,27,6,53,394,486,92,19%
0480,BOULDER VALLEY RE 2,4874,LAFAYETTE ELEMENTARY SCHOOL,PK,0,3,1,5,17,26,9,35%
0480,BOULDER VALLEY RE 2,4874,LAFAYETTE ELEMENTARY SCHOOL,HALF DAY K,0,6,4,12,76,98,22,22%
0480,BOULDER VALLEY RE 2,4874,LAFAYETTE ELEMENTARY SCHOOL,1ST,2,4,1,19,87,113,26,23%
0480,BOULDER VALLEY RE 2,4874,LAFAYETTE ELEMENTARY SCHOOL,2ND,0,5,2,16,83,106,23,22%
0480,BOULDER VALLEY RE 2,4874,LAFAYETTE ELEMENTARY SCHOOL,3RD,0,9,2,11,73,95,22,23%
0480,BOULDER VALLEY RE 2,4874,LAFAYETTE ELEMENTARY SCHOOL,4TH,0,7,1,19,65,92,27,29%
0480,BOULDER VALLEY RE 2,4874,LAFAYETTE ELEMENTARY SCHOOL,5TH,0,0,4,14,61,79,18,23%
0480,BOULDER VALLEY RE 2,4874,LAFAYETTE ELEMENTARY SCHOOL,SCHOOL TOTAL,2,34,15,96,462,609,147,24%
0480,BOULDER VALLEY RE 2,4878,ANGEVINE MIDDLE SCHOOL,6TH,0,8,6,75,114,203,89,44%
0480,BOULDER VALLEY RE 2,4878,ANGEVINE MIDDLE SCHOOL,7TH,3,9,2,66,91,171,80,47%
0480,BOULDER VALLEY RE 2,4878,ANGEVINE MIDDLE SCHOOL,8TH,3,6,3,81,114,207,93,45%
0480,BOULDER VALLEY RE 2,4878,ANGEVINE MIDDLE SCHOOL,SCHOOL TOTAL,6,23,11,222,319,581,262,45%
0480,BOULDER VALLEY RE 2,5302,LOUISVILLE ELEMENTARY SCHOOL,HALF DAY K,0,1,0,6,74,81,7,9%
0480,BOULDER VALLEY RE 2,5302,LOUISVILLE ELEMENTARY SCHOOL,1ST,1,5,2,5,68,81,13,16%
0480,BOULDER VALLEY RE 2,5302,LOUISVILLE ELEMENTARY SCHOOL,2ND,1,2,0,7,69,79,10,13%
0480,BOULDER VALLEY RE 2,5302,LOUISVILLE ELEMENTARY SCHOOL,3RD,0,3,0,5,63,71,8,11%
0480,BOULDER VALLEY RE 2,5302,LOUISVILLE ELEMENTARY SCHOOL,4TH,0,1,0,3,68,72,4,6%
0480,BOULDER VALLEY RE 2,5302,LOUISVILLE ELEMENTARY SCHOOL,5TH,1,3,2,5,62,73,11,15%
0480,BOULDER VALLEY RE 2,5302,LOUISVILLE ELEMENTARY SCHOOL,SCHOOL TOTAL,3,15,4,31,404,457,53,12%
0480,BOULDER VALLEY RE 2,5306,LOUISVILLE MIDDLE SCHOOL,6TH,2,9,2,11,173,197,24,12%
0480,BOULDER VALLEY RE 2,5306,LOUISVILLE MIDDLE SCHOOL,7TH,0,10,1,12,160,183,23,13%
0480,BOULDER VALLEY RE 2,5306,LOUISVILLE MIDDLE SCHOOL,8TH,1,12,2,6,168,189,21,11%
0480,BOULDER VALLEY RE 2,5306,LOUISVILLE MIDDLE SCHOOL,SCHOOL TOTAL,3,31,5,29,501,569,68,12%
0480,BOULDER VALLEY RE 2,5606,CREEKSIDE ELEMENTARY SCHOOL AT MARTIN PARK,PK,0,3,2,13,16,34,18,53%
0480,BOULDER VALLEY RE 2,5606,CREEKSIDE ELEMENTARY SCHOOL AT MARTIN PARK,HALF DAY K,0,9,3,16,31,59,28,47%
0480,BOULDER VALLEY RE 2,5606,CREEKSIDE ELEMENTARY SCHOOL AT MARTIN PARK,1ST,1,6,1,14,40,62,22,35%
0480,BOULDER VALLEY RE 2,5606,CREEKSIDE ELEMENTARY SCHOOL AT MARTIN PARK,2ND,0,1,2,22,36,61,25,41%
0480,BOULDER VALLEY RE 2,5606,CREEKSIDE ELEMENTARY SCHOOL AT MARTIN PARK,3RD,0,4,4,23,30,61,31,51%
0480,BOULDER VALLEY RE 2,5606,CREEKSIDE ELEMENTARY SCHOOL AT MARTIN PARK,4TH,1,4,0,9,24,38,14,37%
0480,BOULDER VALLEY RE 2,5606,CREEKSIDE ELEMENTARY SCHOOL AT MARTIN PARK,5TH,1,2,3,14,16,36,20,56%
0480,BOULDER VALLEY RE 2,5606,CREEKSIDE ELEMENTARY SCHOOL AT MARTIN PARK,SCHOOL TOTAL,3,29,15,111,193,351,158,45%
0480,BOULDER VALLEY RE 2,5838,MESA ELEMENTARY SCHOOL,HALF DAY K,1,3,0,0,39,43,4,9%
0480,BOULDER VALLEY RE 2,5838,MESA ELEMENTARY SCHOOL,1ST,0,5,0,1,61,67,6,9%
0480,BOULDER VALLEY RE 2,5838,MESA ELEMENTARY SCHOOL,2ND,1,5,0,0,60,66,6,9%
0480,BOULDER VALLEY RE 2,5838,MESA ELEMENTARY SCHOOL,3RD,0,9,0,0,63,72,9,13%
0480,BOULDER VALLEY RE 2,5838,MESA ELEMENTARY SCHOOL,4TH,1,0,0,2,58,61,3,5%
0480,BOULDER VALLEY RE 2,5838,MESA ELEMENTARY SCHOOL,5TH,0,4,0,0,52,56,4,7%
0480,BOULDER VALLEY RE 2,5838,MESA ELEMENTARY SCHOOL,SCHOOL TOTAL,3,26,0,3,333,365,32,9%
0480,BOULDER VALLEY RE 2,5999,MONARCH HIGH SCHOOL,9TH,1,30,7,23,336,397,61,15%
0480,BOULDER VALLEY RE 2,5999,MONARCH HIGH SCHOOL,10TH,1,26,2,26,327,382,55,14%
0480,BOULDER VALLEY RE 2,5999,MONARCH HIGH SCHOOL,11TH,0,22,3,27,333,385,52,14%
0480,BOULDER VALLEY RE 2,5999,MONARCH HIGH SCHOOL,12TH,4,19,3,23,296,345,49,14%
0480,BOULDER VALLEY RE 2,5999,MONARCH HIGH SCHOOL,SCHOOL TOTAL,6,97,15,99,1292,1509,217,14%
0480,BOULDER VALLEY RE 2,6000,MONARCH K-8 SCHOOL,HALF DAY K,0,9,0,2,31,42,11,26%
0480,BOULDER VALLEY RE 2,6000,MONARCH K-8 SCHOOL,1ST,0,8,1,1,34,44,10,23%
0480,BOULDER VALLEY RE 2,6000,MONARCH K-8 SCHOOL,2ND,0,4,0,2,56,62,6,10%
0480,BOULDER VALLEY RE 2,6000,MONARCH K-8 SCHOOL,3RD,1,9,0,2,36,48,12,25%
0480,BOULDER VALLEY RE 2,6000,MONARCH K-8 SCHOOL,4TH,0,12,0,2,53,67,14,21%
0480,BOULDER VALLEY RE 2,6000,MONARCH K-8 SCHOOL,5TH,1,5,1,3,43,53,10,19%
0480,BOULDER VALLEY RE 2,6000,MONARCH K-8 SCHOOL,6TH,0,17,3,13,118,151,33,22%
0480,BOULDER VALLEY RE 2,6000,MONARCH K-8 SCHOOL,7TH,1,10,1,10,120,142,22,15%
0480,BOULDER VALLEY RE 2,6000,MONARCH K-8 SCHOOL,8TH,1,12,1,5,120,139,19,14%
0480,BOULDER VALLEY RE 2,6000,MONARCH K-8 SCHOOL,SCHOOL TOTAL,4,86,7,40,611,748,137,18%
0480,BOULDER VALLEY RE 2,6195,NEW VISTA HIGH SCHOOL,9TH,0,4,3,9,46,62,16,26%
0480,BOULDER VALLEY RE 2,6195,NEW VISTA HIGH SCHOOL,10TH,1,2,1,7,67,78,11,14%
0480,BOULDER VALLEY RE 2,6195,NEW VISTA HIGH SCHOOL,11TH,1,5,2,9,75,92,17,18%
0480,BOULDER VALLEY RE 2,6195,NEW VISTA HIGH SCHOOL,12TH,0,4,3,11,67,85,18,21%
0480,BOULDER VALLEY RE 2,6195,NEW VISTA HIGH SCHOOL,SCHOOL TOTAL,2,15,9,36,255,317,62,20%
0480,BOULDER VALLEY RE 2,6208,NEDERLAND ELEMENTARY SCHOOL,PK,1,1,0,1,10,13,3,23%
0480,BOULDER VALLEY RE 2,6208,NEDERLAND ELEMENTARY SCHOOL,HALF DAY K,0,1,0,0,43,44,1,2%
0480,BOULDER VALLEY RE 2,6208,NEDERLAND ELEMENTARY SCHOOL,1ST,0,2,0,5,47,54,7,13%
0480,BOULDER VALLEY RE 2,6208,NEDERLAND ELEMENTARY SCHOOL,2ND,0,2,1,0,34,37,3,8%
0480,BOULDER VALLEY RE 2,6208,NEDERLAND ELEMENTARY SCHOOL,3RD,1,2,2,2,36,43,7,16%
0480,BOULDER VALLEY RE 2,6208,NEDERLAND ELEMENTARY SCHOOL,4TH,0,1,0,1,38,40,2,5%
0480,BOULDER VALLEY RE 2,6208,NEDERLAND ELEMENTARY SCHOOL,5TH,0,3,0,1,47,51,4,8%
0480,BOULDER VALLEY RE 2,6208,NEDERLAND ELEMENTARY SCHOOL,SCHOOL TOTAL,2,12,3,10,255,282,27,10%
0480,BOULDER VALLEY RE 2,6212,NEDERLAND MIDDLE-SENIOR HIGH SCHOOL,6TH,0,3,0,0,59,62,3,5%
0480,BOULDER VALLEY RE 2,6212,NEDERLAND MIDDLE-SENIOR HIGH SCHOOL,7TH,1,0,0,3,44,48,4,8%
0480,BOULDER VALLEY RE 2,6212,NEDERLAND MIDDLE-SENIOR HIGH SCHOOL,8TH,1,1,0,3,43,48,5,10%
0480,BOULDER VALLEY RE 2,6212,NEDERLAND MIDDLE-SENIOR HIGH SCHOOL,9TH,1,1,0,2,38,42,4,10%
0480,BOULDER VALLEY RE 2,6212,NEDERLAND MIDDLE-SENIOR HIGH SCHOOL,10TH,0,0,1,4,53,58,5,9%
0480,BOULDER VALLEY RE 2,6212,NEDERLAND MIDDLE-SENIOR HIGH SCHOOL,11TH,0,1,0,3,43,47,4,9%
0480,BOULDER VALLEY RE 2,6212,NEDERLAND MIDDLE-SENIOR HIGH SCHOOL,12TH,1,0,0,3,51,55,4,7%
0480,BOULDER VALLEY RE 2,6212,NEDERLAND MIDDLE-SENIOR HIGH SCHOOL,SCHOOL TOTAL,4,6,1,18,331,360,29,8%
0480,BOULDER VALLEY RE 2,6224,NEVIN PLATT MIDDLE SCHOOL,6TH,0,7,3,6,161,177,16,9%
0480,BOULDER VALLEY RE 2,6224,NEVIN PLATT MIDDLE SCHOOL,7TH,1,9,2,6,155,173,18,10%
0480,BOULDER VALLEY RE 2,6224,NEVIN PLATT MIDDLE SCHOOL,8TH,0,13,4,9,170,196,26,13%
0480,BOULDER VALLEY RE 2,6224,NEVIN PLATT MIDDLE SCHOOL,SCHOOL TOTAL,1,29,9,21,486,546,60,11%
0480,BOULDER VALLEY RE 2,6642,HORIZONS K-8 SCHOOL,HALF DAY K,0,3,0,2,31,36,5,14%
0480,BOULDER VALLEY RE 2,6642,HORIZONS K-8 SCHOOL,1ST,1,3,0,1,31,36,5,14%
0480,BOULDER VALLEY RE 2,6642,HORIZONS K-8 SCHOOL,2ND,0,4,0,0,32,36,4,11%
0480,BOULDER VALLEY RE 2,6642,HORIZONS K-8 SCHOOL,3RD,0,2,0,1,33,36,3,8%
0480,BOULDER VALLEY RE 2,6642,HORIZONS K-8 SCHOOL,4TH,0,2,0,0,34,36,2,6%
0480,BOULDER VALLEY RE 2,6642,HORIZONS K-8 SCHOOL,5TH,0,0,2,1,35,38,3,8%
0480,BOULDER VALLEY RE 2,6642,HORIZONS K-8 SCHOOL,6TH,0,3,0,1,35,39,4,10%
0480,BOULDER VALLEY RE 2,6642,HORIZONS K-8 SCHOOL,7TH,0,0,0,1,30,31,1,3%
0480,BOULDER VALLEY RE 2,6642,HORIZONS K-8 SCHOOL,8TH,0,3,0,0,34,37,3,8%
0480,BOULDER VALLEY RE 2,6642,HORIZONS K-8 SCHOOL,SCHOOL TOTAL,1,20,2,7,295,325,30,9%
0480,BOULDER VALLEY RE 2,6816,PEAK TO PEAK CHARTER SCHOOL,HALF DAY K,1,10,0,5,54,70,16,23%
0480,BOULDER VALLEY RE 2,6816,PEAK TO PEAK CHARTER SCHOOL,1ST,0,16,3,8,45,72,27,38%
0480,BOULDER VALLEY RE 2,6816,PEAK TO PEAK CHARTER SCHOOL,2ND,0,12,1,4,53,70,17,24%
0480,BOULDER VALLEY RE 2,6816,PEAK TO PEAK CHARTER SCHOOL,3RD,0,8,1,4,63,76,13,17%
0480,BOULDER VALLEY RE 2,6816,PEAK TO PEAK CHARTER SCHOOL,4TH,1,11,0,3,65,80,15,19%
0480,BOULDER VALLEY RE 2,6816,PEAK TO PEAK CHARTER SCHOOL,5TH,0,9,2,5,62,78,16,21%
0480,BOULDER VALLEY RE 2,6816,PEAK TO PEAK CHARTER SCHOOL,6TH,1,12,1,15,106,135,29,21%
0480,BOULDER VALLEY RE 2,6816,PEAK TO PEAK CHARTER SCHOOL,7TH,3,16,1,8,107,135,28,21%
0480,BOULDER VALLEY RE 2,6816,PEAK TO PEAK CHARTER SCHOOL,8TH,2,8,1,8,116,135,19,14%
0480,BOULDER VALLEY RE 2,6816,PEAK TO PEAK CHARTER SCHOOL,9TH,1,18,2,9,129,159,30,19%
0480,BOULDER VALLEY RE 2,6816,PEAK TO PEAK CHARTER SCHOOL,10TH,2,17,1,7,121,148,27,18%
0480,BOULDER VALLEY RE 2,6816,PEAK TO PEAK CHARTER SCHOOL,11TH,2,15,1,13,110,141,31,22%
0480,BOULDER VALLEY RE 2,6816,PEAK TO PEAK CHARTER SCHOOL,12TH,3,10,1,9,103,126,23,18%
0480,BOULDER VALLEY RE 2,6816,PEAK TO PEAK CHARTER SCHOOL,SCHOOL TOTAL,16,162,15,98,1134,1425,291,20%
0480,BOULDER VALLEY RE 2,6962,PIONEER BILINGUAL ELEMENTARY SCHOOL,PK,0,0,2,41,9,52,43,83%
0480,BOULDER VALLEY RE 2,6962,PIONEER BILINGUAL ELEMENTARY SCHOOL,KINDERGARTEN,0,1,1,38,32,72,40,56%
0480,BOULDER VALLEY RE 2,6962,PIONEER BILINGUAL ELEMENTARY SCHOOL,1ST,0,0,1,36,31,68,37,54%
0480,BOULDER VALLEY RE 2,6962,PIONEER BILINGUAL ELEMENTARY SCHOOL,2ND,0,0,0,35,29,64,35,55%
0480,BOULDER VALLEY RE 2,6962,PIONEER BILINGUAL ELEMENTARY SCHOOL,3RD,0,0,1,46,24,71,47,66%
0480,BOULDER VALLEY RE 2,6962,PIONEER BILINGUAL ELEMENTARY SCHOOL,4TH,0,0,1,38,25,64,39,61%
0480,BOULDER VALLEY RE 2,6962,PIONEER BILINGUAL ELEMENTARY SCHOOL,5TH,2,2,0,33,25,62,37,60%
0480,BOULDER VALLEY RE 2,6962,PIONEER BILINGUAL ELEMENTARY SCHOOL,SCHOOL TOTAL,2,3,6,267,175,453,278,61%
0480,BOULDER VALLEY RE 2,7528,RYAN ELEMENTARY SCHOOL,PK,0,2,0,6,16,24,8,33%
0480,BOULDER VALLEY RE 2,7528,RYAN ELEMENTARY SCHOOL,HALF DAY K,1,3,1,18,50,73,23,32%
0480,BOULDER VALLEY RE 2,7528,RYAN ELEMENTARY SCHOOL,1ST,1,3,2,11,54,71,17,24%
0480,BOULDER VALLEY RE 2,7528,RYAN ELEMENTARY SCHOOL,2ND,0,4,2,18,45,69,24,35%
0480,BOULDER VALLEY RE 2,7528,RYAN ELEMENTARY SCHOOL,3RD,1,4,3,17,48,73,25,34%
0480,BOULDER VALLEY RE 2,7528,RYAN ELEMENTARY SCHOOL,4TH,1,3,2,12,37,55,18,33%
0480,BOULDER VALLEY RE 2,7528,RYAN ELEMENTARY SCHOOL,5TH,1,4,0,12,42,59,17,29%
0480,BOULDER VALLEY RE 2,7528,RYAN ELEMENTARY SCHOOL,SCHOOL TOTAL,5,23,10,94,292,424,132,31%
0480,BOULDER VALLEY RE 2,7592,SANCHEZ ELEMENTARY SCHOOL,PK,0,2,2,10,9,23,14,61%
0480,BOULDER VALLEY RE 2,7592,SANCHEZ ELEMENTARY SCHOOL,HALF DAY K,0,2,0,35,17,54,37,69%
0480,BOULDER VALLEY RE 2,7592,SANCHEZ ELEMENTARY SCHOOL,1ST,0,0,1,23,22,46,24,52%
0480,BOULDER VALLEY RE 2,7592,SANCHEZ ELEMENTARY SCHOOL,2ND,1,1,1,37,15,55,40,73%
0480,BOULDER VALLEY RE 2,7592,SANCHEZ ELEMENTARY SCHOOL,3RD,0,2,2,27,12,43,31,72%
0480,BOULDER VALLEY RE 2,7592,SANCHEZ ELEMENTARY SCHOOL,4TH,0,1,0,35,11,47,36,77%
0480,BOULDER VALLEY RE 2,7592,SANCHEZ ELEMENTARY SCHOOL,5TH,0,1,0,20,5,26,21,81%
0480,BOULDER VALLEY RE 2,7592,SANCHEZ ELEMENTARY SCHOOL,SCHOOL TOTAL,1,9,6,187,91,294,203,69%
0480,BOULDER VALLEY RE 2,8135,SOUTHERN HILLS MIDDLE SCHOOL,6TH,2,18,4,8,151,183,32,17%
0480,BOULDER VALLEY RE 2,8135,SOUTHERN HILLS MIDDLE SCHOOL,7TH,0,19,3,7,157,186,29,16%
0480,BOULDER VALLEY RE 2,8135,SOUTHERN HILLS MIDDLE SCHOOL,8TH,1,14,3,5,146,169,23,14%
0480,BOULDER VALLEY RE 2,8135,SOUTHERN HILLS MIDDLE SCHOOL,SCHOOL TOTAL,3,51,10,20,454,538,84,16%
0480,BOULDER VALLEY RE 2,8387,SUMMIT MIDDLE CHARTER SCHOOL,6TH,1,16,0,5,91,113,22,19%
0480,BOULDER VALLEY RE 2,8387,SUMMIT MIDDLE CHARTER SCHOOL,7TH,1,18,1,6,84,110,26,24%
0480,BOULDER VALLEY RE 2,8387,SUMMIT MIDDLE CHARTER SCHOOL,8TH,1,11,1,2,86,101,15,15%
0480,BOULDER VALLEY RE 2,8387,SUMMIT MIDDLE CHARTER SCHOOL,SCHOOL TOTAL,3,45,2,13,261,324,63,19%
0480,BOULDER VALLEY RE 2,8418,SUPERIOR ELEMENTARY SCHOOL,HALF DAY K,1,9,0,4,74,88,14,16%
0480,BOULDER VALLEY RE 2,8418,SUPERIOR ELEMENTARY SCHOOL,1ST,0,18,3,3,74,98,24,24%
0480,BOULDER VALLEY RE 2,8418,SUPERIOR ELEMENTARY SCHOOL,2ND,1,9,2,2,77,91,14,15%
0480,BOULDER VALLEY RE 2,8418,SUPERIOR ELEMENTARY SCHOOL,3RD,1,16,2,1,101,121,20,17%
0480,BOULDER VALLEY RE 2,8418,SUPERIOR ELEMENTARY SCHOOL,4TH,0,13,2,2,101,118,17,14%
0480,BOULDER VALLEY RE 2,8418,SUPERIOR ELEMENTARY SCHOOL,5TH,2,13,3,7,95,120,25,21%
0480,BOULDER VALLEY RE 2,8418,SUPERIOR ELEMENTARY SCHOOL,SCHOOL TOTAL,5,78,12,19,522,636,114,18%
0480,BOULDER VALLEY RE 2,8978,UNIVERSITY HILL ELEMENTARY SCHOOL,PK,0,4,2,38,16,60,44,73%
0480,BOULDER VALLEY RE 2,8978,UNIVERSITY HILL ELEMENTARY SCHOOL,KINDERGARTEN,1,0,1,46,22,70,48,69%
0480,BOULDER VALLEY RE 2,8978,UNIVERSITY HILL ELEMENTARY SCHOOL,1ST,0,2,1,35,28,66,38,58%
0480,BOULDER VALLEY RE 2,8978,UNIVERSITY HILL ELEMENTARY SCHOOL,2ND,0,0,0,23,10,33,23,70%
0480,BOULDER VALLEY RE 2,8978,UNIVERSITY HILL ELEMENTARY SCHOOL,3RD,0,0,2,38,19,59,40,68%
0480,BOULDER VALLEY RE 2,8978,UNIVERSITY HILL ELEMENTARY SCHOOL,4TH,0,0,1,25,6,32,26,81%
0480,BOULDER VALLEY RE 2,8978,UNIVERSITY HILL ELEMENTARY SCHOOL,5TH,0,1,1,22,9,33,24,73%
0480,BOULDER VALLEY RE 2,8978,UNIVERSITY HILL ELEMENTARY SCHOOL,SCHOOL TOTAL,1,7,8,227,110,353,243,69%
0480,BOULDER VALLEY RE 2,9544,WHITTIER ELEMENTARY SCHOOL,HALF DAY K,0,5,0,13,47,65,18,28%
0480,BOULDER VALLEY RE 2,9544,WHITTIER ELEMENTARY SCHOOL,1ST,1,5,2,15,34,57,23,40%
0480,BOULDER VALLEY RE 2,9544,WHITTIER ELEMENTARY SCHOOL,2ND,0,3,1,16,43,63,20,32%
0480,BOULDER VALLEY RE 2,9544,WHITTIER ELEMENTARY SCHOOL,3RD,0,2,0,16,27,45,18,40%
0480,BOULDER VALLEY RE 2,9544,WHITTIER ELEMENTARY SCHOOL,4TH,0,4,1,9,40,54,14,26%
0480,BOULDER VALLEY RE 2,9544,WHITTIER ELEMENTARY SCHOOL,5TH,0,1,2,10,36,49,13,27%
0480,BOULDER VALLEY RE 2,9544,WHITTIER ELEMENTARY SCHOOL,SCHOOL TOTAL,1,20,6,79,227,333,106,32%
0480,BOULDER VALLEY RE 2,,DISTRICT TOTAL,,201,2052,440,4471,21847,29011,7164,25%
0490,BUENA VISTA R-31,1130,BUENA VISTA HIGH SCHOOL,9TH,0,1,0,11,57,69,12,17%
0490,BUENA VISTA R-31,1130,BUENA VISTA HIGH SCHOOL,10TH,0,0,1,3,80,84,4,5%
0490,BUENA VISTA R-31,1130,BUENA VISTA HIGH SCHOOL,11TH,0,1,0,5,73,79,6,8%
0490,BUENA VISTA R-31,1130,BUENA VISTA HIGH SCHOOL,12TH,0,0,0,4,60,64,4,6%
0490,BUENA VISTA R-31,1130,BUENA VISTA HIGH SCHOOL,SCHOOL TOTAL,0,2,1,23,270,296,26,9%
0490,BUENA VISTA R-31,1132,HARRY L MC GINNIS MIDDLE SCHOOL,6TH,1,0,0,8,64,73,9,12%
0490,BUENA VISTA R-31,1132,HARRY L MC GINNIS MIDDLE SCHOOL,7TH,2,0,0,6,65,73,8,11%
0490,BUENA VISTA R-31,1132,HARRY L MC GINNIS MIDDLE SCHOOL,8TH,1,0,0,6,41,48,7,15%
0490,BUENA VISTA R-31,1132,HARRY L MC GINNIS MIDDLE SCHOOL,SCHOOL TOTAL,4,0,0,20,170,194,24,12%
0490,BUENA VISTA R-31,1508,CHAFFEE COUNTY HIGH SCHOOL,9TH,1,0,0,2,13,16,3,19%
0490,BUENA VISTA R-31,1508,CHAFFEE COUNTY HIGH SCHOOL,10TH,0,0,0,2,14,16,2,13%
0490,BUENA VISTA R-31,1508,CHAFFEE COUNTY HIGH SCHOOL,11TH,0,0,0,1,22,23,1,4%
0490,BUENA VISTA R-31,1508,CHAFFEE COUNTY HIGH SCHOOL,12TH,0,0,0,1,4,5,1,20%
0490,BUENA VISTA R-31,1508,CHAFFEE COUNTY HIGH SCHOOL,SCHOOL TOTAL,1,0,0,6,53,60,7,12%
0490,BUENA VISTA R-31,4306,AVERY/PARSONS ELEMENTARY SCHOOL,PK,0,0,3,4,59,66,7,11%
0490,BUENA VISTA R-31,4306,AVERY/PARSONS ELEMENTARY SCHOOL,HALF DAY K,0,0,0,0,2,2,0,0%
0490,BUENA VISTA R-31,4306,AVERY/PARSONS ELEMENTARY SCHOOL,KINDERGARTEN,1,0,0,2,50,53,3,6%
0490,BUENA VISTA R-31,4306,AVERY/PARSONS ELEMENTARY SCHOOL,1ST,1,0,2,3,57,63,6,10%
0490,BUENA VISTA R-31,4306,AVERY/PARSONS ELEMENTARY SCHOOL,2ND,0,0,0,2,48,50,2,4%
0490,BUENA VISTA R-31,4306,AVERY/PARSONS ELEMENTARY SCHOOL,3RD,0,0,0,1,59,60,1,2%
0490,BUENA VISTA R-31,4306,AVERY/PARSONS ELEMENTARY SCHOOL,4TH,1,1,0,6,55,63,8,13%
0490,BUENA VISTA R-31,4306,AVERY/PARSONS ELEMENTARY SCHOOL,5TH,4,1,0,2,55,62,7,11%
0490,BUENA VISTA R-31,4306,AVERY/PARSONS ELEMENTARY SCHOOL,SCHOOL TOTAL,7,2,5,20,385,419,34,8%
0490,BUENA VISTA R-31,,DISTRICT TOTAL,,12,4,6,69,878,969,91,9%
0500,SALIDA R-32,0000,NOT IN A SCHOOL,PK,0,0,0,0,2,2,0,0%
0500,SALIDA R-32,0000,NOT IN A SCHOOL,SCHOOL TOTAL,0,0,0,0,2,2,0,0%
0500,SALIDA R-32,4085,HORIZONS EXPLORATORY ACADEMY,9TH,0,0,0,0,7,7,0,0%
0500,SALIDA R-32,4085,HORIZONS EXPLORATORY ACADEMY,10TH,0,0,0,1,1,2,1,50%
0500,SALIDA R-32,4085,HORIZONS EXPLORATORY ACADEMY,11TH,0,0,0,0,5,5,0,0%
0500,SALIDA R-32,4085,HORIZONS EXPLORATORY ACADEMY,12TH,0,0,0,2,4,6,2,33%
0500,SALIDA R-32,4085,HORIZONS EXPLORATORY ACADEMY,SCHOOL TOTAL,0,0,0,3,17,20,3,15%
0500,SALIDA R-32,4680,SALIDA MIDDLE SCHOOL,5TH,0,0,0,9,76,85,9,11%
0500,SALIDA R-32,4680,SALIDA MIDDLE SCHOOL,6TH,2,2,0,4,64,72,8,11%
0500,SALIDA R-32,4680,SALIDA MIDDLE SCHOOL,7TH,0,2,0,9,89,100,11,11%
0500,SALIDA R-32,4680,SALIDA MIDDLE SCHOOL,8TH,1,1,0,5,71,78,7,9%
0500,SALIDA R-32,4680,SALIDA MIDDLE SCHOOL,SCHOOL TOTAL,3,5,0,27,300,335,35,10%
0500,SALIDA R-32,5268,LONGFELLOW ELEMENTARY SCHOOL,HALF DAY K,2,0,0,3,32,37,5,14%
0500,SALIDA R-32,5268,LONGFELLOW ELEMENTARY SCHOOL,KINDERGARTEN,2,1,1,11,40,55,15,27%
0500,SALIDA R-32,5268,LONGFELLOW ELEMENTARY SCHOOL,1ST,0,1,0,7,70,78,8,10%
0500,SALIDA R-32,5268,LONGFELLOW ELEMENTARY SCHOOL,2ND,0,0,0,12,51,63,12,19%
0500,SALIDA R-32,5268,LONGFELLOW ELEMENTARY SCHOOL,3RD,1,0,0,13,86,100,14,14%
0500,SALIDA R-32,5268,LONGFELLOW ELEMENTARY SCHOOL,4TH,0,1,0,11,67,79,12,15%
0500,SALIDA R-32,5268,LONGFELLOW ELEMENTARY SCHOOL,SCHOOL TOTAL,5,3,1,57,346,412,66,16%
0500,SALIDA R-32,7568,SALIDA HIGH SCHOOL,9TH,0,3,0,10,66,79,13,16%
0500,SALIDA R-32,7568,SALIDA HIGH SCHOOL,10TH,2,1,0,6,61,70,9,13%
0500,SALIDA R-32,7568,SALIDA HIGH SCHOOL,11TH,3,3,0,12,69,87,18,21%
0500,SALIDA R-32,7568,SALIDA HIGH SCHOOL,12TH,3,0,0,6,71,80,9,11%
0500,SALIDA R-32,7568,SALIDA HIGH SCHOOL,SCHOOL TOTAL,8,7,0,34,267,316,49,16%
0500,SALIDA R-32,,DISTRICT TOTAL,,16,15,1,121,932,1085,153,14%
0510,KIT CARSON R-1,4738,KIT CARSON ELEMENTARY SCHOOL,HALF DAY K,0,0,0,0,5,5,0,0%
0510,KIT CARSON R-1,4738,KIT CARSON ELEMENTARY SCHOOL,1ST,0,0,0,0,11,11,0,0%
0510,KIT CARSON R-1,4738,KIT CARSON ELEMENTARY SCHOOL,2ND,0,0,0,0,7,7,0,0%
0510,KIT CARSON R-1,4738,KIT CARSON ELEMENTARY SCHOOL,3RD,0,0,0,0,11,11,0,0%
0510,KIT CARSON R-1,4738,KIT CARSON ELEMENTARY SCHOOL,4TH,0,0,0,1,5,6,1,17%
0510,KIT CARSON R-1,4738,KIT CARSON ELEMENTARY SCHOOL,5TH,0,0,0,0,5,5,0,0%
0510,KIT CARSON R-1,4738,KIT CARSON ELEMENTARY SCHOOL,SCHOOL TOTAL,0,0,0,1,44,45,1,2%
0510,KIT CARSON R-1,4742,KIT CARSON JUNIOR-SENIOR HIGH SCHOOL,6TH,0,0,0,4,7,11,4,36%
0510,KIT CARSON R-1,4742,KIT CARSON JUNIOR-SENIOR HIGH SCHOOL,7TH,0,0,0,0,6,6,0,0%
0510,KIT CARSON R-1,4742,KIT CARSON JUNIOR-SENIOR HIGH SCHOOL,8TH,0,0,0,2,4,6,2,33%
0510,KIT CARSON R-1,4742,KIT CARSON JUNIOR-SENIOR HIGH SCHOOL,9TH,0,0,0,1,9,10,1,10%
0510,KIT CARSON R-1,4742,KIT CARSON JUNIOR-SENIOR HIGH SCHOOL,10TH,0,0,0,1,8,9,1,11%
0510,KIT CARSON R-1,4742,KIT CARSON JUNIOR-SENIOR HIGH SCHOOL,11TH,0,0,0,1,5,6,1,17%
0510,KIT CARSON R-1,4742,KIT CARSON JUNIOR-SENIOR HIGH SCHOOL,12TH,0,0,0,0,3,3,0,0%
0510,KIT CARSON R-1,4742,KIT CARSON JUNIOR-SENIOR HIGH SCHOOL,SCHOOL TOTAL,0,0,0,9,42,51,9,18%
0510,KIT CARSON R-1,,DISTRICT TOTAL,,0,0,0,10,86,96,10,10%
0520,CHEYENNE COUNTY RE-5,1608,CHEYENNE WELLS ELEMENTARY SCHOOL,PK,0,0,0,6,22,28,6,21%
0520,CHEYENNE COUNTY RE-5,1608,CHEYENNE WELLS ELEMENTARY SCHOOL,KINDERGARTEN,0,0,0,3,7,10,3,30%
0520,CHEYENNE COUNTY RE-5,1608,CHEYENNE WELLS ELEMENTARY SCHOOL,1ST,0,0,0,2,5,7,2,29%
0520,CHEYENNE COUNTY RE-5,1608,CHEYENNE WELLS ELEMENTARY SCHOOL,2ND,0,0,0,3,16,19,3,16%
0520,CHEYENNE COUNTY RE-5,1608,CHEYENNE WELLS ELEMENTARY SCHOOL,3RD,0,0,0,1,5,6,1,17%
0520,CHEYENNE COUNTY RE-5,1608,CHEYENNE WELLS ELEMENTARY SCHOOL,4TH,0,0,0,1,13,14,1,7%
0520,CHEYENNE COUNTY RE-5,1608,CHEYENNE WELLS ELEMENTARY SCHOOL,5TH,0,0,0,2,12,14,2,14%
0520,CHEYENNE COUNTY RE-5,1608,CHEYENNE WELLS ELEMENTARY SCHOOL,SCHOOL TOTAL,0,0,0,18,80,98,18,18%
0520,CHEYENNE COUNTY RE-5,1610,CHEYENNE WELLS MIDDLE SCHOOL,6TH,0,0,0,2,8,10,2,20%
0520,CHEYENNE COUNTY RE-5,1610,CHEYENNE WELLS MIDDLE SCHOOL,7TH,0,0,0,1,10,11,1,9%
0520,CHEYENNE COUNTY RE-5,1610,CHEYENNE WELLS MIDDLE SCHOOL,8TH,0,0,0,3,9,12,3,25%
0520,CHEYENNE COUNTY RE-5,1610,CHEYENNE WELLS MIDDLE SCHOOL,SCHOOL TOTAL,0,0,0,6,27,33,6,18%
0520,CHEYENNE COUNTY RE-5,1612,CHEYENNE WELLS HIGH SCHOOL,9TH,0,0,0,1,16,17,1,6%
0520,CHEYENNE COUNTY RE-5,1612,CHEYENNE WELLS HIGH SCHOOL,10TH,0,0,0,5,6,11,5,45%
0520,CHEYENNE COUNTY RE-5,1612,CHEYENNE WELLS HIGH SCHOOL,11TH,0,0,0,2,17,19,2,11%
0520,CHEYENNE COUNTY RE-5,1612,CHEYENNE WELLS HIGH SCHOOL,12TH,0,0,0,2,9,11,2,18%
0520,CHEYENNE COUNTY RE-5,1612,CHEYENNE WELLS HIGH SCHOOL,SCHOOL TOTAL,0,0,0,10,48,58,10,17%
0520,CHEYENNE COUNTY RE-5,,DISTRICT TOTAL,,0,0,0,34,155,189,34,18%
0540,CLEAR CREEK RE-1,1660,CLEAR CREEK MIDDLE SCHOOL,7TH,1,0,0,9,50,60,10,17%
0540,CLEAR CREEK RE-1,1660,CLEAR CREEK MIDDLE SCHOOL,8TH,1,1,2,3,59,66,7,11%
0540,CLEAR CREEK RE-1,1660,CLEAR CREEK MIDDLE SCHOOL,SCHOOL TOTAL,2,1,2,12,109,126,17,13%
0540,CLEAR CREEK RE-1,3385,GEORGETOWN COMMUNITY SCHOOL,PK,0,0,0,1,17,18,1,6%
0540,CLEAR CREEK RE-1,3385,GEORGETOWN COMMUNITY SCHOOL,KINDERGARTEN,0,0,1,0,12,13,1,8%
0540,CLEAR CREEK RE-1,3385,GEORGETOWN COMMUNITY SCHOOL,1ST,0,0,0,3,15,18,3,17%
0540,CLEAR CREEK RE-1,3385,GEORGETOWN COMMUNITY SCHOOL,2ND,0,0,0,1,12,13,1,8%
0540,CLEAR CREEK RE-1,3385,GEORGETOWN COMMUNITY SCHOOL,3RD,0,0,1,2,12,15,3,20%
0540,CLEAR CREEK RE-1,3385,GEORGETOWN COMMUNITY SCHOOL,4TH,0,0,0,2,10,12,2,17%
0540,CLEAR CREEK RE-1,3385,GEORGETOWN COMMUNITY SCHOOL,5TH,0,0,0,1,13,14,1,7%
0540,CLEAR CREEK RE-1,3385,GEORGETOWN COMMUNITY SCHOOL,6TH,0,0,0,1,14,15,1,7%
0540,CLEAR CREEK RE-1,3385,GEORGETOWN COMMUNITY SCHOOL,SCHOOL TOTAL,0,0,2,11,105,118,13,11%
0540,CLEAR CREEK RE-1,4212,CARLSON ELEMENTARY SCHOOL,PK,1,1,0,4,31,37,6,16%
0540,CLEAR CREEK RE-1,4212,CARLSON ELEMENTARY SCHOOL,KINDERGARTEN,2,1,1,4,29,37,8,22%
0540,CLEAR CREEK RE-1,4212,CARLSON ELEMENTARY SCHOOL,1ST,0,1,0,4,16,21,5,24%
0540,CLEAR CREEK RE-1,4212,CARLSON ELEMENTARY SCHOOL,2ND,2,1,1,3,28,35,7,20%
0540,CLEAR CREEK RE-1,4212,CARLSON ELEMENTARY SCHOOL,3RD,1,0,1,4,25,31,6,19%
0540,CLEAR CREEK RE-1,4212,CARLSON ELEMENTARY SCHOOL,4TH,0,1,0,2,30,33,3,9%
0540,CLEAR CREEK RE-1,4212,CARLSON ELEMENTARY SCHOOL,5TH,1,0,0,5,15,21,6,29%
0540,CLEAR CREEK RE-1,4212,CARLSON ELEMENTARY SCHOOL,6TH,1,0,1,3,33,38,5,13%
0540,CLEAR CREEK RE-1,4212,CARLSON ELEMENTARY SCHOOL,SCHOOL TOTAL,8,5,4,29,207,253,46,18%
0540,CLEAR CREEK RE-1,4216,CLEAR CREEK HIGH SCHOOL,9TH,0,1,0,5,56,62,6,10%
0540,CLEAR CREEK RE-1,4216,CLEAR CREEK HIGH SCHOOL,10TH,3,1,1,13,55,73,18,25%
0540,CLEAR CREEK RE-1,4216,CLEAR CREEK HIGH SCHOOL,11TH,0,0,1,6,60,67,7,10%
0540,CLEAR CREEK RE-1,4216,CLEAR CREEK HIGH SCHOOL,12TH,1,1,1,5,48,56,8,14%
0540,CLEAR CREEK RE-1,4216,CLEAR CREEK HIGH SCHOOL,SCHOOL TOTAL,4,3,3,29,219,258,39,15%
0540,CLEAR CREEK RE-1,4700,KING-MURPHY ELEMENTARY SCHOOL,PK,0,0,0,2,25,27,2,7%
0540,CLEAR CREEK RE-1,4700,KING-MURPHY ELEMENTARY SCHOOL,KINDERGARTEN,0,1,0,0,34,35,1,3%
0540,CLEAR CREEK RE-1,4700,KING-MURPHY ELEMENTARY SCHOOL,1ST,0,0,0,0,18,18,0,0%
0540,CLEAR CREEK RE-1,4700,KING-MURPHY ELEMENTARY SCHOOL,2ND,0,3,1,0,31,35,4,11%
0540,CLEAR CREEK RE-1,4700,KING-MURPHY ELEMENTARY SCHOOL,3RD,0,0,0,0,21,21,0,0%
0540,CLEAR CREEK RE-1,4700,KING-MURPHY ELEMENTARY SCHOOL,4TH,0,2,1,1,26,30,4,13%
0540,CLEAR CREEK RE-1,4700,KING-MURPHY ELEMENTARY SCHOOL,5TH,0,0,0,2,31,33,2,6%
0540,CLEAR CREEK RE-1,4700,KING-MURPHY ELEMENTARY SCHOOL,6TH,0,0,0,0,20,20,0,0%
0540,CLEAR CREEK RE-1,4700,KING-MURPHY ELEMENTARY SCHOOL,SCHOOL TOTAL,0,6,2,5,206,219,13,6%
0540,CLEAR CREEK RE-1,,DISTRICT TOTAL,,14,15,13,86,846,974,128,13%
0550,NORTH CONEJOS RE-1J,1276,CENTAURI MIDDLE SCHOOL,6TH,0,0,0,50,26,76,50,66%
0550,NORTH CONEJOS RE-1J,1276,CENTAURI MIDDLE SCHOOL,7TH,2,0,1,42,31,76,45,59%
0550,NORTH CONEJOS RE-1J,1276,CENTAURI MIDDLE SCHOOL,8TH,0,0,0,48,33,81,48,59%
0550,NORTH CONEJOS RE-1J,1276,CENTAURI MIDDLE SCHOOL,SCHOOL TOTAL,2,0,1,140,90,233,143,61%
0550,NORTH CONEJOS RE-1J,1378,CENTAURI HIGH SCHOOL,9TH,1,1,1,33,33,69,36,52%
0550,NORTH CONEJOS RE-1J,1378,CENTAURI HIGH SCHOOL,10TH,0,0,0,32,34,66,32,48%
0550,NORTH CONEJOS RE-1J,1378,CENTAURI HIGH SCHOOL,11TH,0,1,1,47,34,83,49,59%
0550,NORTH CONEJOS RE-1J,1378,CENTAURI HIGH SCHOOL,12TH,1,0,0,31,42,74,32,43%
0550,NORTH CONEJOS RE-1J,1378,CENTAURI HIGH SCHOOL,SCHOOL TOTAL,2,2,2,143,143,292,149,51%
0550,NORTH CONEJOS RE-1J,4836,LA JARA ELEMENTARY SCHOOL,KINDERGARTEN,0,0,0,20,16,36,20,56%
0550,NORTH CONEJOS RE-1J,4836,LA JARA ELEMENTARY SCHOOL,1ST,0,0,0,20,16,36,20,56%
0550,NORTH CONEJOS RE-1J,4836,LA JARA ELEMENTARY SCHOOL,2ND,0,0,0,21,9,30,21,70%
0550,NORTH CONEJOS RE-1J,4836,LA JARA ELEMENTARY SCHOOL,3RD,0,0,0,24,12,36,24,67%
0550,NORTH CONEJOS RE-1J,4836,LA JARA ELEMENTARY SCHOOL,4TH,0,0,0,30,16,46,30,65%
0550,NORTH CONEJOS RE-1J,4836,LA JARA ELEMENTARY SCHOOL,5TH,0,0,0,22,11,33,22,67%
0550,NORTH CONEJOS RE-1J,4836,LA JARA ELEMENTARY SCHOOL,SCHOOL TOTAL,0,0,0,137,80,217,137,63%
0550,NORTH CONEJOS RE-1J,4837,LA JARA SECOND CHANCE SCHOOL,8TH,0,0,0,1,1,2,1,50%
0550,NORTH CONEJOS RE-1J,4837,LA JARA SECOND CHANCE SCHOOL,9TH,0,0,0,9,1,10,9,90%
0550,NORTH CONEJOS RE-1J,4837,LA JARA SECOND CHANCE SCHOOL,10TH,0,0,0,6,2,8,6,75%
0550,NORTH CONEJOS RE-1J,4837,LA JARA SECOND CHANCE SCHOOL,11TH,0,0,0,11,5,16,11,69%
0550,NORTH CONEJOS RE-1J,4837,LA JARA SECOND CHANCE SCHOOL,12TH,1,0,1,20,9,31,22,71%
0550,NORTH CONEJOS RE-1J,4837,LA JARA SECOND CHANCE SCHOOL,SCHOOL TOTAL,1,0,1,47,18,67,49,73%
0550,NORTH CONEJOS RE-1J,5422,MANASSA ELEMENTARY SCHOOL,KINDERGARTEN,1,1,0,14,20,36,16,44%
0550,NORTH CONEJOS RE-1J,5422,MANASSA ELEMENTARY SCHOOL,1ST,0,0,0,15,19,34,15,44%
0550,NORTH CONEJOS RE-1J,5422,MANASSA ELEMENTARY SCHOOL,2ND,0,1,1,13,20,35,15,43%
0550,NORTH CONEJOS RE-1J,5422,MANASSA ELEMENTARY SCHOOL,3RD,1,0,1,25,20,47,27,57%
0550,NORTH CONEJOS RE-1J,5422,MANASSA ELEMENTARY SCHOOL,4TH,1,0,1,27,20,49,29,59%
0550,NORTH CONEJOS RE-1J,5422,MANASSA ELEMENTARY SCHOOL,5TH,0,0,0,23,18,41,23,56%
0550,NORTH CONEJOS RE-1J,5422,MANASSA ELEMENTARY SCHOOL,SCHOOL TOTAL,3,2,3,117,117,242,125,52%
0550,NORTH CONEJOS RE-1J,,DISTRICT TOTAL,,8,4,7,584,448,1051,603,57%
0560,SANFORD 6J,7612,SANFORD ELEMENTARY SCHOOL,PK,1,0,0,8,16,25,9,36%
0560,SANFORD 6J,7612,SANFORD ELEMENTARY SCHOOL,KINDERGARTEN,0,0,0,4,25,29,4,14%
0560,SANFORD 6J,7612,SANFORD ELEMENTARY SCHOOL,1ST,0,0,0,4,11,15,4,27%
0560,SANFORD 6J,7612,SANFORD ELEMENTARY SCHOOL,2ND,0,1,0,7,23,31,8,26%
0560,SANFORD 6J,7612,SANFORD ELEMENTARY SCHOOL,3RD,1,0,0,12,20,33,13,39%
0560,SANFORD 6J,7612,SANFORD ELEMENTARY SCHOOL,4TH,0,0,0,6,15,21,6,29%
0560,SANFORD 6J,7612,SANFORD ELEMENTARY SCHOOL,5TH,0,0,0,9,20,29,9,31%
0560,SANFORD 6J,7612,SANFORD ELEMENTARY SCHOOL,6TH,1,1,0,9,20,31,11,35%
0560,SANFORD 6J,7612,SANFORD ELEMENTARY SCHOOL,SCHOOL TOTAL,3,2,0,59,150,214,64,30%
0560,SANFORD 6J,7616,SANFORD JUNIOR/SENIOR HIGH SCHOOL,7TH,0,0,0,13,16,29,13,45%
0560,SANFORD 6J,7616,SANFORD JUNIOR/SENIOR HIGH SCHOOL,8TH,0,0,0,6,10,16,6,38%
0560,SANFORD 6J,7616,SANFORD JUNIOR/SENIOR HIGH SCHOOL,9TH,0,0,0,5,14,19,5,26%
0560,SANFORD 6J,7616,SANFORD JUNIOR/SENIOR HIGH SCHOOL,10TH,0,0,0,4,16,20,4,20%
0560,SANFORD 6J,7616,SANFORD JUNIOR/SENIOR HIGH SCHOOL,11TH,0,0,0,5,13,18,5,28%
0560,SANFORD 6J,7616,SANFORD JUNIOR/SENIOR HIGH SCHOOL,12TH,0,0,0,5,19,24,5,21%
0560,SANFORD 6J,7616,SANFORD JUNIOR/SENIOR HIGH SCHOOL,SCHOOL TOTAL,0,0,0,38,88,126,38,30%
0560,SANFORD 6J,,DISTRICT TOTAL,,3,2,0,97,238,340,102,30%
0580,SOUTH CONEJOS RE-10,0248,GUADALUPE ELEMENTARY SCHOOL,PK,0,0,0,8,0,8,8,100%
0580,SOUTH CONEJOS RE-10,0248,GUADALUPE ELEMENTARY SCHOOL,KINDERGARTEN,1,0,0,13,1,15,14,93%
0580,SOUTH CONEJOS RE-10,0248,GUADALUPE ELEMENTARY SCHOOL,1ST,0,0,1,15,2,18,16,89%
0580,SOUTH CONEJOS RE-10,0248,GUADALUPE ELEMENTARY SCHOOL,2ND,0,0,0,17,1,18,17,94%
0580,SOUTH CONEJOS RE-10,0248,GUADALUPE ELEMENTARY SCHOOL,3RD,0,0,0,17,3,20,17,85%
0580,SOUTH CONEJOS RE-10,0248,GUADALUPE ELEMENTARY SCHOOL,4TH,0,0,0,18,0,18,18,100%
0580,SOUTH CONEJOS RE-10,0248,GUADALUPE ELEMENTARY SCHOOL,5TH,0,0,1,9,0,10,10,100%
0580,SOUTH CONEJOS RE-10,0248,GUADALUPE ELEMENTARY SCHOOL,6TH,0,0,0,22,0,22,22,100%
0580,SOUTH CONEJOS RE-10,0248,GUADALUPE ELEMENTARY SCHOOL,SCHOOL TOTAL,1,0,2,119,7,129,122,95%
0580,SOUTH CONEJOS RE-10,0250,ANTONITO JUNIOR HIGH SCHOOL,7TH,0,0,0,17,3,20,17,85%
0580,SOUTH CONEJOS RE-10,0250,ANTONITO JUNIOR HIGH SCHOOL,8TH,0,0,0,24,1,25,24,96%
0580,SOUTH CONEJOS RE-10,0250,ANTONITO JUNIOR HIGH SCHOOL,SCHOOL TOTAL,0,0,0,41,4,45,41,91%
0580,SOUTH CONEJOS RE-10,0252,ANTONITO HIGH SCHOOL,9TH,0,0,1,15,3,19,16,84%
0580,SOUTH CONEJOS RE-10,0252,ANTONITO HIGH SCHOOL,10TH,0,3,0,25,1,29,28,97%
0580,SOUTH CONEJOS RE-10,0252,ANTONITO HIGH SCHOOL,11TH,0,1,0,24,2,27,25,93%
0580,SOUTH CONEJOS RE-10,0252,ANTONITO HIGH SCHOOL,12TH,0,0,0,28,3,31,28,90%
0580,SOUTH CONEJOS RE-10,0252,ANTONITO HIGH SCHOOL,SCHOOL TOTAL,0,4,1,92,9,106,97,92%
0580,SOUTH CONEJOS RE-10,,DISTRICT TOTAL,,1,4,3,252,20,280,260,93%
0640,CENTENNIAL R-1,1396,CENTENNIAL JUNIOR HIGH SCHOOL,7TH,1,0,0,13,1,15,14,93%
0640,CENTENNIAL R-1,1396,CENTENNIAL JUNIOR HIGH SCHOOL,8TH,1,0,1,10,0,12,12,100%
0640,CENTENNIAL R-1,1396,CENTENNIAL JUNIOR HIGH SCHOOL,SCHOOL TOTAL,2,0,1,23,1,27,26,96%
0640,CENTENNIAL R-1,1398,CENTENNIAL HIGH SCHOOL,9TH,0,0,1,24,1,26,25,96%
0640,CENTENNIAL R-1,1398,CENTENNIAL HIGH SCHOOL,10TH,0,0,0,17,0,17,17,100%
0640,CENTENNIAL R-1,1398,CENTENNIAL HIGH SCHOOL,11TH,0,0,0,25,2,27,25,93%
0640,CENTENNIAL R-1,1398,CENTENNIAL HIGH SCHOOL,12TH,0,0,0,11,1,12,11,92%
0640,CENTENNIAL R-1,1398,CENTENNIAL HIGH SCHOOL,SCHOOL TOTAL,0,0,1,77,4,82,78,95%
0640,CENTENNIAL R-1,7588,CENTENNIAL ELEMENTARY SCHOOL,PK,0,0,0,11,0,11,11,100%
0640,CENTENNIAL R-1,7588,CENTENNIAL ELEMENTARY SCHOOL,KINDERGARTEN,0,0,0,10,1,11,10,91%
0640,CENTENNIAL R-1,7588,CENTENNIAL ELEMENTARY SCHOOL,1ST,0,0,0,14,2,16,14,88%
0640,CENTENNIAL R-1,7588,CENTENNIAL ELEMENTARY SCHOOL,2ND,0,0,0,21,0,21,21,100%
0640,CENTENNIAL R-1,7588,CENTENNIAL ELEMENTARY SCHOOL,3RD,0,0,0,14,0,14,14,100%
0640,CENTENNIAL R-1,7588,CENTENNIAL ELEMENTARY SCHOOL,4TH,0,0,0,13,0,13,13,100%
0640,CENTENNIAL R-1,7588,CENTENNIAL ELEMENTARY SCHOOL,5TH,0,0,1,12,1,14,13,93%
0640,CENTENNIAL R-1,7588,CENTENNIAL ELEMENTARY SCHOOL,6TH,0,0,0,11,0,11,11,100%
0640,CENTENNIAL R-1,7588,CENTENNIAL ELEMENTARY SCHOOL,SCHOOL TOTAL,0,0,1,106,4,111,107,96%
0640,CENTENNIAL R-1,,DISTRICT TOTAL,,2,0,3,206,9,220,211,96%
0740,SIERRA GRANDE R-30,7876,SIERRA GRANDE ELEMENTARY SCHOOL,KINDERGARTEN,0,0,1,11,1,13,12,92%
0740,SIERRA GRANDE R-30,7876,SIERRA GRANDE ELEMENTARY SCHOOL,1ST,0,0,1,21,8,30,22,73%
0740,SIERRA GRANDE R-30,7876,SIERRA GRANDE ELEMENTARY SCHOOL,2ND,0,0,0,11,3,14,11,79%
0740,SIERRA GRANDE R-30,7876,SIERRA GRANDE ELEMENTARY SCHOOL,3RD,0,0,0,17,3,20,17,85%
0740,SIERRA GRANDE R-30,7876,SIERRA GRANDE ELEMENTARY SCHOOL,4TH,1,0,1,14,4,20,16,80%
0740,SIERRA GRANDE R-30,7876,SIERRA GRANDE ELEMENTARY SCHOOL,5TH,0,0,0,14,5,19,14,74%
0740,SIERRA GRANDE R-30,7876,SIERRA GRANDE ELEMENTARY SCHOOL,SCHOOL TOTAL,1,0,3,88,24,116,92,79%
0740,SIERRA GRANDE R-30,7878,SIERRA GRANDE MIDDLE SCHOOL,6TH,0,0,0,10,3,13,10,77%
0740,SIERRA GRANDE R-30,7878,SIERRA GRANDE MIDDLE SCHOOL,7TH,1,2,0,7,4,14,10,71%
0740,SIERRA GRANDE R-30,7878,SIERRA GRANDE MIDDLE SCHOOL,8TH,1,1,0,24,5,31,26,84%
0740,SIERRA GRANDE R-30,7878,SIERRA GRANDE MIDDLE SCHOOL,SCHOOL TOTAL,2,3,0,41,12,58,46,79%
0740,SIERRA GRANDE R-30,7880,SIERRA GRANDE SENIOR HIGH SCHOOL,9TH,0,4,0,18,1,23,22,96%
0740,SIERRA GRANDE R-30,7880,SIERRA GRANDE SENIOR HIGH SCHOOL,10TH,0,0,0,19,4,23,19,83%
0740,SIERRA GRANDE R-30,7880,SIERRA GRANDE SENIOR HIGH SCHOOL,11TH,0,0,0,11,2,13,11,85%
0740,SIERRA GRANDE R-30,7880,SIERRA GRANDE SENIOR HIGH SCHOOL,12TH,0,0,0,14,5,19,14,74%
0740,SIERRA GRANDE R-30,7880,SIERRA GRANDE SENIOR HIGH SCHOOL,SCHOOL TOTAL,0,4,0,62,12,78,66,85%
0740,SIERRA GRANDE R-30,,DISTRICT TOTAL,,3,7,3,191,48,252,204,81%
0770,CROWLEY COUNTY RE-1-J,1967,CROWLEY COUNTY ONLINE ACADEMY,9TH,0,0,0,3,4,7,3,43%
0770,CROWLEY COUNTY RE-1-J,1967,CROWLEY COUNTY ONLINE ACADEMY,10TH,0,0,0,2,4,6,2,33%
0770,CROWLEY COUNTY RE-1-J,1967,CROWLEY COUNTY ONLINE ACADEMY,11TH,0,0,0,1,2,3,1,33%
0770,CROWLEY COUNTY RE-1-J,1967,CROWLEY COUNTY ONLINE ACADEMY,12TH,0,0,0,1,3,4,1,25%
0770,CROWLEY COUNTY RE-1-J,1967,CROWLEY COUNTY ONLINE ACADEMY,SCHOOL TOTAL,0,0,0,7,13,20,7,35%
0770,CROWLEY COUNTY RE-1-J,2050,CROWLEY COUNTY ELEMENTARY SCHOOL,KINDERGARTEN,1,1,0,18,21,41,20,49%
0770,CROWLEY COUNTY RE-1-J,2050,CROWLEY COUNTY ELEMENTARY SCHOOL,1ST,0,1,0,13,15,29,14,48%
0770,CROWLEY COUNTY RE-1-J,2050,CROWLEY COUNTY ELEMENTARY SCHOOL,2ND,1,0,0,12,15,28,13,46%
0770,CROWLEY COUNTY RE-1-J,2050,CROWLEY COUNTY ELEMENTARY SCHOOL,3RD,0,0,0,11,23,34,11,32%
0770,CROWLEY COUNTY RE-1-J,2050,CROWLEY COUNTY ELEMENTARY SCHOOL,4TH,0,0,1,10,22,33,11,33%
0770,CROWLEY COUNTY RE-1-J,2050,CROWLEY COUNTY ELEMENTARY SCHOOL,5TH,0,0,0,14,30,44,14,32%
0770,CROWLEY COUNTY RE-1-J,2050,CROWLEY COUNTY ELEMENTARY SCHOOL,SCHOOL TOTAL,2,2,1,78,126,209,83,40%
0770,CROWLEY COUNTY RE-1-J,2054,CROWLEY COUNTY WARD MIDDLE SCHOOL,6TH,0,0,1,10,32,43,11,26%
0770,CROWLEY COUNTY RE-1-J,2054,CROWLEY COUNTY WARD MIDDLE SCHOOL,7TH,0,0,3,10,26,39,13,33%
0770,CROWLEY COUNTY RE-1-J,2054,CROWLEY COUNTY WARD MIDDLE SCHOOL,8TH,0,0,0,11,14,25,11,44%
0770,CROWLEY COUNTY RE-1-J,2054,CROWLEY COUNTY WARD MIDDLE SCHOOL,SCHOOL TOTAL,0,0,4,31,72,107,35,33%
0770,CROWLEY COUNTY RE-1-J,2058,CROWLEY COUNTY HIGH SCHOOL,9TH,0,0,0,14,29,43,14,33%
0770,CROWLEY COUNTY RE-1-J,2058,CROWLEY COUNTY HIGH SCHOOL,10TH,0,0,1,11,29,41,12,29%
0770,CROWLEY COUNTY RE-1-J,2058,CROWLEY COUNTY HIGH SCHOOL,11TH,0,0,0,14,28,42,14,33%
0770,CROWLEY COUNTY RE-1-J,2058,CROWLEY COUNTY HIGH SCHOOL,12TH,1,0,1,13,18,33,15,45%
0770,CROWLEY COUNTY RE-1-J,2058,CROWLEY COUNTY HIGH SCHOOL,SCHOOL TOTAL,1,0,2,52,104,159,55,35%
0770,CROWLEY COUNTY RE-1-J,,DISTRICT TOTAL,,3,2,7,168,315,495,180,36%
0860,CUSTER COUNTY SCHOOL DISTRICT C-1,2088,CUSTER COUNTY ELEMENTARY SCHOOL,PK,1,0,0,0,31,32,1,3%
0860,CUSTER COUNTY SCHOOL DISTRICT C-1,2088,CUSTER COUNTY ELEMENTARY SCHOOL,HALF DAY K,0,0,0,0,23,23,0,0%
0860,CUSTER COUNTY SCHOOL DISTRICT C-1,2088,CUSTER COUNTY ELEMENTARY SCHOOL,1ST,0,0,0,1,26,27,1,4%
0860,CUSTER COUNTY SCHOOL DISTRICT C-1,2088,CUSTER COUNTY ELEMENTARY SCHOOL,2ND,1,1,0,0,23,25,2,8%
0860,CUSTER COUNTY SCHOOL DISTRICT C-1,2088,CUSTER COUNTY ELEMENTARY SCHOOL,3RD,0,1,0,0,22,23,1,4%
0860,CUSTER COUNTY SCHOOL DISTRICT C-1,2088,CUSTER COUNTY ELEMENTARY SCHOOL,4TH,2,1,1,0,29,33,4,12%
0860,CUSTER COUNTY SCHOOL DISTRICT C-1,2088,CUSTER COUNTY ELEMENTARY SCHOOL,5TH,0,0,0,0,35,35,0,0%
0860,CUSTER COUNTY SCHOOL DISTRICT C-1,2088,CUSTER COUNTY ELEMENTARY SCHOOL,SCHOOL TOTAL,4,3,1,1,189,198,9,5%
0860,CUSTER COUNTY SCHOOL DISTRICT C-1,2091,CUSTER MIDDLE SCHOOL,6TH,0,0,0,1,33,34,1,3%
0860,CUSTER COUNTY SCHOOL DISTRICT C-1,2091,CUSTER MIDDLE SCHOOL,7TH,0,0,0,1,38,39,1,3%
0860,CUSTER COUNTY SCHOOL DISTRICT C-1,2091,CUSTER MIDDLE SCHOOL,8TH,1,0,1,1,37,40,3,8%
0860,CUSTER COUNTY SCHOOL DISTRICT C-1,2091,CUSTER MIDDLE SCHOOL,SCHOOL TOTAL,1,0,1,3,108,113,5,4%
0860,CUSTER COUNTY SCHOOL DISTRICT C-1,2092,CUSTER COUNTY HIGH SCHOOL,9TH,2,1,1,2,40,46,6,13%
0860,CUSTER COUNTY SCHOOL DISTRICT C-1,2092,CUSTER COUNTY HIGH SCHOOL,10TH,1,0,2,0,36,39,3,8%
0860,CUSTER COUNTY SCHOOL DISTRICT C-1,2092,CUSTER COUNTY HIGH SCHOOL,11TH,0,0,1,0,42,43,1,2%
0860,CUSTER COUNTY SCHOOL DISTRICT C-1,2092,CUSTER COUNTY HIGH SCHOOL,12TH,0,0,0,0,50,50,0,0%
0860,CUSTER COUNTY SCHOOL DISTRICT C-1,2092,CUSTER COUNTY HIGH SCHOOL,SCHOOL TOTAL,3,1,4,2,168,178,10,6%
0860,CUSTER COUNTY SCHOOL DISTRICT C-1,,DISTRICT TOTAL,,8,4,6,6,465,489,24,5%
0870,DELTA COUNTY 50(J),0489,BACKPACK EARLY LEARNING ACADEMY,PK,0,1,3,52,110,166,56,34%
0870,DELTA COUNTY 50(J),0489,BACKPACK EARLY LEARNING ACADEMY,SCHOOL TOTAL,0,1,3,52,110,166,56,34%
0870,DELTA COUNTY 50(J),1372,CEDAREDGE HIGH SCHOOL,9TH,2,0,0,3,67,72,5,7%
0870,DELTA COUNTY 50(J),1372,CEDAREDGE HIGH SCHOOL,10TH,1,0,0,9,73,83,10,12%
0870,DELTA COUNTY 50(J),1372,CEDAREDGE HIGH SCHOOL,11TH,0,2,0,4,60,66,6,9%
0870,DELTA COUNTY 50(J),1372,CEDAREDGE HIGH SCHOOL,12TH,1,0,0,10,49,60,11,18%
0870,DELTA COUNTY 50(J),1372,CEDAREDGE HIGH SCHOOL,SCHOOL TOTAL,4,2,0,26,249,281,32,11%
0870,DELTA COUNTY 50(J),1375,CEDAREDGE MIDDLE SCHOOL,6TH,0,1,0,5,69,75,6,8%
0870,DELTA COUNTY 50(J),1375,CEDAREDGE MIDDLE SCHOOL,7TH,1,0,0,4,62,67,5,7%
0870,DELTA COUNTY 50(J),1375,CEDAREDGE MIDDLE SCHOOL,8TH,1,0,0,7,64,72,8,11%
0870,DELTA COUNTY 50(J),1375,CEDAREDGE MIDDLE SCHOOL,SCHOOL TOTAL,2,1,0,16,195,214,19,9%
0870,DELTA COUNTY 50(J),1952,CRAWFORD ELEMENTARY SCHOOL,PK,0,0,1,1,14,16,2,13%
0870,DELTA COUNTY 50(J),1952,CRAWFORD ELEMENTARY SCHOOL,KINDERGARTEN,0,0,0,0,16,16,0,0%
0870,DELTA COUNTY 50(J),1952,CRAWFORD ELEMENTARY SCHOOL,1ST,0,0,1,0,10,11,1,9%
0870,DELTA COUNTY 50(J),1952,CRAWFORD ELEMENTARY SCHOOL,2ND,0,0,0,0,16,16,0,0%
0870,DELTA COUNTY 50(J),1952,CRAWFORD ELEMENTARY SCHOOL,3RD,0,0,0,1,12,13,1,8%
0870,DELTA COUNTY 50(J),1952,CRAWFORD ELEMENTARY SCHOOL,4TH,0,0,1,0,17,18,1,6%
0870,DELTA COUNTY 50(J),1952,CRAWFORD ELEMENTARY SCHOOL,5TH,0,0,0,0,13,13,0,0%
0870,DELTA COUNTY 50(J),1952,CRAWFORD ELEMENTARY SCHOOL,6TH,0,0,0,0,7,7,0,0%
0870,DELTA COUNTY 50(J),1952,CRAWFORD ELEMENTARY SCHOOL,7TH,1,0,0,1,17,19,2,11%
0870,DELTA COUNTY 50(J),1952,CRAWFORD ELEMENTARY SCHOOL,8TH,0,0,0,1,13,14,1,7%
0870,DELTA COUNTY 50(J),1952,CRAWFORD ELEMENTARY SCHOOL,SCHOOL TOTAL,1,0,3,4,135,143,8,6%
0870,DELTA COUNTY 50(J),2152,DELTA ACADEMY OF APPLIED LEARNING,6TH,0,0,1,2,3,6,3,50%
0870,DELTA COUNTY 50(J),2152,DELTA ACADEMY OF APPLIED LEARNING,7TH,0,0,0,1,11,12,1,8%
0870,DELTA COUNTY 50(J),2152,DELTA ACADEMY OF APPLIED LEARNING,8TH,0,0,0,1,7,8,1,13%
0870,DELTA COUNTY 50(J),2152,DELTA ACADEMY OF APPLIED LEARNING,SCHOOL TOTAL,0,0,1,4,21,26,5,19%
0870,DELTA COUNTY 50(J),2155,DELTA COUNTY OPPORTUNITY SCHOOL,8TH,0,0,0,1,3,4,1,25%
0870,DELTA COUNTY 50(J),2155,DELTA COUNTY OPPORTUNITY SCHOOL,9TH,0,0,0,1,3,4,1,25%
0870,DELTA COUNTY 50(J),2155,DELTA COUNTY OPPORTUNITY SCHOOL,10TH,0,0,0,7,10,17,7,41%
0870,DELTA COUNTY 50(J),2155,DELTA COUNTY OPPORTUNITY SCHOOL,11TH,0,0,0,11,13,24,11,46%
0870,DELTA COUNTY 50(J),2155,DELTA COUNTY OPPORTUNITY SCHOOL,12TH,1,0,0,11,35,47,12,26%
0870,DELTA COUNTY 50(J),2155,DELTA COUNTY OPPORTUNITY SCHOOL,SCHOOL TOTAL,1,0,0,31,64,96,32,33%
0870,DELTA COUNTY 50(J),2160,DELTA MIDDLE SCHOOL,6TH,3,1,1,55,97,157,60,38%
0870,DELTA COUNTY 50(J),2160,DELTA MIDDLE SCHOOL,7TH,1,2,2,52,104,161,57,35%
0870,DELTA COUNTY 50(J),2160,DELTA MIDDLE SCHOOL,8TH,2,0,0,49,113,164,51,31%
0870,DELTA COUNTY 50(J),2160,DELTA MIDDLE SCHOOL,SCHOOL TOTAL,6,3,3,156,314,482,168,35%
0870,DELTA COUNTY 50(J),2164,DELTA HIGH SCHOOL,9TH,3,1,3,44,117,168,51,30%
0870,DELTA COUNTY 50(J),2164,DELTA HIGH SCHOOL,10TH,2,1,5,62,113,183,70,38%
0870,DELTA COUNTY 50(J),2164,DELTA HIGH SCHOOL,11TH,1,1,5,49,114,170,56,33%
0870,DELTA COUNTY 50(J),2164,DELTA HIGH SCHOOL,12TH,1,0,0,36,127,164,37,23%
0870,DELTA COUNTY 50(J),2164,DELTA HIGH SCHOOL,SCHOOL TOTAL,7,3,13,191,471,685,214,31%
0870,DELTA COUNTY 50(J),2166,DELTA VISION SCHOOL,HALF DAY K,0,0,0,0,8,8,0,0%
0870,DELTA COUNTY 50(J),2166,DELTA VISION SCHOOL,1ST,0,0,0,3,11,14,3,21%
0870,DELTA COUNTY 50(J),2166,DELTA VISION SCHOOL,2ND,0,0,0,0,13,13,0,0%
0870,DELTA COUNTY 50(J),2166,DELTA VISION SCHOOL,3RD,0,1,0,0,7,8,1,13%
0870,DELTA COUNTY 50(J),2166,DELTA VISION SCHOOL,4TH,0,0,0,0,17,17,0,0%
0870,DELTA COUNTY 50(J),2166,DELTA VISION SCHOOL,5TH,0,2,0,0,13,15,2,13%
0870,DELTA COUNTY 50(J),2166,DELTA VISION SCHOOL,6TH,0,0,2,0,20,22,2,9%
0870,DELTA COUNTY 50(J),2166,DELTA VISION SCHOOL,7TH,0,1,0,1,26,28,2,7%
0870,DELTA COUNTY 50(J),2166,DELTA VISION SCHOOL,8TH,0,0,1,1,19,21,2,10%
0870,DELTA COUNTY 50(J),2166,DELTA VISION SCHOOL,9TH,0,0,1,4,20,25,5,20%
0870,DELTA COUNTY 50(J),2166,DELTA VISION SCHOOL,10TH,1,0,0,3,28,32,4,13%
0870,DELTA COUNTY 50(J),2166,DELTA VISION SCHOOL,11TH,0,0,0,1,26,27,1,4%
0870,DELTA COUNTY 50(J),2166,DELTA VISION SCHOOL,12TH,0,0,0,0,30,30,0,0%
0870,DELTA COUNTY 50(J),2166,DELTA VISION SCHOOL,SCHOOL TOTAL,1,4,4,13,238,260,22,8%
0870,DELTA COUNTY 50(J),3330,GARNET MESA ELEMENTARY SCHOOL,KINDERGARTEN,0,0,0,32,66,98,32,33%
0870,DELTA COUNTY 50(J),3330,GARNET MESA ELEMENTARY SCHOOL,1ST,0,1,0,27,59,87,28,32%
0870,DELTA COUNTY 50(J),3330,GARNET MESA ELEMENTARY SCHOOL,2ND,0,0,0,30,62,92,30,33%
0870,DELTA COUNTY 50(J),3330,GARNET MESA ELEMENTARY SCHOOL,3RD,1,0,0,21,70,92,22,24%
0870,DELTA COUNTY 50(J),3330,GARNET MESA ELEMENTARY SCHOOL,4TH,0,2,0,13,62,77,15,19%
0870,DELTA COUNTY 50(J),3330,GARNET MESA ELEMENTARY SCHOOL,5TH,0,2,0,29,53,84,31,37%
0870,DELTA COUNTY 50(J),3330,GARNET MESA ELEMENTARY SCHOOL,SCHOOL TOTAL,1,5,0,152,372,530,158,30%
0870,DELTA COUNTY 50(J),4124,HOTCHKISS ELEMENTARY SCHOOL,PK,0,0,0,5,21,26,5,19%
0870,DELTA COUNTY 50(J),4124,HOTCHKISS ELEMENTARY SCHOOL,KINDERGARTEN,1,0,1,10,31,43,12,28%
0870,DELTA COUNTY 50(J),4124,HOTCHKISS ELEMENTARY SCHOOL,1ST,0,1,0,8,37,46,9,20%
0870,DELTA COUNTY 50(J),4124,HOTCHKISS ELEMENTARY SCHOOL,2ND,1,0,0,5,23,29,6,21%
0870,DELTA COUNTY 50(J),4124,HOTCHKISS ELEMENTARY SCHOOL,3RD,0,0,0,9,32,41,9,22%
0870,DELTA COUNTY 50(J),4124,HOTCHKISS ELEMENTARY SCHOOL,4TH,0,0,1,6,27,34,7,21%
0870,DELTA COUNTY 50(J),4124,HOTCHKISS ELEMENTARY SCHOOL,5TH,1,0,1,8,26,36,10,28%
0870,DELTA COUNTY 50(J),4124,HOTCHKISS ELEMENTARY SCHOOL,6TH,0,0,0,8,37,45,8,18%
0870,DELTA COUNTY 50(J),4124,HOTCHKISS ELEMENTARY SCHOOL,7TH,0,0,0,3,47,50,3,6%
0870,DELTA COUNTY 50(J),4124,HOTCHKISS ELEMENTARY SCHOOL,8TH,0,2,2,8,42,54,12,22%
0870,DELTA COUNTY 50(J),4124,HOTCHKISS ELEMENTARY SCHOOL,SCHOOL TOTAL,3,3,5,70,323,404,81,20%
0870,DELTA COUNTY 50(J),4128,HOTCHKISS HIGH SCHOOL,9TH,0,2,0,9,60,71,11,15%
0870,DELTA COUNTY 50(J),4128,HOTCHKISS HIGH SCHOOL,10TH,1,2,0,9,62,74,12,16%
0870,DELTA COUNTY 50(J),4128,HOTCHKISS HIGH SCHOOL,11TH,0,0,1,7,57,65,8,12%
0870,DELTA COUNTY 50(J),4128,HOTCHKISS HIGH SCHOOL,12TH,0,2,0,7,51,60,9,15%
0870,DELTA COUNTY 50(J),4128,HOTCHKISS HIGH SCHOOL,SCHOOL TOTAL,1,6,1,32,230,270,40,15%
0870,DELTA COUNTY 50(J),4182,CEDAREDGE ELEMENTARY SCHOOL,KINDERGARTEN,0,0,1,2,67,70,3,4%
0870,DELTA COUNTY 50(J),4182,CEDAREDGE ELEMENTARY SCHOOL,1ST,3,1,1,8,59,72,13,18%
0870,DELTA COUNTY 50(J),4182,CEDAREDGE ELEMENTARY SCHOOL,2ND,0,1,0,5,63,69,6,9%
0870,DELTA COUNTY 50(J),4182,CEDAREDGE ELEMENTARY SCHOOL,3RD,0,0,0,2,60,62,2,3%
0870,DELTA COUNTY 50(J),4182,CEDAREDGE ELEMENTARY SCHOOL,4TH,0,0,0,2,70,72,2,3%
0870,DELTA COUNTY 50(J),4182,CEDAREDGE ELEMENTARY SCHOOL,5TH,1,0,0,3,73,77,4,5%
0870,DELTA COUNTY 50(J),4182,CEDAREDGE ELEMENTARY SCHOOL,SCHOOL TOTAL,4,2,2,22,392,422,30,7%
0870,DELTA COUNTY 50(J),4965,LAMBORN VISION SCHOOL,1ST,0,0,0,0,5,5,0,0%
0870,DELTA COUNTY 50(J),4965,LAMBORN VISION SCHOOL,2ND,0,0,0,0,8,8,0,0%
0870,DELTA COUNTY 50(J),4965,LAMBORN VISION SCHOOL,3RD,0,0,0,0,3,3,0,0%
0870,DELTA COUNTY 50(J),4965,LAMBORN VISION SCHOOL,5TH,0,0,0,0,1,1,0,0%
0870,DELTA COUNTY 50(J),4965,LAMBORN VISION SCHOOL,7TH,0,0,0,3,2,5,3,60%
0870,DELTA COUNTY 50(J),4965,LAMBORN VISION SCHOOL,8TH,0,0,0,0,3,3,0,0%
0870,DELTA COUNTY 50(J),4965,LAMBORN VISION SCHOOL,9TH,1,0,0,0,1,2,1,50%
0870,DELTA COUNTY 50(J),4965,LAMBORN VISION SCHOOL,10TH,0,0,0,0,3,3,0,0%
0870,DELTA COUNTY 50(J),4965,LAMBORN VISION SCHOOL,11TH,0,0,0,0,2,2,0,0%
0870,DELTA COUNTY 50(J),4965,LAMBORN VISION SCHOOL,12TH,0,0,0,0,4,4,0,0%
0870,DELTA COUNTY 50(J),4965,LAMBORN VISION SCHOOL,SCHOOL TOTAL,1,0,0,3,32,36,4,11%
0870,DELTA COUNTY 50(J),5154,LINCOLN ELEMENTARY SCHOOL,KINDERGARTEN,0,0,0,29,58,87,29,33%
0870,DELTA COUNTY 50(J),5154,LINCOLN ELEMENTARY SCHOOL,1ST,0,0,1,30,62,93,31,33%
0870,DELTA COUNTY 50(J),5154,LINCOLN ELEMENTARY SCHOOL,2ND,0,1,0,27,62,90,28,31%
0870,DELTA COUNTY 50(J),5154,LINCOLN ELEMENTARY SCHOOL,3RD,1,1,0,20,65,87,22,25%
0870,DELTA COUNTY 50(J),5154,LINCOLN ELEMENTARY SCHOOL,4TH,1,0,0,24,56,81,25,31%
0870,DELTA COUNTY 50(J),5154,LINCOLN ELEMENTARY SCHOOL,5TH,1,2,0,25,59,87,28,32%
0870,DELTA COUNTY 50(J),5154,LINCOLN ELEMENTARY SCHOOL,SCHOOL TOTAL,3,4,1,155,362,525,163,31%
0870,DELTA COUNTY 50(J),6298,NORTH FORK MONTESSORI SCHOOL,PK,0,0,0,2,14,16,2,13%
0870,DELTA COUNTY 50(J),6298,NORTH FORK MONTESSORI SCHOOL,KINDERGARTEN,0,1,0,1,6,8,2,25%
0870,DELTA COUNTY 50(J),6298,NORTH FORK MONTESSORI SCHOOL,1ST,0,1,0,0,7,8,1,13%
0870,DELTA COUNTY 50(J),6298,NORTH FORK MONTESSORI SCHOOL,2ND,0,0,0,0,10,10,0,0%
0870,DELTA COUNTY 50(J),6298,NORTH FORK MONTESSORI SCHOOL,3RD,0,1,0,0,9,10,1,10%
0870,DELTA COUNTY 50(J),6298,NORTH FORK MONTESSORI SCHOOL,4TH,0,1,0,2,5,8,3,38%
0870,DELTA COUNTY 50(J),6298,NORTH FORK MONTESSORI SCHOOL,5TH,0,0,1,0,7,8,1,13%
0870,DELTA COUNTY 50(J),6298,NORTH FORK MONTESSORI SCHOOL,6TH,0,0,1,1,7,9,2,22%
0870,DELTA COUNTY 50(J),6298,NORTH FORK MONTESSORI SCHOOL,SCHOOL TOTAL,0,4,2,6,65,77,12,16%
0870,DELTA COUNTY 50(J),6700,PAONIA ELEMENTARY SCHOOL,KINDERGARTEN,2,0,1,6,16,25,9,36%
0870,DELTA COUNTY 50(J),6700,PAONIA ELEMENTARY SCHOOL,1ST,0,0,2,5,27,34,7,21%
0870,DELTA COUNTY 50(J),6700,PAONIA ELEMENTARY SCHOOL,2ND,0,0,0,2,23,25,2,8%
0870,DELTA COUNTY 50(J),6700,PAONIA ELEMENTARY SCHOOL,3RD,0,0,0,3,28,31,3,10%
0870,DELTA COUNTY 50(J),6700,PAONIA ELEMENTARY SCHOOL,4TH,0,0,0,4,28,32,4,13%
0870,DELTA COUNTY 50(J),6700,PAONIA ELEMENTARY SCHOOL,5TH,0,0,0,5,37,42,5,12%
0870,DELTA COUNTY 50(J),6700,PAONIA ELEMENTARY SCHOOL,6TH,0,0,0,2,39,41,2,5%
0870,DELTA COUNTY 50(J),6700,PAONIA ELEMENTARY SCHOOL,SCHOOL TOTAL,2,0,3,27,198,230,32,14%
0870,DELTA COUNTY 50(J),6708,PAONIA HIGH SCHOOL,7TH,0,2,0,2,42,46,4,9%
0870,DELTA COUNTY 50(J),6708,PAONIA HIGH SCHOOL,8TH,0,0,0,2,36,38,2,5%
0870,DELTA COUNTY 50(J),6708,PAONIA HIGH SCHOOL,9TH,0,0,0,4,33,37,4,11%
0870,DELTA COUNTY 50(J),6708,PAONIA HIGH SCHOOL,10TH,1,0,0,4,35,40,5,13%
0870,DELTA COUNTY 50(J),6708,PAONIA HIGH SCHOOL,11TH,1,0,1,2,28,32,4,13%
0870,DELTA COUNTY 50(J),6708,PAONIA HIGH SCHOOL,12TH,0,0,1,3,43,47,4,9%
0870,DELTA COUNTY 50(J),6708,PAONIA HIGH SCHOOL,SCHOOL TOTAL,2,2,2,17,217,240,23,10%
0870,DELTA COUNTY 50(J),8419,SURFACE CREEK VISION SCHOOL,HALF DAY K,0,0,0,0,7,7,0,0%
0870,DELTA COUNTY 50(J),8419,SURFACE CREEK VISION SCHOOL,KINDERGARTEN,0,0,0,0,4,4,0,0%
0870,DELTA COUNTY 50(J),8419,SURFACE CREEK VISION SCHOOL,1ST,0,0,0,1,12,13,1,8%
0870,DELTA COUNTY 50(J),8419,SURFACE CREEK VISION SCHOOL,2ND,0,0,0,0,10,10,0,0%
0870,DELTA COUNTY 50(J),8419,SURFACE CREEK VISION SCHOOL,3RD,0,0,0,0,6,6,0,0%
0870,DELTA COUNTY 50(J),8419,SURFACE CREEK VISION SCHOOL,4TH,0,0,0,0,15,15,0,0%
0870,DELTA COUNTY 50(J),8419,SURFACE CREEK VISION SCHOOL,5TH,0,0,0,0,12,12,0,0%
0870,DELTA COUNTY 50(J),8419,SURFACE CREEK VISION SCHOOL,6TH,0,0,0,1,14,15,1,7%
0870,DELTA COUNTY 50(J),8419,SURFACE CREEK VISION SCHOOL,7TH,0,0,0,0,16,16,0,0%
0870,DELTA COUNTY 50(J),8419,SURFACE CREEK VISION SCHOOL,8TH,0,0,0,2,14,16,2,13%
0870,DELTA COUNTY 50(J),8419,SURFACE CREEK VISION SCHOOL,9TH,0,0,0,1,15,16,1,6%
0870,DELTA COUNTY 50(J),8419,SURFACE CREEK VISION SCHOOL,10TH,0,0,0,1,20,21,1,5%
0870,DELTA COUNTY 50(J),8419,SURFACE CREEK VISION SCHOOL,11TH,0,0,0,1,24,25,1,4%
0870,DELTA COUNTY 50(J),8419,SURFACE CREEK VISION SCHOOL,12TH,0,0,0,2,13,15,2,13%
0870,DELTA COUNTY 50(J),8419,SURFACE CREEK VISION SCHOOL,SCHOOL TOTAL,0,0,0,9,182,191,9,5%
0870,DELTA COUNTY 50(J),9146,NORTH FORK VISION SCHOOL,KINDERGARTEN,0,0,0,0,3,3,0,0%
0870,DELTA COUNTY 50(J),9146,NORTH FORK VISION SCHOOL,1ST,0,0,0,0,2,2,0,0%
0870,DELTA COUNTY 50(J),9146,NORTH FORK VISION SCHOOL,2ND,0,0,0,0,1,1,0,0%
0870,DELTA COUNTY 50(J),9146,NORTH FORK VISION SCHOOL,3RD,0,0,0,0,2,2,0,0%
0870,DELTA COUNTY 50(J),9146,NORTH FORK VISION SCHOOL,4TH,0,0,0,0,6,6,0,0%
0870,DELTA COUNTY 50(J),9146,NORTH FORK VISION SCHOOL,5TH,0,0,0,0,2,2,0,0%
0870,DELTA COUNTY 50(J),9146,NORTH FORK VISION SCHOOL,6TH,0,0,0,0,3,3,0,0%
0870,DELTA COUNTY 50(J),9146,NORTH FORK VISION SCHOOL,7TH,0,0,0,0,5,5,0,0%
0870,DELTA COUNTY 50(J),9146,NORTH FORK VISION SCHOOL,8TH,1,0,0,0,7,8,1,13%
0870,DELTA COUNTY 50(J),9146,NORTH FORK VISION SCHOOL,9TH,0,0,0,1,5,6,1,17%
0870,DELTA COUNTY 50(J),9146,NORTH FORK VISION SCHOOL,10TH,0,0,0,0,6,6,0,0%
0870,DELTA COUNTY 50(J),9146,NORTH FORK VISION SCHOOL,11TH,0,0,0,0,7,7,0,0%
0870,DELTA COUNTY 50(J),9146,NORTH FORK VISION SCHOOL,12TH,0,0,0,0,8,8,0,0%
0870,DELTA COUNTY 50(J),9146,NORTH FORK VISION SCHOOL,SCHOOL TOTAL,1,0,0,1,57,59,2,3%
0870,DELTA COUNTY 50(J),,DISTRICT TOTAL,,40,40,43,987,4227,5337,1110,21%
0880,DENVER COUNTY 1,0010,ABRAHAM LINCOLN HIGH SCHOOL,9TH,5,14,10,588,27,644,617,96%
0880,DENVER COUNTY 1,0010,ABRAHAM LINCOLN HIGH SCHOOL,10TH,10,14,8,443,20,495,475,96%
0880,DENVER COUNTY 1,0010,ABRAHAM LINCOLN HIGH SCHOOL,11TH,5,9,4,361,18,397,379,95%
0880,DENVER COUNTY 1,0010,ABRAHAM LINCOLN HIGH SCHOOL,12TH,4,11,10,322,16,363,347,96%
0880,DENVER COUNTY 1,0010,ABRAHAM LINCOLN HIGH SCHOOL,SCHOOL TOTAL,24,48,32,1714,81,1899,1818,96%
0880,DENVER COUNTY 1,0040,RIDGE VIEW ACADEMY CHARTER SCHOOL,9TH,3,0,22,41,35,101,66,65%
0880,DENVER COUNTY 1,0040,RIDGE VIEW ACADEMY CHARTER SCHOOL,10TH,2,2,28,48,40,120,80,67%
0880,DENVER COUNTY 1,0040,RIDGE VIEW ACADEMY CHARTER SCHOOL,11TH,3,0,15,30,22,70,48,69%
0880,DENVER COUNTY 1,0040,RIDGE VIEW ACADEMY CHARTER SCHOOL,12TH,4,0,19,33,34,90,56,62%
0880,DENVER COUNTY 1,0040,RIDGE VIEW ACADEMY CHARTER SCHOOL,SCHOOL TOTAL,12,2,84,152,131,381,250,66%
0880,DENVER COUNTY 1,0067,ACADEMY OF URBAN LEARNING,10TH,0,0,5,9,2,16,14,88%
0880,DENVER COUNTY 1,0067,ACADEMY OF URBAN LEARNING,11TH,2,0,17,13,5,37,32,86%
0880,DENVER COUNTY 1,0067,ACADEMY OF URBAN LEARNING,12TH,0,0,30,9,8,47,39,83%
0880,DENVER COUNTY 1,0067,ACADEMY OF URBAN LEARNING,SCHOOL TOTAL,2,0,52,31,15,100,85,85%
0880,DENVER COUNTY 1,0133,EMERSON STREET SCHOOL,7TH,0,0,2,0,0,2,2,100%
0880,DENVER COUNTY 1,0133,EMERSON STREET SCHOOL,8TH,0,0,1,8,0,9,9,100%
0880,DENVER COUNTY 1,0133,EMERSON STREET SCHOOL,9TH,3,1,8,16,0,28,28,100%
0880,DENVER COUNTY 1,0133,EMERSON STREET SCHOOL,10TH,0,0,5,0,3,8,5,63%
0880,DENVER COUNTY 1,0133,EMERSON STREET SCHOOL,SCHOOL TOTAL,3,1,16,24,3,47,44,94%
0880,DENVER COUNTY 1,0220,AMESSE ELEMENTARY SCHOOL,PK,0,0,12,44,13,69,56,81%
0880,DENVER COUNTY 1,0220,AMESSE ELEMENTARY SCHOOL,KINDERGARTEN,0,0,19,61,12,92,80,87%
0880,DENVER COUNTY 1,0220,AMESSE ELEMENTARY SCHOOL,1ST,0,1,25,63,11,100,89,89%
0880,DENVER COUNTY 1,0220,AMESSE ELEMENTARY SCHOOL,2ND,0,0,23,60,5,88,83,94%
0880,DENVER COUNTY 1,0220,AMESSE ELEMENTARY SCHOOL,3RD,2,0,20,66,9,97,88,91%
0880,DENVER COUNTY 1,0220,AMESSE ELEMENTARY SCHOOL,4TH,0,0,22,64,7,93,86,92%
0880,DENVER COUNTY 1,0220,AMESSE ELEMENTARY SCHOOL,5TH,0,1,24,58,3,86,83,97%
0880,DENVER COUNTY 1,0220,AMESSE ELEMENTARY SCHOOL,SCHOOL TOTAL,2,2,145,416,60,625,565,90%
0880,DENVER COUNTY 1,0388,ASBURY ELEMENTARY SCHOOL,PK,0,3,3,5,36,47,11,23%
0880,DENVER COUNTY 1,0388,ASBURY ELEMENTARY SCHOOL,KINDERGARTEN,1,1,6,11,37,56,19,34%
0880,DENVER COUNTY 1,0388,ASBURY ELEMENTARY SCHOOL,1ST,1,2,6,13,31,53,22,42%
0880,DENVER COUNTY 1,0388,ASBURY ELEMENTARY SCHOOL,2ND,0,4,6,18,26,54,28,52%
0880,DENVER COUNTY 1,0388,ASBURY ELEMENTARY SCHOOL,3RD,2,2,5,19,21,49,28,57%
0880,DENVER COUNTY 1,0388,ASBURY ELEMENTARY SCHOOL,4TH,0,5,4,18,27,54,27,50%
0880,DENVER COUNTY 1,0388,ASBURY ELEMENTARY SCHOOL,5TH,1,0,1,17,23,42,19,45%
0880,DENVER COUNTY 1,0388,ASBURY ELEMENTARY SCHOOL,SCHOOL TOTAL,5,17,31,101,201,355,154,43%
0880,DENVER COUNTY 1,0408,VALDEZ ELEMENTARY SCHOOL,PK,1,0,1,37,48,87,39,45%
0880,DENVER COUNTY 1,0408,VALDEZ ELEMENTARY SCHOOL,KINDERGARTEN,0,0,0,28,21,49,28,57%
0880,DENVER COUNTY 1,0408,VALDEZ ELEMENTARY SCHOOL,1ST,0,0,0,33,6,39,33,85%
0880,DENVER COUNTY 1,0408,VALDEZ ELEMENTARY SCHOOL,2ND,0,0,0,31,12,43,31,72%
0880,DENVER COUNTY 1,0408,VALDEZ ELEMENTARY SCHOOL,3RD,2,1,2,35,7,47,40,85%
0880,DENVER COUNTY 1,0408,VALDEZ ELEMENTARY SCHOOL,4TH,0,0,0,44,2,46,44,96%
0880,DENVER COUNTY 1,0408,VALDEZ ELEMENTARY SCHOOL,5TH,0,0,2,29,1,32,31,97%
0880,DENVER COUNTY 1,0408,VALDEZ ELEMENTARY SCHOOL,6TH,1,0,1,17,0,19,19,100%
0880,DENVER COUNTY 1,0408,VALDEZ ELEMENTARY SCHOOL,7TH,1,0,0,25,1,27,26,96%
0880,DENVER COUNTY 1,0408,VALDEZ ELEMENTARY SCHOOL,SCHOOL TOTAL,5,1,6,279,98,389,291,75%
0880,DENVER COUNTY 1,0418,ASHLEY ELEMENTARY SCHOOL,PK,0,0,9,27,2,38,36,95%
0880,DENVER COUNTY 1,0418,ASHLEY ELEMENTARY SCHOOL,KINDERGARTEN,0,0,8,33,11,52,41,79%
0880,DENVER COUNTY 1,0418,ASHLEY ELEMENTARY SCHOOL,1ST,0,0,15,43,5,63,58,92%
0880,DENVER COUNTY 1,0418,ASHLEY ELEMENTARY SCHOOL,2ND,0,0,16,36,4,56,52,93%
0880,DENVER COUNTY 1,0418,ASHLEY ELEMENTARY SCHOOL,3RD,0,1,16,33,2,52,50,96%
0880,DENVER COUNTY 1,0418,ASHLEY ELEMENTARY SCHOOL,4TH,1,0,10,38,1,50,49,98%
0880,DENVER COUNTY 1,0418,ASHLEY ELEMENTARY SCHOOL,5TH,0,0,14,30,3,47,44,94%
0880,DENVER COUNTY 1,0418,ASHLEY ELEMENTARY SCHOOL,SCHOOL TOTAL,1,1,88,240,28,358,330,92%
0880,DENVER COUNTY 1,0520,BARNUM ELEMENTARY SCHOOL,PK,0,0,0,32,0,32,32,100%
0880,DENVER COUNTY 1,0520,BARNUM ELEMENTARY SCHOOL,HALF DAY K,0,0,0,7,3,10,7,70%
0880,DENVER COUNTY 1,0520,BARNUM ELEMENTARY SCHOOL,KINDERGARTEN,1,1,1,55,7,65,58,89%
0880,DENVER COUNTY 1,0520,BARNUM ELEMENTARY SCHOOL,1ST,1,0,1,77,8,87,79,91%
0880,DENVER COUNTY 1,0520,BARNUM ELEMENTARY SCHOOL,2ND,0,0,0,56,9,65,56,86%
0880,DENVER COUNTY 1,0520,BARNUM ELEMENTARY SCHOOL,3RD,0,1,1,62,3,67,64,96%
0880,DENVER COUNTY 1,0520,BARNUM ELEMENTARY SCHOOL,4TH,0,0,0,69,6,75,69,92%
0880,DENVER COUNTY 1,0520,BARNUM ELEMENTARY SCHOOL,5TH,1,2,1,64,1,69,68,99%
0880,DENVER COUNTY 1,0520,BARNUM ELEMENTARY SCHOOL,SCHOOL TOTAL,3,4,4,422,37,470,433,92%
0880,DENVER COUNTY 1,0540,BARRETT ELEMENTARY SCHOOL,PK,0,0,10,16,4,30,26,87%
0880,DENVER COUNTY 1,0540,BARRETT ELEMENTARY SCHOOL,KINDERGARTEN,1,1,20,14,1,37,36,97%
0880,DENVER COUNTY 1,0540,BARRETT ELEMENTARY SCHOOL,1ST,0,0,18,17,1,36,35,97%
0880,DENVER COUNTY 1,0540,BARRETT ELEMENTARY SCHOOL,2ND,1,0,13,19,1,34,33,97%
0880,DENVER COUNTY 1,0540,BARRETT ELEMENTARY SCHOOL,3RD,0,1,11,15,1,28,27,96%
0880,DENVER COUNTY 1,0540,BARRETT ELEMENTARY SCHOOL,4TH,0,0,15,11,1,27,26,96%
0880,DENVER COUNTY 1,0540,BARRETT ELEMENTARY SCHOOL,5TH,1,0,23,10,0,34,34,100%
0880,DENVER COUNTY 1,0540,BARRETT ELEMENTARY SCHOOL,SCHOOL TOTAL,3,2,110,102,9,226,217,96%
0880,DENVER COUNTY 1,0650,BEACH COURT ELEMENTARY SCHOOL,PK,0,0,0,26,6,32,26,81%
0880,DENVER COUNTY 1,0650,BEACH COURT ELEMENTARY SCHOOL,KINDERGARTEN,1,0,1,38,5,45,40,89%
0880,DENVER COUNTY 1,0650,BEACH COURT ELEMENTARY SCHOOL,1ST,0,0,1,40,5,46,41,89%
0880,DENVER COUNTY 1,0650,BEACH COURT ELEMENTARY SCHOOL,2ND,0,0,0,51,4,55,51,93%
0880,DENVER COUNTY 1,0650,BEACH COURT ELEMENTARY SCHOOL,3RD,0,0,1,45,5,51,46,90%
0880,DENVER COUNTY 1,0650,BEACH COURT ELEMENTARY SCHOOL,4TH,0,0,2,34,3,39,36,92%
0880,DENVER COUNTY 1,0650,BEACH COURT ELEMENTARY SCHOOL,5TH,0,0,2,42,2,46,44,96%
0880,DENVER COUNTY 1,0650,BEACH COURT ELEMENTARY SCHOOL,SCHOOL TOTAL,1,0,7,276,30,314,284,90%
0880,DENVER COUNTY 1,0964,BRADLEY ELEMENTARY SCHOOL,PK,0,7,6,27,56,96,40,42%
0880,DENVER COUNTY 1,0964,BRADLEY ELEMENTARY SCHOOL,HALF DAY K,0,1,4,10,12,27,15,56%
0880,DENVER COUNTY 1,0964,BRADLEY ELEMENTARY SCHOOL,KINDERGARTEN,0,2,7,5,46,60,14,23%
0880,DENVER COUNTY 1,0964,BRADLEY ELEMENTARY SCHOOL,1ST,2,1,14,17,46,80,34,43%
0880,DENVER COUNTY 1,0964,BRADLEY ELEMENTARY SCHOOL,2ND,0,1,9,24,36,70,34,49%
0880,DENVER COUNTY 1,0964,BRADLEY ELEMENTARY SCHOOL,3RD,1,2,11,19,31,64,33,52%
0880,DENVER COUNTY 1,0964,BRADLEY ELEMENTARY SCHOOL,4TH,2,0,11,15,29,57,28,49%
0880,DENVER COUNTY 1,0964,BRADLEY ELEMENTARY SCHOOL,5TH,1,2,2,15,29,49,20,41%
0880,DENVER COUNTY 1,0964,BRADLEY ELEMENTARY SCHOOL,SCHOOL TOTAL,6,16,64,132,285,503,218,43%
0880,DENVER COUNTY 1,1056,BROMWELL ELEMENTARY SCHOOL,HALF DAY K,0,0,0,0,1,1,0,0%
0880,DENVER COUNTY 1,1056,BROMWELL ELEMENTARY SCHOOL,KINDERGARTEN,0,1,0,3,46,50,4,8%
0880,DENVER COUNTY 1,1056,BROMWELL ELEMENTARY SCHOOL,1ST,1,1,4,5,44,55,11,20%
0880,DENVER COUNTY 1,1056,BROMWELL ELEMENTARY SCHOOL,2ND,0,3,0,6,44,53,9,17%
0880,DENVER COUNTY 1,1056,BROMWELL ELEMENTARY SCHOOL,3RD,0,3,1,2,47,53,6,11%
0880,DENVER COUNTY 1,1056,BROMWELL ELEMENTARY SCHOOL,4TH,1,4,2,4,41,52,11,21%
0880,DENVER COUNTY 1,1056,BROMWELL ELEMENTARY SCHOOL,5TH,0,4,1,3,45,53,8,15%
0880,DENVER COUNTY 1,1056,BROMWELL ELEMENTARY SCHOOL,SCHOOL TOTAL,2,16,8,23,268,317,49,15%
0880,DENVER COUNTY 1,1076,BROWN ELEMENTARY SCHOOL,PK,0,1,2,7,26,36,10,28%
0880,DENVER COUNTY 1,1076,BROWN ELEMENTARY SCHOOL,HALF DAY K,1,0,1,5,8,15,7,47%
0880,DENVER COUNTY 1,1076,BROWN ELEMENTARY SCHOOL,KINDERGARTEN,0,3,1,5,56,65,9,14%
0880,DENVER COUNTY 1,1076,BROWN ELEMENTARY SCHOOL,1ST,1,2,1,46,56,106,50,47%
0880,DENVER COUNTY 1,1076,BROWN ELEMENTARY SCHOOL,2ND,2,5,1,22,29,59,30,51%
0880,DENVER COUNTY 1,1076,BROWN ELEMENTARY SCHOOL,3RD,9,3,2,35,20,69,49,71%
0880,DENVER COUNTY 1,1076,BROWN ELEMENTARY SCHOOL,4TH,6,4,4,35,16,65,49,75%
0880,DENVER COUNTY 1,1076,BROWN ELEMENTARY SCHOOL,5TH,2,1,2,30,11,46,35,76%
0880,DENVER COUNTY 1,1076,BROWN ELEMENTARY SCHOOL,SCHOOL TOTAL,21,19,14,185,222,461,239,52%
0880,DENVER COUNTY 1,1106,BRYANT WEBSTER K-8 SCHOOL,PK,0,0,0,15,1,16,15,94%
0880,DENVER COUNTY 1,1106,BRYANT WEBSTER K-8 SCHOOL,KINDERGARTEN,0,0,1,45,1,47,46,98%
0880,DENVER COUNTY 1,1106,BRYANT WEBSTER K-8 SCHOOL,1ST,1,0,0,45,3,49,46,94%
0880,DENVER COUNTY 1,1106,BRYANT WEBSTER K-8 SCHOOL,2ND,0,0,0,35,1,36,35,97%
0880,DENVER COUNTY 1,1106,BRYANT WEBSTER K-8 SCHOOL,3RD,0,0,0,50,1,51,50,98%
0880,DENVER COUNTY 1,1106,BRYANT WEBSTER K-8 SCHOOL,4TH,0,0,0,47,1,48,47,98%
0880,DENVER COUNTY 1,1106,BRYANT WEBSTER K-8 SCHOOL,5TH,2,0,0,55,4,61,57,93%
0880,DENVER COUNTY 1,1106,BRYANT WEBSTER K-8 SCHOOL,6TH,2,1,1,47,0,51,51,100%
0880,DENVER COUNTY 1,1106,BRYANT WEBSTER K-8 SCHOOL,7TH,2,0,0,46,2,50,48,96%
0880,DENVER COUNTY 1,1106,BRYANT WEBSTER K-8 SCHOOL,8TH,0,0,0,46,1,47,46,98%
0880,DENVER COUNTY 1,1106,BRYANT WEBSTER K-8 SCHOOL,SCHOOL TOTAL,7,1,2,431,15,456,441,97%
0880,DENVER COUNTY 1,1319,FRED N THOMAS CAREER EDUCATION CENTER,9TH,2,5,7,99,6,119,113,95%
0880,DENVER COUNTY 1,1319,FRED N THOMAS CAREER EDUCATION CENTER,10TH,1,2,6,79,9,97,88,91%
0880,DENVER COUNTY 1,1319,FRED N THOMAS CAREER EDUCATION CENTER,11TH,0,2,3,82,8,95,87,92%
0880,DENVER COUNTY 1,1319,FRED N THOMAS CAREER EDUCATION CENTER,12TH,1,1,6,62,9,79,70,89%
0880,DENVER COUNTY 1,1319,FRED N THOMAS CAREER EDUCATION CENTER,SCHOOL TOTAL,4,10,22,322,32,390,358,92%
0880,DENVER COUNTY 1,1324,CARSON ELEMENTARY SCHOOL,PK,0,2,2,5,23,32,9,28%
0880,DENVER COUNTY 1,1324,CARSON ELEMENTARY SCHOOL,HALF DAY K,0,0,0,0,2,2,0,0%
0880,DENVER COUNTY 1,1324,CARSON ELEMENTARY SCHOOL,KINDERGARTEN,2,4,3,6,38,53,15,28%
0880,DENVER COUNTY 1,1324,CARSON ELEMENTARY SCHOOL,1ST,0,2,7,7,60,76,16,21%
0880,DENVER COUNTY 1,1324,CARSON ELEMENTARY SCHOOL,2ND,1,3,6,11,57,78,21,27%
0880,DENVER COUNTY 1,1324,CARSON ELEMENTARY SCHOOL,3RD,1,4,9,9,41,64,23,36%
0880,DENVER COUNTY 1,1324,CARSON ELEMENTARY SCHOOL,4TH,1,4,8,7,35,55,20,36%
0880,DENVER COUNTY 1,1324,CARSON ELEMENTARY SCHOOL,5TH,0,1,7,13,25,46,21,46%
0880,DENVER COUNTY 1,1324,CARSON ELEMENTARY SCHOOL,SCHOOL TOTAL,5,20,42,58,281,406,125,31%
0880,DENVER COUNTY 1,1345,CESAR CHAVEZ ACADEMY DENVER,KINDERGARTEN,1,1,0,25,9,36,27,75%
0880,DENVER COUNTY 1,1345,CESAR CHAVEZ ACADEMY DENVER,1ST,1,0,0,42,2,45,43,96%
0880,DENVER COUNTY 1,1345,CESAR CHAVEZ ACADEMY DENVER,2ND,0,0,3,28,10,41,31,76%
0880,DENVER COUNTY 1,1345,CESAR CHAVEZ ACADEMY DENVER,3RD,2,0,2,35,4,43,39,91%
0880,DENVER COUNTY 1,1345,CESAR CHAVEZ ACADEMY DENVER,4TH,1,0,0,35,7,43,36,84%
0880,DENVER COUNTY 1,1345,CESAR CHAVEZ ACADEMY DENVER,5TH,0,0,0,24,2,26,24,92%
0880,DENVER COUNTY 1,1345,CESAR CHAVEZ ACADEMY DENVER,6TH,0,0,2,33,1,36,35,97%
0880,DENVER COUNTY 1,1345,CESAR CHAVEZ ACADEMY DENVER,7TH,0,0,0,34,4,38,34,89%
0880,DENVER COUNTY 1,1345,CESAR CHAVEZ ACADEMY DENVER,8TH,0,0,1,20,4,25,21,84%
0880,DENVER COUNTY 1,1345,CESAR CHAVEZ ACADEMY DENVER,SCHOOL TOTAL,5,1,8,276,43,333,290,87%
0880,DENVER COUNTY 1,1400,CENTENNIAL K-8 SCHOOL,PK,0,1,0,17,18,36,18,50%
0880,DENVER COUNTY 1,1400,CENTENNIAL K-8 SCHOOL,HALF DAY K,0,0,0,1,2,3,1,33%
0880,DENVER COUNTY 1,1400,CENTENNIAL K-8 SCHOOL,KINDERGARTEN,0,0,0,33,35,68,33,49%
0880,DENVER COUNTY 1,1400,CENTENNIAL K-8 SCHOOL,1ST,0,1,2,36,24,63,39,62%
0880,DENVER COUNTY 1,1400,CENTENNIAL K-8 SCHOOL,2ND,1,1,1,34,20,57,37,65%
0880,DENVER COUNTY 1,1400,CENTENNIAL K-8 SCHOOL,3RD,2,3,0,45,17,67,50,75%
0880,DENVER COUNTY 1,1400,CENTENNIAL K-8 SCHOOL,4TH,3,3,0,54,11,71,60,85%
0880,DENVER COUNTY 1,1400,CENTENNIAL K-8 SCHOOL,5TH,0,0,1,52,9,62,53,85%
0880,DENVER COUNTY 1,1400,CENTENNIAL K-8 SCHOOL,6TH,1,1,3,47,4,56,52,93%
0880,DENVER COUNTY 1,1400,CENTENNIAL K-8 SCHOOL,7TH,0,1,1,44,11,57,46,81%
0880,DENVER COUNTY 1,1400,CENTENNIAL K-8 SCHOOL,8TH,0,0,0,35,9,44,35,80%
0880,DENVER COUNTY 1,1400,CENTENNIAL K-8 SCHOOL,SCHOOL TOTAL,7,11,8,398,160,584,424,73%
0880,DENVER COUNTY 1,1528,CHELTENHAM ELEMENTARY SCHOOL,PK,1,0,2,55,6,64,58,91%
0880,DENVER COUNTY 1,1528,CHELTENHAM ELEMENTARY SCHOOL,KINDERGARTEN,0,1,3,64,12,80,68,85%
0880,DENVER COUNTY 1,1528,CHELTENHAM ELEMENTARY SCHOOL,1ST,1,1,2,73,8,85,77,91%
0880,DENVER COUNTY 1,1528,CHELTENHAM ELEMENTARY SCHOOL,2ND,3,1,4,65,2,75,73,97%
0880,DENVER COUNTY 1,1528,CHELTENHAM ELEMENTARY SCHOOL,3RD,1,0,6,55,2,64,62,97%
0880,DENVER COUNTY 1,1528,CHELTENHAM ELEMENTARY SCHOOL,4TH,1,0,6,68,4,79,75,95%
0880,DENVER COUNTY 1,1528,CHELTENHAM ELEMENTARY SCHOOL,5TH,3,0,3,51,2,59,57,97%
0880,DENVER COUNTY 1,1528,CHELTENHAM ELEMENTARY SCHOOL,SCHOOL TOTAL,10,3,26,431,36,506,470,93%
0880,DENVER COUNTY 1,1748,COLORADO HIGH SCHOOL,10TH,2,1,14,44,3,64,61,95%
0880,DENVER COUNTY 1,1748,COLORADO HIGH SCHOOL,11TH,1,0,26,49,6,82,76,93%
0880,DENVER COUNTY 1,1748,COLORADO HIGH SCHOOL,12TH,0,0,13,46,0,59,59,100%
0880,DENVER COUNTY 1,1748,COLORADO HIGH SCHOOL,SCHOOL TOTAL,3,1,53,139,9,205,196,96%
0880,DENVER COUNTY 1,1774,COLFAX ELEMENTARY SCHOOL,PK,0,1,2,55,3,61,58,95%
0880,DENVER COUNTY 1,1774,COLFAX ELEMENTARY SCHOOL,KINDERGARTEN,1,0,3,51,9,64,55,86%
0880,DENVER COUNTY 1,1774,COLFAX ELEMENTARY SCHOOL,1ST,0,2,7,53,5,67,62,93%
0880,DENVER COUNTY 1,1774,COLFAX ELEMENTARY SCHOOL,2ND,2,0,7,39,6,54,48,89%
0880,DENVER COUNTY 1,1774,COLFAX ELEMENTARY SCHOOL,3RD,4,1,3,32,4,44,40,91%
0880,DENVER COUNTY 1,1774,COLFAX ELEMENTARY SCHOOL,4TH,0,0,5,40,2,47,45,96%
0880,DENVER COUNTY 1,1774,COLFAX ELEMENTARY SCHOOL,5TH,0,0,7,31,3,41,38,93%
0880,DENVER COUNTY 1,1774,COLFAX ELEMENTARY SCHOOL,SCHOOL TOTAL,7,4,34,301,32,378,346,92%
0880,DENVER COUNTY 1,1785,COLE ARTS AND SCIENCE ACADEMY,PK,0,1,5,34,9,49,40,82%
0880,DENVER COUNTY 1,1785,COLE ARTS AND SCIENCE ACADEMY,KINDERGARTEN,0,1,12,53,10,76,66,87%
0880,DENVER COUNTY 1,1785,COLE ARTS AND SCIENCE ACADEMY,1ST,1,0,19,56,9,85,76,89%
0880,DENVER COUNTY 1,1785,COLE ARTS AND SCIENCE ACADEMY,2ND,2,2,17,38,9,68,59,87%
0880,DENVER COUNTY 1,1785,COLE ARTS AND SCIENCE ACADEMY,3RD,3,0,14,38,7,62,55,89%
0880,DENVER COUNTY 1,1785,COLE ARTS AND SCIENCE ACADEMY,4TH,3,1,18,34,2,58,56,97%
0880,DENVER COUNTY 1,1785,COLE ARTS AND SCIENCE ACADEMY,5TH,5,0,13,41,4,63,59,94%
0880,DENVER COUNTY 1,1785,COLE ARTS AND SCIENCE ACADEMY,6TH,1,0,11,33,5,50,45,90%
0880,DENVER COUNTY 1,1785,COLE ARTS AND SCIENCE ACADEMY,7TH,1,0,19,34,3,57,54,95%
0880,DENVER COUNTY 1,1785,COLE ARTS AND SCIENCE ACADEMY,8TH,0,0,16,37,3,56,53,95%
0880,DENVER COUNTY 1,1785,COLE ARTS AND SCIENCE ACADEMY,SCHOOL TOTAL,16,5,144,398,61,624,563,90%
0880,DENVER COUNTY 1,1788,COLLEGE VIEW ELEMENTARY SCHOOL,PK,1,5,3,46,14,69,55,80%
0880,DENVER COUNTY 1,1788,COLLEGE VIEW ELEMENTARY SCHOOL,KINDERGARTEN,3,6,0,62,7,78,71,91%
0880,DENVER COUNTY 1,1788,COLLEGE VIEW ELEMENTARY SCHOOL,1ST,1,10,4,45,5,65,60,92%
0880,DENVER COUNTY 1,1788,COLLEGE VIEW ELEMENTARY SCHOOL,2ND,1,10,5,53,5,74,69,93%
0880,DENVER COUNTY 1,1788,COLLEGE VIEW ELEMENTARY SCHOOL,3RD,5,2,3,38,5,53,48,91%
0880,DENVER COUNTY 1,1788,COLLEGE VIEW ELEMENTARY SCHOOL,4TH,1,9,1,46,6,63,57,90%
0880,DENVER COUNTY 1,1788,COLLEGE VIEW ELEMENTARY SCHOOL,5TH,3,7,0,41,2,53,51,96%
0880,DENVER COUNTY 1,1788,COLLEGE VIEW ELEMENTARY SCHOOL,SCHOOL TOTAL,15,49,16,331,44,455,411,90%
0880,DENVER COUNTY 1,1816,COLUMBIAN ELEMENTARY SCHOOL,PK,1,0,0,31,16,48,32,67%
0880,DENVER COUNTY 1,1816,COLUMBIAN ELEMENTARY SCHOOL,KINDERGARTEN,0,0,0,30,9,39,30,77%
0880,DENVER COUNTY 1,1816,COLUMBIAN ELEMENTARY SCHOOL,1ST,0,0,0,45,8,53,45,85%
0880,DENVER COUNTY 1,1816,COLUMBIAN ELEMENTARY SCHOOL,2ND,1,0,2,38,8,49,41,84%
0880,DENVER COUNTY 1,1816,COLUMBIAN ELEMENTARY SCHOOL,3RD,1,0,1,40,4,46,42,91%
0880,DENVER COUNTY 1,1816,COLUMBIAN ELEMENTARY SCHOOL,4TH,1,0,0,44,4,49,45,92%
0880,DENVER COUNTY 1,1816,COLUMBIAN ELEMENTARY SCHOOL,5TH,0,0,0,30,5,35,30,86%
0880,DENVER COUNTY 1,1816,COLUMBIAN ELEMENTARY SCHOOL,SCHOOL TOTAL,4,0,3,258,54,319,265,83%
0880,DENVER COUNTY 1,1846,COLUMBINE ELEMENTARY SCHOOL,PK,0,0,11,17,8,36,28,78%
0880,DENVER COUNTY 1,1846,COLUMBINE ELEMENTARY SCHOOL,KINDERGARTEN,0,1,20,25,3,49,46,94%
0880,DENVER COUNTY 1,1846,COLUMBINE ELEMENTARY SCHOOL,1ST,1,0,20,22,4,47,43,91%
0880,DENVER COUNTY 1,1846,COLUMBINE ELEMENTARY SCHOOL,2ND,0,0,20,12,5,37,32,86%
0880,DENVER COUNTY 1,1846,COLUMBINE ELEMENTARY SCHOOL,3RD,1,0,16,16,1,34,33,97%
0880,DENVER COUNTY 1,1846,COLUMBINE ELEMENTARY SCHOOL,4TH,1,0,22,19,4,46,42,91%
0880,DENVER COUNTY 1,1846,COLUMBINE ELEMENTARY SCHOOL,5TH,0,0,18,19,1,38,37,97%
0880,DENVER COUNTY 1,1846,COLUMBINE ELEMENTARY SCHOOL,6TH,1,0,10,11,1,23,22,96%
0880,DENVER COUNTY 1,1846,COLUMBINE ELEMENTARY SCHOOL,SCHOOL TOTAL,4,1,137,141,27,310,283,91%
0880,DENVER COUNTY 1,1866,ACE COMMUNITY CHALLENGE CHARTER SCHOOL,8TH,0,0,0,3,0,3,3,100%
0880,DENVER COUNTY 1,1866,ACE COMMUNITY CHALLENGE CHARTER SCHOOL,9TH,0,1,2,98,3,104,101,97%
0880,DENVER COUNTY 1,1866,ACE COMMUNITY CHALLENGE CHARTER SCHOOL,10TH,2,1,1,91,1,96,95,99%
0880,DENVER COUNTY 1,1866,ACE COMMUNITY CHALLENGE CHARTER SCHOOL,SCHOOL TOTAL,2,2,3,192,4,203,199,98%
0880,DENVER COUNTY 1,1887,CONNECTIONS ACADEMY,HALF DAY K,1,2,6,15,35,59,24,41%
0880,DENVER COUNTY 1,1887,CONNECTIONS ACADEMY,1ST,0,1,4,3,46,54,8,15%
0880,DENVER COUNTY 1,1887,CONNECTIONS ACADEMY,2ND,0,2,3,5,45,55,10,18%
0880,DENVER COUNTY 1,1887,CONNECTIONS ACADEMY,3RD,2,1,5,4,55,67,12,18%
0880,DENVER COUNTY 1,1887,CONNECTIONS ACADEMY,4TH,1,0,6,7,62,76,14,18%
0880,DENVER COUNTY 1,1887,CONNECTIONS ACADEMY,5TH,1,1,4,13,57,76,19,25%
0880,DENVER COUNTY 1,1887,CONNECTIONS ACADEMY,6TH,1,1,6,12,76,96,20,21%
0880,DENVER COUNTY 1,1887,CONNECTIONS ACADEMY,7TH,2,3,5,17,99,126,27,21%
0880,DENVER COUNTY 1,1887,CONNECTIONS ACADEMY,8TH,0,1,2,15,104,122,18,15%
0880,DENVER COUNTY 1,1887,CONNECTIONS ACADEMY,9TH,5,1,11,23,148,188,40,21%
0880,DENVER COUNTY 1,1887,CONNECTIONS ACADEMY,10TH,0,0,5,11,79,95,16,17%
0880,DENVER COUNTY 1,1887,CONNECTIONS ACADEMY,11TH,0,0,0,2,26,28,2,7%
0880,DENVER COUNTY 1,1887,CONNECTIONS ACADEMY,12TH,0,0,0,1,17,18,1,6%
0880,DENVER COUNTY 1,1887,CONNECTIONS ACADEMY,SCHOOL TOTAL,13,13,57,128,849,1060,211,20%
0880,DENVER COUNTY 1,1908,CORY ELEMENTARY SCHOOL,PK,0,2,1,2,39,44,5,11%
0880,DENVER COUNTY 1,1908,CORY ELEMENTARY SCHOOL,HALF DAY K,0,0,1,1,17,19,2,11%
0880,DENVER COUNTY 1,1908,CORY ELEMENTARY SCHOOL,KINDERGARTEN,0,1,2,5,42,50,8,16%
0880,DENVER COUNTY 1,1908,CORY ELEMENTARY SCHOOL,1ST,0,2,0,4,69,75,6,8%
0880,DENVER COUNTY 1,1908,CORY ELEMENTARY SCHOOL,2ND,0,1,2,8,58,69,11,16%
0880,DENVER COUNTY 1,1908,CORY ELEMENTARY SCHOOL,3RD,0,1,1,6,56,64,8,13%
0880,DENVER COUNTY 1,1908,CORY ELEMENTARY SCHOOL,4TH,0,4,5,7,49,65,16,25%
0880,DENVER COUNTY 1,1908,CORY ELEMENTARY SCHOOL,5TH,0,3,1,8,53,65,12,18%
0880,DENVER COUNTY 1,1908,CORY ELEMENTARY SCHOOL,SCHOOL TOTAL,0,14,13,41,383,451,68,15%
0880,DENVER COUNTY 1,1928,COWELL ELEMENTARY SCHOOL,PK,0,0,0,62,1,63,62,98%
0880,DENVER COUNTY 1,1928,COWELL ELEMENTARY SCHOOL,KINDERGARTEN,0,0,2,78,7,87,80,92%
0880,DENVER COUNTY 1,1928,COWELL ELEMENTARY SCHOOL,1ST,3,1,2,71,4,81,77,95%
0880,DENVER COUNTY 1,1928,COWELL ELEMENTARY SCHOOL,2ND,3,0,2,81,0,86,86,100%
0880,DENVER COUNTY 1,1928,COWELL ELEMENTARY SCHOOL,3RD,3,1,3,70,3,80,77,96%
0880,DENVER COUNTY 1,1928,COWELL ELEMENTARY SCHOOL,4TH,3,1,2,75,2,83,81,98%
0880,DENVER COUNTY 1,1928,COWELL ELEMENTARY SCHOOL,5TH,0,1,3,49,0,53,53,100%
0880,DENVER COUNTY 1,1928,COWELL ELEMENTARY SCHOOL,SCHOOL TOTAL,12,4,14,486,17,533,516,97%
0880,DENVER COUNTY 1,2027,POLARIS AT EBERT ELEMENTARY SCHOOL,KINDERGARTEN,0,3,0,1,21,25,4,16%
0880,DENVER COUNTY 1,2027,POLARIS AT EBERT ELEMENTARY SCHOOL,1ST,0,1,3,2,44,50,6,12%
0880,DENVER COUNTY 1,2027,POLARIS AT EBERT ELEMENTARY SCHOOL,2ND,0,2,2,3,47,54,7,13%
0880,DENVER COUNTY 1,2027,POLARIS AT EBERT ELEMENTARY SCHOOL,3RD,0,6,4,5,40,55,15,27%
0880,DENVER COUNTY 1,2027,POLARIS AT EBERT ELEMENTARY SCHOOL,4TH,0,2,3,8,58,71,13,18%
0880,DENVER COUNTY 1,2027,POLARIS AT EBERT ELEMENTARY SCHOOL,5TH,0,5,11,8,56,80,24,30%
0880,DENVER COUNTY 1,2027,POLARIS AT EBERT ELEMENTARY SCHOOL,SCHOOL TOTAL,0,19,23,27,266,335,69,21%
0880,DENVER COUNTY 1,2174,DENISON MONTESSORI SCHOOL,PK,0,7,4,63,34,108,74,69%
0880,DENVER COUNTY 1,2174,DENISON MONTESSORI SCHOOL,KINDERGARTEN,2,3,3,26,22,56,34,61%
0880,DENVER COUNTY 1,2174,DENISON MONTESSORI SCHOOL,1ST,0,2,0,27,30,59,29,49%
0880,DENVER COUNTY 1,2174,DENISON MONTESSORI SCHOOL,2ND,2,3,3,27,19,54,35,65%
0880,DENVER COUNTY 1,2174,DENISON MONTESSORI SCHOOL,3RD,1,2,3,25,13,44,31,70%
0880,DENVER COUNTY 1,2174,DENISON MONTESSORI SCHOOL,4TH,1,3,2,23,15,44,29,66%
0880,DENVER COUNTY 1,2174,DENISON MONTESSORI SCHOOL,5TH,0,2,2,16,18,38,20,53%
0880,DENVER COUNTY 1,2174,DENISON MONTESSORI SCHOOL,6TH,0,1,1,20,5,27,22,81%
0880,DENVER COUNTY 1,2174,DENISON MONTESSORI SCHOOL,SCHOOL TOTAL,6,23,18,227,156,430,274,64%
0880,DENVER COUNTY 1,2183,DENVER CENTER FOR INTERNATIONAL STUDIES,6TH,0,10,8,35,45,98,53,54%
0880,DENVER COUNTY 1,2183,DENVER CENTER FOR INTERNATIONAL STUDIES,7TH,2,9,6,42,49,108,59,55%
0880,DENVER COUNTY 1,2183,DENVER CENTER FOR INTERNATIONAL STUDIES,8TH,0,11,8,40,61,120,59,49%
0880,DENVER COUNTY 1,2183,DENVER CENTER FOR INTERNATIONAL STUDIES,9TH,2,6,5,58,23,94,71,76%
0880,DENVER COUNTY 1,2183,DENVER CENTER FOR INTERNATIONAL STUDIES,10TH,0,6,7,32,19,64,45,70%
0880,DENVER COUNTY 1,2183,DENVER CENTER FOR INTERNATIONAL STUDIES,11TH,1,4,2,24,14,45,31,69%
0880,DENVER COUNTY 1,2183,DENVER CENTER FOR INTERNATIONAL STUDIES,12TH,1,4,3,25,5,38,33,87%
0880,DENVER COUNTY 1,2183,DENVER CENTER FOR INTERNATIONAL STUDIES,SCHOOL TOTAL,6,50,39,256,216,567,351,62%
0880,DENVER COUNTY 1,2184,DENVER SCHOOL OF THE ARTS,6TH,0,7,15,12,111,145,34,23%
0880,DENVER COUNTY 1,2184,DENVER SCHOOL OF THE ARTS,7TH,1,10,17,20,94,142,48,34%
0880,DENVER COUNTY 1,2184,DENVER SCHOOL OF THE ARTS,8TH,1,12,15,26,100,154,54,35%
0880,DENVER COUNTY 1,2184,DENVER SCHOOL OF THE ARTS,9TH,1,10,19,13,89,132,43,33%
0880,DENVER COUNTY 1,2184,DENVER SCHOOL OF THE ARTS,10TH,1,11,16,15,96,139,43,31%
0880,DENVER COUNTY 1,2184,DENVER SCHOOL OF THE ARTS,11TH,1,6,20,18,69,114,45,39%
0880,DENVER COUNTY 1,2184,DENVER SCHOOL OF THE ARTS,12TH,2,6,16,22,77,123,46,37%
0880,DENVER COUNTY 1,2184,DENVER SCHOOL OF THE ARTS,SCHOOL TOTAL,7,62,118,126,636,949,313,33%
0880,DENVER COUNTY 1,2185,DENVER SCHOOL OF SCIENCE AND TECHNOLOGY,6TH,2,6,41,48,41,138,97,70%
0880,DENVER COUNTY 1,2185,DENVER SCHOOL OF SCIENCE AND TECHNOLOGY,7TH,4,7,43,47,39,140,101,72%
0880,DENVER COUNTY 1,2185,DENVER SCHOOL OF SCIENCE AND TECHNOLOGY,9TH,0,4,46,36,52,138,86,62%
0880,DENVER COUNTY 1,2185,DENVER SCHOOL OF SCIENCE AND TECHNOLOGY,10TH,0,4,39,47,37,127,90,71%
0880,DENVER COUNTY 1,2185,DENVER SCHOOL OF SCIENCE AND TECHNOLOGY,11TH,0,4,31,23,43,101,58,57%
0880,DENVER COUNTY 1,2185,DENVER SCHOOL OF SCIENCE AND TECHNOLOGY,12TH,0,2,25,27,30,84,54,64%
0880,DENVER COUNTY 1,2185,DENVER SCHOOL OF SCIENCE AND TECHNOLOGY,SCHOOL TOTAL,6,27,225,228,242,728,486,67%
0880,DENVER COUNTY 1,2187,DENVER VENTURE CHARTER SCHOOL,9TH,1,0,25,40,8,74,66,89%
0880,DENVER COUNTY 1,2187,DENVER VENTURE CHARTER SCHOOL,10TH,1,1,24,23,6,55,49,89%
0880,DENVER COUNTY 1,2187,DENVER VENTURE CHARTER SCHOOL,SCHOOL TOTAL,2,1,49,63,14,129,115,89%
0880,DENVER COUNTY 1,2258,DOULL ELEMENTARY SCHOOL,PK,0,3,1,39,21,64,43,67%
0880,DENVER COUNTY 1,2258,DOULL ELEMENTARY SCHOOL,HALF DAY K,0,0,0,17,8,25,17,68%
0880,DENVER COUNTY 1,2258,DOULL ELEMENTARY SCHOOL,KINDERGARTEN,0,3,0,45,10,58,48,83%
0880,DENVER COUNTY 1,2258,DOULL ELEMENTARY SCHOOL,1ST,1,2,1,72,17,93,76,82%
0880,DENVER COUNTY 1,2258,DOULL ELEMENTARY SCHOOL,2ND,1,1,0,54,7,63,56,89%
0880,DENVER COUNTY 1,2258,DOULL ELEMENTARY SCHOOL,3RD,1,0,2,53,10,66,56,85%
0880,DENVER COUNTY 1,2258,DOULL ELEMENTARY SCHOOL,4TH,1,0,0,55,9,65,56,86%
0880,DENVER COUNTY 1,2258,DOULL ELEMENTARY SCHOOL,5TH,0,2,2,48,8,60,52,87%
0880,DENVER COUNTY 1,2258,DOULL ELEMENTARY SCHOOL,SCHOOL TOTAL,4,11,6,383,90,494,404,82%
0880,DENVER COUNTY 1,2364,EAGLETON ELEMENTARY SCHOOL,PK,1,0,0,26,5,32,27,84%
0880,DENVER COUNTY 1,2364,EAGLETON ELEMENTARY SCHOOL,HALF DAY K,0,0,0,0,1,1,0,0%
0880,DENVER COUNTY 1,2364,EAGLETON ELEMENTARY SCHOOL,KINDERGARTEN,0,1,1,48,20,70,50,71%
0880,DENVER COUNTY 1,2364,EAGLETON ELEMENTARY SCHOOL,1ST,1,0,2,49,7,59,52,88%
0880,DENVER COUNTY 1,2364,EAGLETON ELEMENTARY SCHOOL,2ND,1,0,1,47,14,63,49,78%
0880,DENVER COUNTY 1,2364,EAGLETON ELEMENTARY SCHOOL,3RD,0,0,0,54,5,59,54,92%
0880,DENVER COUNTY 1,2364,EAGLETON ELEMENTARY SCHOOL,4TH,0,0,1,59,5,65,60,92%
0880,DENVER COUNTY 1,2364,EAGLETON ELEMENTARY SCHOOL,5TH,0,0,1,45,5,51,46,90%
0880,DENVER COUNTY 1,2364,EAGLETON ELEMENTARY SCHOOL,SCHOOL TOTAL,3,1,6,328,62,400,338,85%
0880,DENVER COUNTY 1,2398,EAST HIGH SCHOOL,9TH,11,8,235,152,292,698,406,58%
0880,DENVER COUNTY 1,2398,EAST HIGH SCHOOL,10TH,7,14,161,96,254,532,278,52%
0880,DENVER COUNTY 1,2398,EAST HIGH SCHOOL,11TH,2,12,151,83,242,490,248,51%
0880,DENVER COUNTY 1,2398,EAST HIGH SCHOOL,12TH,2,12,142,88,195,439,244,56%
0880,DENVER COUNTY 1,2398,EAST HIGH SCHOOL,SCHOOL TOTAL,22,46,689,419,983,2159,1176,54%
0880,DENVER COUNTY 1,2506,EDISON ELEMENTARY SCHOOL,PK,0,1,0,7,31,39,8,21%
0880,DENVER COUNTY 1,2506,EDISON ELEMENTARY SCHOOL,HALF DAY K,0,0,1,1,10,12,2,17%
0880,DENVER COUNTY 1,2506,EDISON ELEMENTARY SCHOOL,KINDERGARTEN,0,1,0,18,50,69,19,28%
0880,DENVER COUNTY 1,2506,EDISON ELEMENTARY SCHOOL,1ST,1,3,2,33,60,99,39,39%
0880,DENVER COUNTY 1,2506,EDISON ELEMENTARY SCHOOL,2ND,1,1,1,15,78,96,18,19%
0880,DENVER COUNTY 1,2506,EDISON ELEMENTARY SCHOOL,3RD,1,3,3,39,46,92,46,50%
0880,DENVER COUNTY 1,2506,EDISON ELEMENTARY SCHOOL,4TH,1,0,1,34,43,79,36,46%
0880,DENVER COUNTY 1,2506,EDISON ELEMENTARY SCHOOL,5TH,2,2,0,30,46,80,34,43%
0880,DENVER COUNTY 1,2506,EDISON ELEMENTARY SCHOOL,SCHOOL TOTAL,6,11,8,177,364,566,202,36%
0880,DENVER COUNTY 1,2652,ELLIS ELEMENTARY SCHOOL,PK,1,0,2,44,38,85,47,55%
0880,DENVER COUNTY 1,2652,ELLIS ELEMENTARY SCHOOL,HALF DAY K,0,1,1,5,2,9,7,78%
0880,DENVER COUNTY 1,2652,ELLIS ELEMENTARY SCHOOL,KINDERGARTEN,0,2,9,34,30,75,45,60%
0880,DENVER COUNTY 1,2652,ELLIS ELEMENTARY SCHOOL,1ST,1,4,7,53,29,94,65,69%
0880,DENVER COUNTY 1,2652,ELLIS ELEMENTARY SCHOOL,2ND,0,3,11,47,18,79,61,77%
0880,DENVER COUNTY 1,2652,ELLIS ELEMENTARY SCHOOL,3RD,1,3,6,38,26,74,48,65%
0880,DENVER COUNTY 1,2652,ELLIS ELEMENTARY SCHOOL,4TH,1,5,4,51,23,84,61,73%
0880,DENVER COUNTY 1,2652,ELLIS ELEMENTARY SCHOOL,5TH,1,8,7,28,22,66,44,67%
0880,DENVER COUNTY 1,2652,ELLIS ELEMENTARY SCHOOL,SCHOOL TOTAL,5,26,47,300,188,566,378,67%
0880,DENVER COUNTY 1,2726,EMILY GRIFFITH OPPORTUNITY SCHOOL,9TH,0,0,9,27,13,49,36,73%
0880,DENVER COUNTY 1,2726,EMILY GRIFFITH OPPORTUNITY SCHOOL,10TH,2,2,13,55,16,88,72,82%
0880,DENVER COUNTY 1,2726,EMILY GRIFFITH OPPORTUNITY SCHOOL,11TH,4,1,28,64,14,111,97,87%
0880,DENVER COUNTY 1,2726,EMILY GRIFFITH OPPORTUNITY SCHOOL,12TH,5,3,78,182,58,326,268,82%
0880,DENVER COUNTY 1,2726,EMILY GRIFFITH OPPORTUNITY SCHOOL,SCHOOL TOTAL,11,6,128,328,101,574,473,82%
0880,DENVER COUNTY 1,2755,ENVISION LEADERSHIP PREP,6TH,1,0,72,36,6,115,109,95%
0880,DENVER COUNTY 1,2755,ENVISION LEADERSHIP PREP,9TH,1,1,27,27,8,64,56,88%
0880,DENVER COUNTY 1,2755,ENVISION LEADERSHIP PREP,SCHOOL TOTAL,2,1,99,63,14,179,165,92%
0880,DENVER COUNTY 1,2789,ESCUELA TLATELOLCO SCHOOL,7TH,0,0,0,4,0,4,4,100%
0880,DENVER COUNTY 1,2789,ESCUELA TLATELOLCO SCHOOL,8TH,0,0,0,12,0,12,12,100%
0880,DENVER COUNTY 1,2789,ESCUELA TLATELOLCO SCHOOL,9TH,0,0,0,19,3,22,19,86%
0880,DENVER COUNTY 1,2789,ESCUELA TLATELOLCO SCHOOL,10TH,0,0,0,28,2,30,28,93%
0880,DENVER COUNTY 1,2789,ESCUELA TLATELOLCO SCHOOL,11TH,0,0,0,11,0,11,11,100%
0880,DENVER COUNTY 1,2789,ESCUELA TLATELOLCO SCHOOL,12TH,0,0,0,6,0,6,6,100%
0880,DENVER COUNTY 1,2789,ESCUELA TLATELOLCO SCHOOL,SCHOOL TOTAL,0,0,0,80,5,85,80,94%
0880,DENVER COUNTY 1,2856,FAIRMONT K-8 SCHOOL,PK,0,0,5,50,13,68,55,81%
0880,DENVER COUNTY 1,2856,FAIRMONT K-8 SCHOOL,KINDERGARTEN,0,0,1,42,15,58,43,74%
0880,DENVER COUNTY 1,2856,FAIRMONT K-8 SCHOOL,1ST,0,1,0,40,3,44,41,93%
0880,DENVER COUNTY 1,2856,FAIRMONT K-8 SCHOOL,2ND,1,0,1,36,7,45,38,84%
0880,DENVER COUNTY 1,2856,FAIRMONT K-8 SCHOOL,3RD,2,0,0,34,0,36,36,100%
0880,DENVER COUNTY 1,2856,FAIRMONT K-8 SCHOOL,4TH,1,1,2,39,3,46,43,93%
0880,DENVER COUNTY 1,2856,FAIRMONT K-8 SCHOOL,5TH,0,0,1,24,2,27,25,93%
0880,DENVER COUNTY 1,2856,FAIRMONT K-8 SCHOOL,6TH,0,0,1,29,5,35,30,86%
0880,DENVER COUNTY 1,2856,FAIRMONT K-8 SCHOOL,7TH,0,0,0,22,5,27,22,81%
0880,DENVER COUNTY 1,2856,FAIRMONT K-8 SCHOOL,8TH,0,0,0,28,0,28,28,100%
0880,DENVER COUNTY 1,2856,FAIRMONT K-8 SCHOOL,SCHOOL TOTAL,4,2,11,344,53,414,361,87%
0880,DENVER COUNTY 1,2880,FAIRVIEW ELEMENTARY SCHOOL,PK,2,2,7,25,11,47,36,77%
0880,DENVER COUNTY 1,2880,FAIRVIEW ELEMENTARY SCHOOL,KINDERGARTEN,2,2,12,31,8,55,47,85%
0880,DENVER COUNTY 1,2880,FAIRVIEW ELEMENTARY SCHOOL,1ST,1,3,14,21,6,45,39,87%
0880,DENVER COUNTY 1,2880,FAIRVIEW ELEMENTARY SCHOOL,2ND,0,4,14,13,3,34,31,91%
0880,DENVER COUNTY 1,2880,FAIRVIEW ELEMENTARY SCHOOL,3RD,1,6,9,11,3,30,27,90%
0880,DENVER COUNTY 1,2880,FAIRVIEW ELEMENTARY SCHOOL,4TH,1,3,6,12,4,26,22,85%
0880,DENVER COUNTY 1,2880,FAIRVIEW ELEMENTARY SCHOOL,5TH,0,1,4,10,1,16,15,94%
0880,DENVER COUNTY 1,2880,FAIRVIEW ELEMENTARY SCHOOL,SCHOOL TOTAL,7,21,66,123,36,253,217,86%
0880,DENVER COUNTY 1,3000,FLORENCE CRITTENTON HIGH SCHOOL,9TH,1,0,6,49,4,60,56,93%
0880,DENVER COUNTY 1,3000,FLORENCE CRITTENTON HIGH SCHOOL,10TH,1,1,11,38,2,53,51,96%
0880,DENVER COUNTY 1,3000,FLORENCE CRITTENTON HIGH SCHOOL,11TH,0,1,4,25,5,35,30,86%
0880,DENVER COUNTY 1,3000,FLORENCE CRITTENTON HIGH SCHOOL,12TH,0,0,4,21,3,28,25,89%
0880,DENVER COUNTY 1,3000,FLORENCE CRITTENTON HIGH SCHOOL,SCHOOL TOTAL,2,2,25,133,14,176,162,92%
0880,DENVER COUNTY 1,3032,FORCE ELEMENTARY SCHOOL,PK,1,1,0,60,2,64,62,97%
0880,DENVER COUNTY 1,3032,FORCE ELEMENTARY SCHOOL,HALF DAY K,0,0,0,1,0,1,1,100%
0880,DENVER COUNTY 1,3032,FORCE ELEMENTARY SCHOOL,KINDERGARTEN,1,1,4,58,9,73,64,88%
0880,DENVER COUNTY 1,3032,FORCE ELEMENTARY SCHOOL,1ST,2,0,2,67,10,81,71,88%
0880,DENVER COUNTY 1,3032,FORCE ELEMENTARY SCHOOL,2ND,1,2,0,65,4,72,68,94%
0880,DENVER COUNTY 1,3032,FORCE ELEMENTARY SCHOOL,3RD,1,2,0,72,5,80,75,94%
0880,DENVER COUNTY 1,3032,FORCE ELEMENTARY SCHOOL,4TH,1,0,6,48,7,62,55,89%
0880,DENVER COUNTY 1,3032,FORCE ELEMENTARY SCHOOL,5TH,0,2,2,60,7,71,64,90%
0880,DENVER COUNTY 1,3032,FORCE ELEMENTARY SCHOOL,SCHOOL TOTAL,7,8,14,431,44,504,460,91%
0880,DENVER COUNTY 1,3038,FORD ELEMENTARY SCHOOL,PK,0,0,16,86,3,105,102,97%
0880,DENVER COUNTY 1,3038,FORD ELEMENTARY SCHOOL,KINDERGARTEN,3,0,24,85,4,116,112,97%
0880,DENVER COUNTY 1,3038,FORD ELEMENTARY SCHOOL,1ST,0,1,23,70,4,98,94,96%
0880,DENVER COUNTY 1,3038,FORD ELEMENTARY SCHOOL,2ND,1,0,21,78,4,104,100,96%
0880,DENVER COUNTY 1,3038,FORD ELEMENTARY SCHOOL,3RD,0,0,14,82,2,98,96,98%
0880,DENVER COUNTY 1,3038,FORD ELEMENTARY SCHOOL,4TH,0,0,20,60,4,84,80,95%
0880,DENVER COUNTY 1,3038,FORD ELEMENTARY SCHOOL,5TH,0,1,24,65,1,91,90,99%
0880,DENVER COUNTY 1,3038,FORD ELEMENTARY SCHOOL,SCHOOL TOTAL,4,2,142,526,22,696,674,97%
0880,DENVER COUNTY 1,3296,GARDEN PLACE ELEMENTARY SCHOOL,PK,0,0,0,26,6,32,26,81%
0880,DENVER COUNTY 1,3296,GARDEN PLACE ELEMENTARY SCHOOL,HALF DAY K,0,0,1,7,1,9,8,89%
0880,DENVER COUNTY 1,3296,GARDEN PLACE ELEMENTARY SCHOOL,KINDERGARTEN,0,0,1,45,3,49,46,94%
0880,DENVER COUNTY 1,3296,GARDEN PLACE ELEMENTARY SCHOOL,1ST,0,0,3,53,2,58,56,97%
0880,DENVER COUNTY 1,3296,GARDEN PLACE ELEMENTARY SCHOOL,2ND,1,0,1,45,3,50,47,94%
0880,DENVER COUNTY 1,3296,GARDEN PLACE ELEMENTARY SCHOOL,3RD,3,0,2,47,1,53,52,98%
0880,DENVER COUNTY 1,3296,GARDEN PLACE ELEMENTARY SCHOOL,4TH,1,0,1,46,4,52,48,92%
0880,DENVER COUNTY 1,3296,GARDEN PLACE ELEMENTARY SCHOOL,5TH,0,0,1,47,3,51,48,94%
0880,DENVER COUNTY 1,3296,GARDEN PLACE ELEMENTARY SCHOOL,SCHOOL TOTAL,5,0,10,316,23,354,331,94%
0880,DENVER COUNTY 1,3340,ARCHULETA ELEMENTARY SCHOOL,PK,0,0,6,26,0,32,32,100%
0880,DENVER COUNTY 1,3340,ARCHULETA ELEMENTARY SCHOOL,KINDERGARTEN,0,2,12,70,21,105,84,80%
0880,DENVER COUNTY 1,3340,ARCHULETA ELEMENTARY SCHOOL,1ST,0,3,13,84,28,128,100,78%
0880,DENVER COUNTY 1,3340,ARCHULETA ELEMENTARY SCHOOL,2ND,1,0,17,79,15,112,97,87%
0880,DENVER COUNTY 1,3340,ARCHULETA ELEMENTARY SCHOOL,3RD,0,2,16,76,13,107,94,88%
0880,DENVER COUNTY 1,3340,ARCHULETA ELEMENTARY SCHOOL,4TH,1,4,18,63,15,101,86,85%
0880,DENVER COUNTY 1,3340,ARCHULETA ELEMENTARY SCHOOL,5TH,0,1,15,68,16,100,84,84%
0880,DENVER COUNTY 1,3340,ARCHULETA ELEMENTARY SCHOOL,SCHOOL TOTAL,2,12,97,466,108,685,577,84%
0880,DENVER COUNTY 1,3378,GEORGE WASHINGTON HIGH SCHOOL,9TH,3,18,224,151,129,525,396,75%
0880,DENVER COUNTY 1,3378,GEORGE WASHINGTON HIGH SCHOOL,10TH,4,11,138,63,104,320,216,68%
0880,DENVER COUNTY 1,3378,GEORGE WASHINGTON HIGH SCHOOL,11TH,2,20,134,53,96,305,209,69%
0880,DENVER COUNTY 1,3378,GEORGE WASHINGTON HIGH SCHOOL,12TH,3,25,130,65,118,341,223,65%
0880,DENVER COUNTY 1,3378,GEORGE WASHINGTON HIGH SCHOOL,SCHOOL TOTAL,12,74,626,332,447,1491,1044,70%
0880,DENVER COUNTY 1,3426,GILPIN K-8 SCHOOL,PK,1,0,22,35,10,68,58,85%
0880,DENVER COUNTY 1,3426,GILPIN K-8 SCHOOL,KINDERGARTEN,1,1,14,21,10,47,37,79%
0880,DENVER COUNTY 1,3426,GILPIN K-8 SCHOOL,1ST,0,0,8,15,5,28,23,82%
0880,DENVER COUNTY 1,3426,GILPIN K-8 SCHOOL,2ND,0,1,10,15,2,28,26,93%
0880,DENVER COUNTY 1,3426,GILPIN K-8 SCHOOL,3RD,0,0,6,24,2,32,30,94%
0880,DENVER COUNTY 1,3426,GILPIN K-8 SCHOOL,4TH,0,0,10,20,0,30,30,100%
0880,DENVER COUNTY 1,3426,GILPIN K-8 SCHOOL,5TH,0,0,10,19,2,31,29,94%
0880,DENVER COUNTY 1,3426,GILPIN K-8 SCHOOL,6TH,0,0,2,9,0,11,11,100%
0880,DENVER COUNTY 1,3426,GILPIN K-8 SCHOOL,7TH,0,0,4,20,0,24,24,100%
0880,DENVER COUNTY 1,3426,GILPIN K-8 SCHOOL,8TH,0,0,8,25,1,34,33,97%
0880,DENVER COUNTY 1,3426,GILPIN K-8 SCHOOL,SCHOOL TOTAL,2,2,94,203,32,333,301,90%
0880,DENVER COUNTY 1,3478,GODSMAN ELEMENTARY SCHOOL,PK,0,3,1,56,4,64,60,94%
0880,DENVER COUNTY 1,3478,GODSMAN ELEMENTARY SCHOOL,HALF DAY K,0,0,0,1,0,1,1,100%
0880,DENVER COUNTY 1,3478,GODSMAN ELEMENTARY SCHOOL,KINDERGARTEN,0,2,0,55,5,62,57,92%
0880,DENVER COUNTY 1,3478,GODSMAN ELEMENTARY SCHOOL,1ST,0,2,0,64,7,73,66,90%
0880,DENVER COUNTY 1,3478,GODSMAN ELEMENTARY SCHOOL,2ND,0,1,0,61,3,65,62,95%
0880,DENVER COUNTY 1,3478,GODSMAN ELEMENTARY SCHOOL,3RD,0,1,0,53,2,56,54,96%
0880,DENVER COUNTY 1,3478,GODSMAN ELEMENTARY SCHOOL,4TH,1,1,0,64,1,67,66,99%
0880,DENVER COUNTY 1,3478,GODSMAN ELEMENTARY SCHOOL,5TH,0,3,0,50,1,54,53,98%
0880,DENVER COUNTY 1,3478,GODSMAN ELEMENTARY SCHOOL,SCHOOL TOTAL,1,13,1,404,23,442,419,95%
0880,DENVER COUNTY 1,3512,GOLDRICK ELEMENTARY SCHOOL,PK,0,2,4,56,2,64,62,97%
0880,DENVER COUNTY 1,3512,GOLDRICK ELEMENTARY SCHOOL,HALF DAY K,0,1,0,4,2,7,5,71%
0880,DENVER COUNTY 1,3512,GOLDRICK ELEMENTARY SCHOOL,KINDERGARTEN,0,5,5,78,8,96,88,92%
0880,DENVER COUNTY 1,3512,GOLDRICK ELEMENTARY SCHOOL,1ST,1,4,4,67,3,79,76,96%
0880,DENVER COUNTY 1,3512,GOLDRICK ELEMENTARY SCHOOL,2ND,0,2,2,88,9,101,92,91%
0880,DENVER COUNTY 1,3512,GOLDRICK ELEMENTARY SCHOOL,3RD,0,7,2,87,3,99,96,97%
0880,DENVER COUNTY 1,3512,GOLDRICK ELEMENTARY SCHOOL,4TH,0,4,5,80,4,93,89,96%
0880,DENVER COUNTY 1,3512,GOLDRICK ELEMENTARY SCHOOL,5TH,0,3,0,74,2,79,77,97%
0880,DENVER COUNTY 1,3512,GOLDRICK ELEMENTARY SCHOOL,SCHOOL TOTAL,1,28,22,534,33,618,585,95%
0880,DENVER COUNTY 1,3600,GRANT MIDDLE SCHOOL,6TH,0,3,7,106,39,155,116,75%
0880,DENVER COUNTY 1,3600,GRANT MIDDLE SCHOOL,7TH,0,0,8,78,15,101,86,85%
0880,DENVER COUNTY 1,3600,GRANT MIDDLE SCHOOL,8TH,1,1,5,78,33,118,85,72%
0880,DENVER COUNTY 1,3600,GRANT MIDDLE SCHOOL,SCHOOL TOTAL,1,4,20,262,87,374,287,77%
0880,DENVER COUNTY 1,3605,GRANT RANCH K-8 SCHOOL,PK,3,4,2,16,21,46,25,54%
0880,DENVER COUNTY 1,3605,GRANT RANCH K-8 SCHOOL,KINDERGARTEN,2,5,0,23,34,64,30,47%
0880,DENVER COUNTY 1,3605,GRANT RANCH K-8 SCHOOL,1ST,1,8,4,21,47,81,34,42%
0880,DENVER COUNTY 1,3605,GRANT RANCH K-8 SCHOOL,2ND,0,6,2,32,24,64,40,63%
0880,DENVER COUNTY 1,3605,GRANT RANCH K-8 SCHOOL,3RD,1,8,2,33,39,83,44,53%
0880,DENVER COUNTY 1,3605,GRANT RANCH K-8 SCHOOL,4TH,1,4,3,27,31,66,35,53%
0880,DENVER COUNTY 1,3605,GRANT RANCH K-8 SCHOOL,5TH,2,5,3,36,33,79,46,58%
0880,DENVER COUNTY 1,3605,GRANT RANCH K-8 SCHOOL,6TH,0,10,2,38,31,81,50,62%
0880,DENVER COUNTY 1,3605,GRANT RANCH K-8 SCHOOL,7TH,2,7,1,35,30,75,45,60%
0880,DENVER COUNTY 1,3605,GRANT RANCH K-8 SCHOOL,8TH,2,10,0,40,29,81,52,64%
0880,DENVER COUNTY 1,3605,GRANT RANCH K-8 SCHOOL,SCHOOL TOTAL,14,67,19,301,319,720,401,56%
0880,DENVER COUNTY 1,3638,GREENLEE K-8 SCHOOL,PK,1,1,15,44,5,66,61,92%
0880,DENVER COUNTY 1,3638,GREENLEE K-8 SCHOOL,KINDERGARTEN,0,1,20,48,7,76,69,91%
0880,DENVER COUNTY 1,3638,GREENLEE K-8 SCHOOL,1ST,4,6,10,62,6,88,82,93%
0880,DENVER COUNTY 1,3638,GREENLEE K-8 SCHOOL,2ND,1,0,13,51,10,75,65,87%
0880,DENVER COUNTY 1,3638,GREENLEE K-8 SCHOOL,3RD,0,4,15,53,5,77,72,94%
0880,DENVER COUNTY 1,3638,GREENLEE K-8 SCHOOL,4TH,0,1,9,36,5,51,46,90%
0880,DENVER COUNTY 1,3638,GREENLEE K-8 SCHOOL,5TH,0,4,17,40,2,63,61,97%
0880,DENVER COUNTY 1,3638,GREENLEE K-8 SCHOOL,6TH,3,1,5,24,3,36,33,92%
0880,DENVER COUNTY 1,3638,GREENLEE K-8 SCHOOL,7TH,1,1,4,24,1,31,30,97%
0880,DENVER COUNTY 1,3638,GREENLEE K-8 SCHOOL,8TH,0,0,7,22,1,30,29,97%
0880,DENVER COUNTY 1,3638,GREENLEE K-8 SCHOOL,SCHOOL TOTAL,10,19,115,404,45,593,548,92%
0880,DENVER COUNTY 1,3641,GREEN VALLEY ELEMENTARY SCHOOL,PK,1,9,22,36,9,77,68,88%
0880,DENVER COUNTY 1,3641,GREEN VALLEY ELEMENTARY SCHOOL,HALF DAY K,0,0,0,0,1,1,0,0%
0880,DENVER COUNTY 1,3641,GREEN VALLEY ELEMENTARY SCHOOL,KINDERGARTEN,1,4,32,47,19,103,84,82%
0880,DENVER COUNTY 1,3641,GREEN VALLEY ELEMENTARY SCHOOL,1ST,0,9,34,33,19,95,76,80%
0880,DENVER COUNTY 1,3641,GREEN VALLEY ELEMENTARY SCHOOL,2ND,2,12,34,49,15,112,97,87%
0880,DENVER COUNTY 1,3641,GREEN VALLEY ELEMENTARY SCHOOL,3RD,2,8,36,36,13,95,82,86%
0880,DENVER COUNTY 1,3641,GREEN VALLEY ELEMENTARY SCHOOL,4TH,2,5,28,34,10,79,69,87%
0880,DENVER COUNTY 1,3641,GREEN VALLEY ELEMENTARY SCHOOL,5TH,2,8,30,44,11,95,84,88%
0880,DENVER COUNTY 1,3641,GREEN VALLEY ELEMENTARY SCHOOL,SCHOOL TOTAL,10,55,216,279,97,657,560,85%
0880,DENVER COUNTY 1,3647,GREENWOOD ELEMENTARY SCHOOL,PK,0,0,2,46,2,50,48,96%
0880,DENVER COUNTY 1,3647,GREENWOOD ELEMENTARY SCHOOL,HALF DAY K,0,0,0,1,0,1,1,100%
0880,DENVER COUNTY 1,3647,GREENWOOD ELEMENTARY SCHOOL,KINDERGARTEN,0,2,16,81,4,103,99,96%
0880,DENVER COUNTY 1,3647,GREENWOOD ELEMENTARY SCHOOL,1ST,0,5,15,63,7,90,83,92%
0880,DENVER COUNTY 1,3647,GREENWOOD ELEMENTARY SCHOOL,2ND,0,1,15,86,10,112,102,91%
0880,DENVER COUNTY 1,3647,GREENWOOD ELEMENTARY SCHOOL,3RD,0,3,11,85,5,104,99,95%
0880,DENVER COUNTY 1,3647,GREENWOOD ELEMENTARY SCHOOL,4TH,0,1,9,69,4,83,79,95%
0880,DENVER COUNTY 1,3647,GREENWOOD ELEMENTARY SCHOOL,5TH,0,1,12,65,7,85,78,92%
0880,DENVER COUNTY 1,3647,GREENWOOD ELEMENTARY SCHOOL,6TH,0,5,4,50,1,60,59,98%
0880,DENVER COUNTY 1,3647,GREENWOOD ELEMENTARY SCHOOL,7TH,0,1,6,38,0,45,45,100%
0880,DENVER COUNTY 1,3647,GREENWOOD ELEMENTARY SCHOOL,8TH,0,4,7,38,0,49,49,100%
0880,DENVER COUNTY 1,3647,GREENWOOD ELEMENTARY SCHOOL,SCHOOL TOTAL,0,23,97,622,40,782,742,95%
0880,DENVER COUNTY 1,3704,GUST ELEMENTARY SCHOOL,PK,0,6,5,90,21,122,101,83%
0880,DENVER COUNTY 1,3704,GUST ELEMENTARY SCHOOL,KINDERGARTEN,1,3,3,65,27,99,72,73%
0880,DENVER COUNTY 1,3704,GUST ELEMENTARY SCHOOL,1ST,0,5,0,56,16,77,61,79%
0880,DENVER COUNTY 1,3704,GUST ELEMENTARY SCHOOL,2ND,0,6,4,45,13,68,55,81%
0880,DENVER COUNTY 1,3704,GUST ELEMENTARY SCHOOL,3RD,0,3,3,48,11,65,54,83%
0880,DENVER COUNTY 1,3704,GUST ELEMENTARY SCHOOL,4TH,1,5,2,45,7,60,53,88%
0880,DENVER COUNTY 1,3704,GUST ELEMENTARY SCHOOL,5TH,0,6,2,50,12,70,58,83%
0880,DENVER COUNTY 1,3704,GUST ELEMENTARY SCHOOL,SCHOOL TOTAL,2,34,19,399,107,561,454,81%
0880,DENVER COUNTY 1,3746,HAMILTON MIDDLE SCHOOL,6TH,2,12,79,90,167,350,183,52%
0880,DENVER COUNTY 1,3746,HAMILTON MIDDLE SCHOOL,7TH,6,17,60,83,146,312,166,53%
0880,DENVER COUNTY 1,3746,HAMILTON MIDDLE SCHOOL,8TH,5,19,63,65,154,306,152,50%
0880,DENVER COUNTY 1,3746,HAMILTON MIDDLE SCHOOL,SCHOOL TOTAL,13,48,202,238,467,968,501,52%
0880,DENVER COUNTY 1,3778,HARRINGTON ELEMENTARY SCHOOL,PK,1,1,5,34,7,48,41,85%
0880,DENVER COUNTY 1,3778,HARRINGTON ELEMENTARY SCHOOL,KINDERGARTEN,0,0,14,53,1,68,67,99%
0880,DENVER COUNTY 1,3778,HARRINGTON ELEMENTARY SCHOOL,1ST,1,1,8,52,3,65,62,95%
0880,DENVER COUNTY 1,3778,HARRINGTON ELEMENTARY SCHOOL,2ND,1,0,8,56,5,70,65,93%
0880,DENVER COUNTY 1,3778,HARRINGTON ELEMENTARY SCHOOL,3RD,0,0,8,48,0,56,56,100%
0880,DENVER COUNTY 1,3778,HARRINGTON ELEMENTARY SCHOOL,4TH,0,1,10,47,2,60,58,97%
0880,DENVER COUNTY 1,3778,HARRINGTON ELEMENTARY SCHOOL,5TH,0,1,7,43,1,52,51,98%
0880,DENVER COUNTY 1,3778,HARRINGTON ELEMENTARY SCHOOL,6TH,0,2,9,43,2,56,54,96%
0880,DENVER COUNTY 1,3778,HARRINGTON ELEMENTARY SCHOOL,SCHOOL TOTAL,3,6,69,376,21,475,454,96%
0880,DENVER COUNTY 1,3987,HIGHLINE ACADEMY CHARTER SCHOOL,KINDERGARTEN,0,4,9,3,30,46,16,35%
0880,DENVER COUNTY 1,3987,HIGHLINE ACADEMY CHARTER SCHOOL,1ST,0,0,13,7,33,53,20,38%
0880,DENVER COUNTY 1,3987,HIGHLINE ACADEMY CHARTER SCHOOL,2ND,2,7,15,8,22,54,32,59%
0880,DENVER COUNTY 1,3987,HIGHLINE ACADEMY CHARTER SCHOOL,3RD,0,3,13,8,30,54,24,44%
0880,DENVER COUNTY 1,3987,HIGHLINE ACADEMY CHARTER SCHOOL,4TH,1,1,14,7,29,52,23,44%
0880,DENVER COUNTY 1,3987,HIGHLINE ACADEMY CHARTER SCHOOL,5TH,0,2,17,5,30,54,24,44%
0880,DENVER COUNTY 1,3987,HIGHLINE ACADEMY CHARTER SCHOOL,6TH,0,4,14,5,29,52,23,44%
0880,DENVER COUNTY 1,3987,HIGHLINE ACADEMY CHARTER SCHOOL,7TH,0,3,16,4,30,53,23,43%
0880,DENVER COUNTY 1,3987,HIGHLINE ACADEMY CHARTER SCHOOL,8TH,0,3,14,7,22,46,24,52%
0880,DENVER COUNTY 1,3987,HIGHLINE ACADEMY CHARTER SCHOOL,SCHOOL TOTAL,3,27,125,54,255,464,209,45%
0880,DENVER COUNTY 1,3990,HILL CAMPUS OF ARTS AND SCIENCES,6TH,1,11,55,83,147,297,150,51%
0880,DENVER COUNTY 1,3990,HILL CAMPUS OF ARTS AND SCIENCES,7TH,4,5,69,78,98,254,156,61%
0880,DENVER COUNTY 1,3990,HILL CAMPUS OF ARTS AND SCIENCES,8TH,2,10,82,90,106,290,184,63%
0880,DENVER COUNTY 1,3990,HILL CAMPUS OF ARTS AND SCIENCES,SCHOOL TOTAL,7,26,206,251,351,841,490,58%
0880,DENVER COUNTY 1,4074,HOLM ELEMENTARY SCHOOL,PK,0,2,6,21,5,34,29,85%
0880,DENVER COUNTY 1,4074,HOLM ELEMENTARY SCHOOL,HALF DAY K,1,2,8,4,9,24,15,63%
0880,DENVER COUNTY 1,4074,HOLM ELEMENTARY SCHOOL,KINDERGARTEN,1,9,14,32,15,71,56,79%
0880,DENVER COUNTY 1,4074,HOLM ELEMENTARY SCHOOL,1ST,3,6,21,58,19,107,88,82%
0880,DENVER COUNTY 1,4074,HOLM ELEMENTARY SCHOOL,2ND,2,6,22,37,16,83,67,81%
0880,DENVER COUNTY 1,4074,HOLM ELEMENTARY SCHOOL,3RD,3,1,18,40,20,82,62,76%
0880,DENVER COUNTY 1,4074,HOLM ELEMENTARY SCHOOL,4TH,2,3,15,39,13,72,59,82%
0880,DENVER COUNTY 1,4074,HOLM ELEMENTARY SCHOOL,5TH,1,2,11,32,11,57,46,81%
0880,DENVER COUNTY 1,4074,HOLM ELEMENTARY SCHOOL,SCHOOL TOTAL,13,31,115,263,108,530,422,80%
0880,DENVER COUNTY 1,4140,HOWELL K-8 SCHOOL,PK,0,1,5,54,4,64,60,94%
0880,DENVER COUNTY 1,4140,HOWELL K-8 SCHOOL,KINDERGARTEN,1,0,14,52,6,73,67,92%
0880,DENVER COUNTY 1,4140,HOWELL K-8 SCHOOL,1ST,0,1,12,61,2,76,74,97%
0880,DENVER COUNTY 1,4140,HOWELL K-8 SCHOOL,2ND,0,1,14,48,6,69,63,91%
0880,DENVER COUNTY 1,4140,HOWELL K-8 SCHOOL,3RD,0,1,21,54,5,81,76,94%
0880,DENVER COUNTY 1,4140,HOWELL K-8 SCHOOL,4TH,0,1,20,39,2,62,60,97%
0880,DENVER COUNTY 1,4140,HOWELL K-8 SCHOOL,5TH,0,0,15,49,2,66,64,97%
0880,DENVER COUNTY 1,4140,HOWELL K-8 SCHOOL,6TH,0,1,22,69,0,92,92,100%
0880,DENVER COUNTY 1,4140,HOWELL K-8 SCHOOL,7TH,0,2,18,63,2,85,83,98%
0880,DENVER COUNTY 1,4140,HOWELL K-8 SCHOOL,8TH,0,0,28,61,3,92,89,97%
0880,DENVER COUNTY 1,4140,HOWELL K-8 SCHOOL,SCHOOL TOTAL,1,8,169,550,32,760,728,96%
0880,DENVER COUNTY 1,4444,JOHN F KENNEDY HIGH SCHOOL,9TH,7,21,6,274,80,388,308,79%
0880,DENVER COUNTY 1,4444,JOHN F KENNEDY HIGH SCHOOL,10TH,6,21,6,192,72,297,225,76%
0880,DENVER COUNTY 1,4444,JOHN F KENNEDY HIGH SCHOOL,11TH,3,20,4,130,57,214,157,73%
0880,DENVER COUNTY 1,4444,JOHN F KENNEDY HIGH SCHOOL,12TH,7,16,2,139,58,222,164,74%
0880,DENVER COUNTY 1,4444,JOHN F KENNEDY HIGH SCHOOL,SCHOOL TOTAL,23,78,18,735,267,1121,854,76%
0880,DENVER COUNTY 1,4450,JOHNSON ELEMENTARY SCHOOL,PK,0,2,0,29,1,32,31,97%
0880,DENVER COUNTY 1,4450,JOHNSON ELEMENTARY SCHOOL,KINDERGARTEN,1,1,1,50,11,64,53,83%
0880,DENVER COUNTY 1,4450,JOHNSON ELEMENTARY SCHOOL,1ST,1,0,0,59,5,65,60,92%
0880,DENVER COUNTY 1,4450,JOHNSON ELEMENTARY SCHOOL,2ND,0,2,2,60,7,71,64,90%
0880,DENVER COUNTY 1,4450,JOHNSON ELEMENTARY SCHOOL,3RD,2,1,0,56,2,61,59,97%
0880,DENVER COUNTY 1,4450,JOHNSON ELEMENTARY SCHOOL,4TH,3,0,3,43,1,50,49,98%
0880,DENVER COUNTY 1,4450,JOHNSON ELEMENTARY SCHOOL,5TH,0,2,3,45,3,53,50,94%
0880,DENVER COUNTY 1,4450,JOHNSON ELEMENTARY SCHOOL,SCHOOL TOTAL,7,8,9,342,30,396,366,92%
0880,DENVER COUNTY 1,4494,JUSTICE HIGH SCHOOL DENVER,9TH,3,0,15,27,4,49,45,92%
0880,DENVER COUNTY 1,4494,JUSTICE HIGH SCHOOL DENVER,10TH,0,0,8,15,2,25,23,92%
0880,DENVER COUNTY 1,4494,JUSTICE HIGH SCHOOL DENVER,11TH,2,0,3,6,3,14,11,79%
0880,DENVER COUNTY 1,4494,JUSTICE HIGH SCHOOL DENVER,12TH,0,0,1,5,1,7,6,86%
0880,DENVER COUNTY 1,4494,JUSTICE HIGH SCHOOL DENVER,SCHOOL TOTAL,5,0,27,53,10,95,85,89%
0880,DENVER COUNTY 1,4498,KAISER ELEMENTARY SCHOOL,PK,0,3,0,17,43,63,20,32%
0880,DENVER COUNTY 1,4498,KAISER ELEMENTARY SCHOOL,KINDERGARTEN,0,3,1,13,37,54,17,31%
0880,DENVER COUNTY 1,4498,KAISER ELEMENTARY SCHOOL,1ST,0,0,1,25,24,50,26,52%
0880,DENVER COUNTY 1,4498,KAISER ELEMENTARY SCHOOL,2ND,0,0,0,26,18,44,26,59%
0880,DENVER COUNTY 1,4498,KAISER ELEMENTARY SCHOOL,3RD,0,3,0,20,18,41,23,56%
0880,DENVER COUNTY 1,4498,KAISER ELEMENTARY SCHOOL,4TH,0,1,1,26,11,39,28,72%
0880,DENVER COUNTY 1,4498,KAISER ELEMENTARY SCHOOL,5TH,1,4,0,19,11,35,24,69%
0880,DENVER COUNTY 1,4498,KAISER ELEMENTARY SCHOOL,SCHOOL TOTAL,1,14,3,146,162,326,164,50%
0880,DENVER COUNTY 1,4656,KEPNER MIDDLE SCHOOL,6TH,2,4,7,310,24,347,323,93%
0880,DENVER COUNTY 1,4656,KEPNER MIDDLE SCHOOL,7TH,4,6,6,332,27,375,348,93%
0880,DENVER COUNTY 1,4656,KEPNER MIDDLE SCHOOL,8TH,1,6,2,282,25,316,291,92%
0880,DENVER COUNTY 1,4656,KEPNER MIDDLE SCHOOL,SCHOOL TOTAL,7,16,15,924,76,1038,962,93%
0880,DENVER COUNTY 1,4730,KIPP DENVER COLLEGIATE HIGH SCHOOL,9TH,1,0,1,116,11,129,118,91%
0880,DENVER COUNTY 1,4730,KIPP DENVER COLLEGIATE HIGH SCHOOL,SCHOOL TOTAL,1,0,1,116,11,129,118,91%
0880,DENVER COUNTY 1,4732,KIPP SUNSHINE PEAK ACADEMY,5TH,0,2,1,99,2,104,102,98%
0880,DENVER COUNTY 1,4732,KIPP SUNSHINE PEAK ACADEMY,6TH,1,1,0,101,0,103,103,100%
0880,DENVER COUNTY 1,4732,KIPP SUNSHINE PEAK ACADEMY,7TH,0,2,0,87,1,90,89,99%
0880,DENVER COUNTY 1,4732,KIPP SUNSHINE PEAK ACADEMY,8TH,1,1,2,69,1,74,73,99%
0880,DENVER COUNTY 1,4732,KIPP SUNSHINE PEAK ACADEMY,SCHOOL TOTAL,2,6,3,356,4,371,367,99%
0880,DENVER COUNTY 1,4762,KNAPP ELEMENTARY SCHOOL,PK,0,0,1,60,4,65,61,94%
0880,DENVER COUNTY 1,4762,KNAPP ELEMENTARY SCHOOL,KINDERGARTEN,3,2,1,86,11,103,92,89%
0880,DENVER COUNTY 1,4762,KNAPP ELEMENTARY SCHOOL,1ST,2,0,1,88,5,96,91,95%
0880,DENVER COUNTY 1,4762,KNAPP ELEMENTARY SCHOOL,2ND,1,0,1,96,7,105,98,93%
0880,DENVER COUNTY 1,4762,KNAPP ELEMENTARY SCHOOL,3RD,0,0,1,94,5,100,95,95%
0880,DENVER COUNTY 1,4762,KNAPP ELEMENTARY SCHOOL,4TH,1,1,0,98,2,102,100,98%
0880,DENVER COUNTY 1,4762,KNAPP ELEMENTARY SCHOOL,5TH,0,0,1,57,3,61,58,95%
0880,DENVER COUNTY 1,4762,KNAPP ELEMENTARY SCHOOL,SCHOOL TOTAL,7,3,6,579,37,632,595,94%
0880,DENVER COUNTY 1,4782,KNIGHT FUNDAMENTAL SCHOOL,PK,1,0,22,18,12,53,41,77%
0880,DENVER COUNTY 1,4782,KNIGHT FUNDAMENTAL SCHOOL,KINDERGARTEN,0,0,25,6,6,37,31,84%
0880,DENVER COUNTY 1,4782,KNIGHT FUNDAMENTAL SCHOOL,1ST,0,0,35,11,4,50,46,92%
0880,DENVER COUNTY 1,4782,KNIGHT FUNDAMENTAL SCHOOL,2ND,1,1,38,7,3,50,47,94%
0880,DENVER COUNTY 1,4782,KNIGHT FUNDAMENTAL SCHOOL,3RD,0,0,42,5,1,48,47,98%
0880,DENVER COUNTY 1,4782,KNIGHT FUNDAMENTAL SCHOOL,4TH,0,1,38,8,1,48,47,98%
0880,DENVER COUNTY 1,4782,KNIGHT FUNDAMENTAL SCHOOL,5TH,0,0,37,6,0,43,43,100%
0880,DENVER COUNTY 1,4782,KNIGHT FUNDAMENTAL SCHOOL,SCHOOL TOTAL,2,2,237,61,27,329,302,92%
0880,DENVER COUNTY 1,4795,KUNSMILLER CREATIVE ARTS ACADEMY,KINDERGARTEN,0,1,1,25,24,51,27,53%
0880,DENVER COUNTY 1,4795,KUNSMILLER CREATIVE ARTS ACADEMY,1ST,0,0,3,32,11,46,35,76%
0880,DENVER COUNTY 1,4795,KUNSMILLER CREATIVE ARTS ACADEMY,2ND,0,2,4,28,13,47,34,72%
0880,DENVER COUNTY 1,4795,KUNSMILLER CREATIVE ARTS ACADEMY,3RD,0,2,3,33,13,51,38,75%
0880,DENVER COUNTY 1,4795,KUNSMILLER CREATIVE ARTS ACADEMY,4TH,1,1,2,28,17,49,32,65%
0880,DENVER COUNTY 1,4795,KUNSMILLER CREATIVE ARTS ACADEMY,5TH,0,1,4,35,13,53,40,75%
0880,DENVER COUNTY 1,4795,KUNSMILLER CREATIVE ARTS ACADEMY,6TH,1,8,8,115,23,155,132,85%
0880,DENVER COUNTY 1,4795,KUNSMILLER CREATIVE ARTS ACADEMY,7TH,1,2,1,38,13,55,42,76%
0880,DENVER COUNTY 1,4795,KUNSMILLER CREATIVE ARTS ACADEMY,8TH,2,2,1,122,10,137,127,93%
0880,DENVER COUNTY 1,4795,KUNSMILLER CREATIVE ARTS ACADEMY,SCHOOL TOTAL,5,19,27,456,137,644,507,79%
0880,DENVER COUNTY 1,4910,LAKE MIDDLE SCHOOL,6TH,3,6,5,161,15,190,175,92%
0880,DENVER COUNTY 1,4910,LAKE MIDDLE SCHOOL,7TH,1,1,8,141,18,169,151,89%
0880,DENVER COUNTY 1,4910,LAKE MIDDLE SCHOOL,8TH,3,0,15,174,17,209,192,92%
0880,DENVER COUNTY 1,4910,LAKE MIDDLE SCHOOL,SCHOOL TOTAL,7,7,28,476,50,568,518,91%
0880,DENVER COUNTY 1,5129,LIFE SKILLS CENTER OF DENVER,9TH,0,0,21,56,12,89,77,87%
0880,DENVER COUNTY 1,5129,LIFE SKILLS CENTER OF DENVER,10TH,2,0,20,68,12,102,90,88%
0880,DENVER COUNTY 1,5129,LIFE SKILLS CENTER OF DENVER,11TH,2,0,28,42,13,85,72,85%
0880,DENVER COUNTY 1,5129,LIFE SKILLS CENTER OF DENVER,12TH,2,1,9,15,5,32,27,84%
0880,DENVER COUNTY 1,5129,LIFE SKILLS CENTER OF DENVER,SCHOOL TOTAL,6,1,78,181,42,308,266,86%
0880,DENVER COUNTY 1,5158,LINCOLN ELEMENTARY SCHOOL,PK,0,8,3,15,54,80,26,33%
0880,DENVER COUNTY 1,5158,LINCOLN ELEMENTARY SCHOOL,KINDERGARTEN,1,3,1,11,35,51,16,31%
0880,DENVER COUNTY 1,5158,LINCOLN ELEMENTARY SCHOOL,1ST,1,3,1,17,30,52,22,42%
0880,DENVER COUNTY 1,5158,LINCOLN ELEMENTARY SCHOOL,2ND,4,3,2,17,23,49,26,53%
0880,DENVER COUNTY 1,5158,LINCOLN ELEMENTARY SCHOOL,3RD,1,4,2,13,25,45,20,44%
0880,DENVER COUNTY 1,5158,LINCOLN ELEMENTARY SCHOOL,4TH,0,1,2,16,15,34,19,56%
0880,DENVER COUNTY 1,5158,LINCOLN ELEMENTARY SCHOOL,5TH,0,1,1,13,7,22,15,68%
0880,DENVER COUNTY 1,5158,LINCOLN ELEMENTARY SCHOOL,SCHOOL TOTAL,7,23,12,102,189,333,144,43%
0880,DENVER COUNTY 1,5342,LOWRY ELEMENTARY SCHOOL,PK,0,1,4,7,23,35,12,34%
0880,DENVER COUNTY 1,5342,LOWRY ELEMENTARY SCHOOL,HALF DAY K,0,0,2,2,5,9,4,44%
0880,DENVER COUNTY 1,5342,LOWRY ELEMENTARY SCHOOL,KINDERGARTEN,2,7,17,10,36,72,36,50%
0880,DENVER COUNTY 1,5342,LOWRY ELEMENTARY SCHOOL,1ST,0,4,12,12,49,77,28,36%
0880,DENVER COUNTY 1,5342,LOWRY ELEMENTARY SCHOOL,2ND,0,1,21,15,42,79,37,47%
0880,DENVER COUNTY 1,5342,LOWRY ELEMENTARY SCHOOL,3RD,0,1,21,12,34,68,34,50%
0880,DENVER COUNTY 1,5342,LOWRY ELEMENTARY SCHOOL,4TH,1,5,17,9,36,68,32,47%
0880,DENVER COUNTY 1,5342,LOWRY ELEMENTARY SCHOOL,5TH,1,2,20,23,29,75,46,61%
0880,DENVER COUNTY 1,5342,LOWRY ELEMENTARY SCHOOL,SCHOOL TOTAL,4,21,114,90,254,483,229,47%
0880,DENVER COUNTY 1,5430,MANNY MARTINEZ MIDDLE SCHOOL,6TH,0,0,4,81,5,90,85,94%
0880,DENVER COUNTY 1,5430,MANNY MARTINEZ MIDDLE SCHOOL,7TH,2,0,7,49,2,60,58,97%
0880,DENVER COUNTY 1,5430,MANNY MARTINEZ MIDDLE SCHOOL,8TH,0,0,5,50,4,59,55,93%
0880,DENVER COUNTY 1,5430,MANNY MARTINEZ MIDDLE SCHOOL,SCHOOL TOTAL,2,0,16,180,11,209,198,95%
0880,DENVER COUNTY 1,5448,MANUAL HIGH SCHOOL,9TH,0,0,39,53,6,98,92,94%
0880,DENVER COUNTY 1,5448,MANUAL HIGH SCHOOL,10TH,0,1,41,64,7,113,106,94%
0880,DENVER COUNTY 1,5448,MANUAL HIGH SCHOOL,11TH,0,0,44,44,4,92,88,96%
0880,DENVER COUNTY 1,5448,MANUAL HIGH SCHOOL,SCHOOL TOTAL,0,1,124,161,17,303,286,94%
0880,DENVER COUNTY 1,5578,MARRAMA ELEMENTARY SCHOOL,PK,0,1,9,22,3,35,32,91%
0880,DENVER COUNTY 1,5578,MARRAMA ELEMENTARY SCHOOL,HALF DAY K,0,0,1,1,4,6,2,33%
0880,DENVER COUNTY 1,5578,MARRAMA ELEMENTARY SCHOOL,KINDERGARTEN,0,3,17,41,13,74,61,82%
0880,DENVER COUNTY 1,5578,MARRAMA ELEMENTARY SCHOOL,1ST,0,4,25,40,15,84,69,82%
0880,DENVER COUNTY 1,5578,MARRAMA ELEMENTARY SCHOOL,2ND,2,3,20,37,18,80,62,78%
0880,DENVER COUNTY 1,5578,MARRAMA ELEMENTARY SCHOOL,3RD,0,5,22,31,9,67,58,87%
0880,DENVER COUNTY 1,5578,MARRAMA ELEMENTARY SCHOOL,4TH,1,6,29,28,13,77,64,83%
0880,DENVER COUNTY 1,5578,MARRAMA ELEMENTARY SCHOOL,5TH,0,3,36,53,13,105,92,88%
0880,DENVER COUNTY 1,5578,MARRAMA ELEMENTARY SCHOOL,SCHOOL TOTAL,3,25,159,253,88,528,440,83%
0880,DENVER COUNTY 1,5605,MARTIN LUTHER KING MIDDLE COLLEGE,6TH,2,9,80,138,27,256,229,89%
0880,DENVER COUNTY 1,5605,MARTIN LUTHER KING MIDDLE COLLEGE,7TH,1,9,64,140,21,235,214,91%
0880,DENVER COUNTY 1,5605,MARTIN LUTHER KING MIDDLE COLLEGE,8TH,0,8,82,161,19,270,251,93%
0880,DENVER COUNTY 1,5605,MARTIN LUTHER KING MIDDLE COLLEGE,9TH,0,10,23,66,21,120,99,83%
0880,DENVER COUNTY 1,5605,MARTIN LUTHER KING MIDDLE COLLEGE,10TH,1,7,18,73,10,109,99,91%
0880,DENVER COUNTY 1,5605,MARTIN LUTHER KING MIDDLE COLLEGE,11TH,1,8,13,41,14,77,63,82%
0880,DENVER COUNTY 1,5605,MARTIN LUTHER KING MIDDLE COLLEGE,12TH,0,2,27,39,7,75,68,91%
0880,DENVER COUNTY 1,5605,MARTIN LUTHER KING MIDDLE COLLEGE,SCHOOL TOTAL,5,53,307,658,119,1142,1023,90%
0880,DENVER COUNTY 1,5608,MATHEMATICS AND SCIENCE LEADERSHIP ACADEMY,KINDERGARTEN,0,0,4,53,3,60,57,95%
0880,DENVER COUNTY 1,5608,MATHEMATICS AND SCIENCE LEADERSHIP ACADEMY,1ST,0,0,0,29,2,31,29,94%
0880,DENVER COUNTY 1,5608,MATHEMATICS AND SCIENCE LEADERSHIP ACADEMY,2ND,0,0,1,41,1,43,42,98%
0880,DENVER COUNTY 1,5608,MATHEMATICS AND SCIENCE LEADERSHIP ACADEMY,SCHOOL TOTAL,0,0,5,123,6,134,128,96%
0880,DENVER COUNTY 1,5644,MAXWELL ELEMENTARY SCHOOL,PK,0,3,9,60,8,80,72,90%
0880,DENVER COUNTY 1,5644,MAXWELL ELEMENTARY SCHOOL,HALF DAY K,0,0,0,0,1,1,0,0%
0880,DENVER COUNTY 1,5644,MAXWELL ELEMENTARY SCHOOL,KINDERGARTEN,1,0,16,51,7,75,68,91%
0880,DENVER COUNTY 1,5644,MAXWELL ELEMENTARY SCHOOL,1ST,0,2,14,66,11,93,82,88%
0880,DENVER COUNTY 1,5644,MAXWELL ELEMENTARY SCHOOL,2ND,0,0,19,60,8,87,79,91%
0880,DENVER COUNTY 1,5644,MAXWELL ELEMENTARY SCHOOL,3RD,0,0,16,67,5,88,83,94%
0880,DENVER COUNTY 1,5644,MAXWELL ELEMENTARY SCHOOL,4TH,0,0,19,73,5,97,92,95%
0880,DENVER COUNTY 1,5644,MAXWELL ELEMENTARY SCHOOL,5TH,0,1,19,58,5,83,78,94%
0880,DENVER COUNTY 1,5644,MAXWELL ELEMENTARY SCHOOL,SCHOOL TOTAL,1,6,112,435,50,604,554,92%
0880,DENVER COUNTY 1,5685,MC GLONE ELEMENTARY SCHOOL,PK,1,0,13,35,16,65,49,75%
0880,DENVER COUNTY 1,5685,MC GLONE ELEMENTARY SCHOOL,KINDERGARTEN,0,1,19,58,15,93,78,84%
0880,DENVER COUNTY 1,5685,MC GLONE ELEMENTARY SCHOOL,1ST,0,1,15,53,13,82,69,84%
0880,DENVER COUNTY 1,5685,MC GLONE ELEMENTARY SCHOOL,2ND,0,1,15,57,11,84,73,87%
0880,DENVER COUNTY 1,5685,MC GLONE ELEMENTARY SCHOOL,3RD,0,0,10,45,10,65,55,85%
0880,DENVER COUNTY 1,5685,MC GLONE ELEMENTARY SCHOOL,4TH,1,0,11,60,4,76,72,95%
0880,DENVER COUNTY 1,5685,MC GLONE ELEMENTARY SCHOOL,5TH,0,0,13,46,3,62,59,95%
0880,DENVER COUNTY 1,5685,MC GLONE ELEMENTARY SCHOOL,SCHOOL TOTAL,2,3,96,354,72,527,455,86%
0880,DENVER COUNTY 1,5702,MC KINLEY-THATCHER ELEMENTARY SCHOOL,PK,0,0,0,10,10,20,10,50%
0880,DENVER COUNTY 1,5702,MC KINLEY-THATCHER ELEMENTARY SCHOOL,KINDERGARTEN,0,2,1,11,13,27,14,52%
0880,DENVER COUNTY 1,5702,MC KINLEY-THATCHER ELEMENTARY SCHOOL,1ST,1,1,2,21,15,40,25,63%
0880,DENVER COUNTY 1,5702,MC KINLEY-THATCHER ELEMENTARY SCHOOL,2ND,0,1,2,15,19,37,18,49%
0880,DENVER COUNTY 1,5702,MC KINLEY-THATCHER ELEMENTARY SCHOOL,3RD,0,2,2,21,20,45,25,56%
0880,DENVER COUNTY 1,5702,MC KINLEY-THATCHER ELEMENTARY SCHOOL,4TH,0,1,1,11,24,37,13,35%
0880,DENVER COUNTY 1,5702,MC KINLEY-THATCHER ELEMENTARY SCHOOL,5TH,0,1,3,11,22,37,15,41%
0880,DENVER COUNTY 1,5702,MC KINLEY-THATCHER ELEMENTARY SCHOOL,SCHOOL TOTAL,1,8,11,100,123,243,120,49%
0880,DENVER COUNTY 1,5716,MC MEEN ELEMENTARY SCHOOL,PK,0,3,12,25,12,52,40,77%
0880,DENVER COUNTY 1,5716,MC MEEN ELEMENTARY SCHOOL,HALF DAY K,0,0,0,0,1,1,0,0%
0880,DENVER COUNTY 1,5716,MC MEEN ELEMENTARY SCHOOL,KINDERGARTEN,3,6,31,44,50,134,84,63%
0880,DENVER COUNTY 1,5716,MC MEEN ELEMENTARY SCHOOL,1ST,1,5,26,38,38,108,70,65%
0880,DENVER COUNTY 1,5716,MC MEEN ELEMENTARY SCHOOL,2ND,1,3,33,44,39,120,81,68%
0880,DENVER COUNTY 1,5716,MC MEEN ELEMENTARY SCHOOL,3RD,0,5,28,37,32,102,70,69%
0880,DENVER COUNTY 1,5716,MC MEEN ELEMENTARY SCHOOL,4TH,3,3,19,39,20,84,64,76%
0880,DENVER COUNTY 1,5716,MC MEEN ELEMENTARY SCHOOL,5TH,1,4,22,26,20,73,53,73%
0880,DENVER COUNTY 1,5716,MC MEEN ELEMENTARY SCHOOL,SCHOOL TOTAL,9,29,171,253,212,674,462,69%
0880,DENVER COUNTY 1,5826,MERRILL MIDDLE SCHOOL,6TH,7,19,26,76,55,183,128,70%
0880,DENVER COUNTY 1,5826,MERRILL MIDDLE SCHOOL,7TH,6,30,32,58,52,178,126,71%
0880,DENVER COUNTY 1,5826,MERRILL MIDDLE SCHOOL,8TH,5,28,35,44,52,164,112,68%
0880,DENVER COUNTY 1,5826,MERRILL MIDDLE SCHOOL,SCHOOL TOTAL,18,77,93,178,159,525,366,70%
0880,DENVER COUNTY 1,5844,CONTEMPORARY LEARNING ACADEMY HIGH SCHOOL,9TH,0,0,28,44,2,74,72,97%
0880,DENVER COUNTY 1,5844,CONTEMPORARY LEARNING ACADEMY HIGH SCHOOL,10TH,0,1,27,36,7,71,64,90%
0880,DENVER COUNTY 1,5844,CONTEMPORARY LEARNING ACADEMY HIGH SCHOOL,11TH,2,2,19,24,2,49,47,96%
0880,DENVER COUNTY 1,5844,CONTEMPORARY LEARNING ACADEMY HIGH SCHOOL,12TH,2,1,18,35,2,58,56,97%
0880,DENVER COUNTY 1,5844,CONTEMPORARY LEARNING ACADEMY HIGH SCHOOL,SCHOOL TOTAL,4,4,92,139,13,252,239,95%
0880,DENVER COUNTY 1,5995,MONTBELLO HIGH SCHOOL,9TH,1,9,160,382,29,581,552,95%
0880,DENVER COUNTY 1,5995,MONTBELLO HIGH SCHOOL,10TH,1,9,110,313,32,465,433,93%
0880,DENVER COUNTY 1,5995,MONTBELLO HIGH SCHOOL,11TH,1,8,120,151,17,297,280,94%
0880,DENVER COUNTY 1,5995,MONTBELLO HIGH SCHOOL,12TH,4,7,127,180,23,341,318,93%
0880,DENVER COUNTY 1,5995,MONTBELLO HIGH SCHOOL,SCHOOL TOTAL,7,33,517,1026,101,1684,1583,94%
0880,DENVER COUNTY 1,5998,OAKLAND ELEMENTARY SCHOOL,PK,0,0,9,37,3,49,46,94%
0880,DENVER COUNTY 1,5998,OAKLAND ELEMENTARY SCHOOL,KINDERGARTEN,0,2,20,55,6,83,77,93%
0880,DENVER COUNTY 1,5998,OAKLAND ELEMENTARY SCHOOL,1ST,0,3,26,51,8,88,80,91%
0880,DENVER COUNTY 1,5998,OAKLAND ELEMENTARY SCHOOL,2ND,1,0,16,57,6,80,74,93%
0880,DENVER COUNTY 1,5998,OAKLAND ELEMENTARY SCHOOL,3RD,0,2,26,48,5,81,76,94%
0880,DENVER COUNTY 1,5998,OAKLAND ELEMENTARY SCHOOL,4TH,0,1,27,36,3,67,64,96%
0880,DENVER COUNTY 1,5998,OAKLAND ELEMENTARY SCHOOL,5TH,0,1,25,51,3,80,77,96%
0880,DENVER COUNTY 1,5998,OAKLAND ELEMENTARY SCHOOL,SCHOOL TOTAL,1,9,149,335,34,528,494,94%
0880,DENVER COUNTY 1,6002,MONTCLAIR ELEMENTARY SCHOOL,PK,0,0,10,1,7,18,11,61%
0880,DENVER COUNTY 1,6002,MONTCLAIR ELEMENTARY SCHOOL,KINDERGARTEN,2,1,23,9,40,75,35,47%
0880,DENVER COUNTY 1,6002,MONTCLAIR ELEMENTARY SCHOOL,1ST,1,4,25,21,29,80,51,64%
0880,DENVER COUNTY 1,6002,MONTCLAIR ELEMENTARY SCHOOL,2ND,1,0,26,18,38,83,45,54%
0880,DENVER COUNTY 1,6002,MONTCLAIR ELEMENTARY SCHOOL,3RD,4,3,27,22,26,82,56,68%
0880,DENVER COUNTY 1,6002,MONTCLAIR ELEMENTARY SCHOOL,4TH,1,3,26,19,17,66,49,74%
0880,DENVER COUNTY 1,6002,MONTCLAIR ELEMENTARY SCHOOL,5TH,1,0,27,18,18,64,46,72%
0880,DENVER COUNTY 1,6002,MONTCLAIR ELEMENTARY SCHOOL,SCHOOL TOTAL,10,11,164,108,175,468,293,63%
0880,DENVER COUNTY 1,6088,MOORE K-8 SCHOOL,PK,0,0,5,7,9,21,12,57%
0880,DENVER COUNTY 1,6088,MOORE K-8 SCHOOL,HALF DAY K,0,0,1,0,5,6,1,17%
0880,DENVER COUNTY 1,6088,MOORE K-8 SCHOOL,KINDERGARTEN,0,1,13,13,23,50,27,54%
0880,DENVER COUNTY 1,6088,MOORE K-8 SCHOOL,1ST,1,2,10,15,16,44,28,64%
0880,DENVER COUNTY 1,6088,MOORE K-8 SCHOOL,2ND,0,0,9,11,19,39,20,51%
0880,DENVER COUNTY 1,6088,MOORE K-8 SCHOOL,3RD,3,2,14,20,25,64,39,61%
0880,DENVER COUNTY 1,6088,MOORE K-8 SCHOOL,4TH,2,0,9,13,17,41,24,59%
0880,DENVER COUNTY 1,6088,MOORE K-8 SCHOOL,5TH,2,2,9,17,13,43,30,70%
0880,DENVER COUNTY 1,6088,MOORE K-8 SCHOOL,6TH,1,1,23,20,14,59,45,76%
0880,DENVER COUNTY 1,6088,MOORE K-8 SCHOOL,7TH,1,2,3,13,7,26,19,73%
0880,DENVER COUNTY 1,6088,MOORE K-8 SCHOOL,8TH,0,0,10,8,6,24,18,75%
0880,DENVER COUNTY 1,6088,MOORE K-8 SCHOOL,SCHOOL TOTAL,10,10,106,137,154,417,263,63%
0880,DENVER COUNTY 1,6098,MOREY MIDDLE SCHOOL,6TH,2,12,73,61,83,231,148,64%
0880,DENVER COUNTY 1,6098,MOREY MIDDLE SCHOOL,7TH,1,12,90,71,103,277,174,63%
0880,DENVER COUNTY 1,6098,MOREY MIDDLE SCHOOL,8TH,4,8,102,94,92,300,208,69%
0880,DENVER COUNTY 1,6098,MOREY MIDDLE SCHOOL,SCHOOL TOTAL,7,32,265,226,278,808,530,66%
0880,DENVER COUNTY 1,6188,MUNROE ELEMENTARY SCHOOL,PK,0,0,1,48,0,49,49,100%
0880,DENVER COUNTY 1,6188,MUNROE ELEMENTARY SCHOOL,HALF DAY K,0,0,0,18,1,19,18,95%
0880,DENVER COUNTY 1,6188,MUNROE ELEMENTARY SCHOOL,KINDERGARTEN,0,0,0,66,7,73,66,90%
0880,DENVER COUNTY 1,6188,MUNROE ELEMENTARY SCHOOL,1ST,0,2,1,105,2,110,108,98%
0880,DENVER COUNTY 1,6188,MUNROE ELEMENTARY SCHOOL,2ND,0,1,1,72,3,77,74,96%
0880,DENVER COUNTY 1,6188,MUNROE ELEMENTARY SCHOOL,3RD,1,1,1,86,3,92,89,97%
0880,DENVER COUNTY 1,6188,MUNROE ELEMENTARY SCHOOL,4TH,1,0,1,76,1,79,78,99%
0880,DENVER COUNTY 1,6188,MUNROE ELEMENTARY SCHOOL,5TH,0,2,1,68,1,72,71,99%
0880,DENVER COUNTY 1,6188,MUNROE ELEMENTARY SCHOOL,SCHOOL TOTAL,2,6,6,539,18,571,553,97%
0880,DENVER COUNTY 1,6254,NEWLON ELEMENTARY SCHOOL,PK,0,0,0,32,0,32,32,100%
0880,DENVER COUNTY 1,6254,NEWLON ELEMENTARY SCHOOL,KINDERGARTEN,1,0,1,85,13,100,87,87%
0880,DENVER COUNTY 1,6254,NEWLON ELEMENTARY SCHOOL,1ST,0,1,1,87,3,92,89,97%
0880,DENVER COUNTY 1,6254,NEWLON ELEMENTARY SCHOOL,2ND,1,0,0,73,8,82,74,90%
0880,DENVER COUNTY 1,6254,NEWLON ELEMENTARY SCHOOL,3RD,1,0,1,85,6,93,87,94%
0880,DENVER COUNTY 1,6254,NEWLON ELEMENTARY SCHOOL,4TH,1,0,0,68,3,72,69,96%
0880,DENVER COUNTY 1,6254,NEWLON ELEMENTARY SCHOOL,5TH,0,0,0,63,2,65,63,97%
0880,DENVER COUNTY 1,6254,NEWLON ELEMENTARY SCHOOL,SCHOOL TOTAL,4,1,3,493,35,536,501,93%
0880,DENVER COUNTY 1,6314,NORTH HIGH SCHOOL,9TH,7,2,16,329,37,391,354,91%
0880,DENVER COUNTY 1,6314,NORTH HIGH SCHOOL,10TH,3,3,7,189,18,220,202,92%
0880,DENVER COUNTY 1,6314,NORTH HIGH SCHOOL,11TH,1,2,3,133,13,152,139,91%
0880,DENVER COUNTY 1,6314,NORTH HIGH SCHOOL,12TH,2,5,6,163,14,190,176,93%
0880,DENVER COUNTY 1,6314,NORTH HIGH SCHOOL,SCHOOL TOTAL,13,12,32,814,82,953,871,91%
0880,DENVER COUNTY 1,6350,BRUCE RANDOLPH SCHOOL,6TH,0,0,2,92,6,100,94,94%
0880,DENVER COUNTY 1,6350,BRUCE RANDOLPH SCHOOL,7TH,0,0,15,135,4,154,150,97%
0880,DENVER COUNTY 1,6350,BRUCE RANDOLPH SCHOOL,8TH,1,0,20,136,1,158,157,99%
0880,DENVER COUNTY 1,6350,BRUCE RANDOLPH SCHOOL,9TH,0,2,3,118,1,124,123,99%
0880,DENVER COUNTY 1,6350,BRUCE RANDOLPH SCHOOL,10TH,1,0,0,99,1,101,100,99%
0880,DENVER COUNTY 1,6350,BRUCE RANDOLPH SCHOOL,11TH,0,0,0,84,4,88,84,95%
0880,DENVER COUNTY 1,6350,BRUCE RANDOLPH SCHOOL,12TH,0,1,6,65,2,74,72,97%
0880,DENVER COUNTY 1,6350,BRUCE RANDOLPH SCHOOL,SCHOOL TOTAL,2,3,46,729,19,799,780,98%
0880,DENVER COUNTY 1,6394,NORTHEAST ACADEMY CHARTER SCHOOL,KINDERGARTEN,2,1,24,13,7,47,40,85%
0880,DENVER COUNTY 1,6394,NORTHEAST ACADEMY CHARTER SCHOOL,1ST,0,0,44,11,3,58,55,95%
0880,DENVER COUNTY 1,6394,NORTHEAST ACADEMY CHARTER SCHOOL,2ND,0,2,37,11,2,52,50,96%
0880,DENVER COUNTY 1,6394,NORTHEAST ACADEMY CHARTER SCHOOL,3RD,0,0,48,12,2,62,60,97%
0880,DENVER COUNTY 1,6394,NORTHEAST ACADEMY CHARTER SCHOOL,4TH,0,0,38,17,3,58,55,95%
0880,DENVER COUNTY 1,6394,NORTHEAST ACADEMY CHARTER SCHOOL,5TH,0,0,34,23,0,57,57,100%
0880,DENVER COUNTY 1,6394,NORTHEAST ACADEMY CHARTER SCHOOL,6TH,0,0,34,16,2,52,50,96%
0880,DENVER COUNTY 1,6394,NORTHEAST ACADEMY CHARTER SCHOOL,7TH,0,1,28,19,2,50,48,96%
0880,DENVER COUNTY 1,6394,NORTHEAST ACADEMY CHARTER SCHOOL,8TH,1,0,16,8,0,25,25,100%
0880,DENVER COUNTY 1,6394,NORTHEAST ACADEMY CHARTER SCHOOL,SCHOOL TOTAL,3,4,303,130,21,461,440,95%
0880,DENVER COUNTY 1,6397,ACADEMIA ANA MARIE SANDOVAL,PK,0,2,0,34,71,107,36,34%
0880,DENVER COUNTY 1,6397,ACADEMIA ANA MARIE SANDOVAL,KINDERGARTEN,0,1,0,19,37,57,20,35%
0880,DENVER COUNTY 1,6397,ACADEMIA ANA MARIE SANDOVAL,1ST,0,0,0,28,23,51,28,55%
0880,DENVER COUNTY 1,6397,ACADEMIA ANA MARIE SANDOVAL,2ND,1,0,0,26,17,44,27,61%
0880,DENVER COUNTY 1,6397,ACADEMIA ANA MARIE SANDOVAL,3RD,0,0,0,20,16,36,20,56%
0880,DENVER COUNTY 1,6397,ACADEMIA ANA MARIE SANDOVAL,4TH,2,1,0,17,12,32,20,63%
0880,DENVER COUNTY 1,6397,ACADEMIA ANA MARIE SANDOVAL,5TH,0,0,0,22,9,31,22,71%
0880,DENVER COUNTY 1,6397,ACADEMIA ANA MARIE SANDOVAL,6TH,0,0,0,23,5,28,23,82%
0880,DENVER COUNTY 1,6397,ACADEMIA ANA MARIE SANDOVAL,SCHOOL TOTAL,3,4,0,189,190,386,196,51%
0880,DENVER COUNTY 1,6479,ODYSSEY CHARTER ELEMENTARY SCHOOL,KINDERGARTEN,1,1,5,1,16,24,8,33%
0880,DENVER COUNTY 1,6479,ODYSSEY CHARTER ELEMENTARY SCHOOL,1ST,0,4,3,7,12,26,14,54%
0880,DENVER COUNTY 1,6479,ODYSSEY CHARTER ELEMENTARY SCHOOL,2ND,1,0,4,2,17,24,7,29%
0880,DENVER COUNTY 1,6479,ODYSSEY CHARTER ELEMENTARY SCHOOL,3RD,0,1,9,4,12,26,14,54%
0880,DENVER COUNTY 1,6479,ODYSSEY CHARTER ELEMENTARY SCHOOL,4TH,1,1,4,1,17,24,7,29%
0880,DENVER COUNTY 1,6479,ODYSSEY CHARTER ELEMENTARY SCHOOL,5TH,0,4,8,2,12,26,14,54%
0880,DENVER COUNTY 1,6479,ODYSSEY CHARTER ELEMENTARY SCHOOL,6TH,0,3,3,3,16,25,9,36%
0880,DENVER COUNTY 1,6479,ODYSSEY CHARTER ELEMENTARY SCHOOL,7TH,0,1,7,1,14,23,9,39%
0880,DENVER COUNTY 1,6479,ODYSSEY CHARTER ELEMENTARY SCHOOL,8TH,1,7,7,1,11,27,16,59%
0880,DENVER COUNTY 1,6479,ODYSSEY CHARTER ELEMENTARY SCHOOL,SCHOOL TOTAL,4,22,50,22,127,225,98,44%
0880,DENVER COUNTY 1,6508,OMAR D BLAIR CHARTER SCHOOL,HALF DAY K,1,2,4,4,33,44,11,25%
0880,DENVER COUNTY 1,6508,OMAR D BLAIR CHARTER SCHOOL,KINDERGARTEN,1,1,14,3,30,49,19,39%
0880,DENVER COUNTY 1,6508,OMAR D BLAIR CHARTER SCHOOL,1ST,1,6,32,26,28,93,65,70%
0880,DENVER COUNTY 1,6508,OMAR D BLAIR CHARTER SCHOOL,2ND,1,20,27,31,26,105,79,75%
0880,DENVER COUNTY 1,6508,OMAR D BLAIR CHARTER SCHOOL,3RD,1,7,29,34,30,101,71,70%
0880,DENVER COUNTY 1,6508,OMAR D BLAIR CHARTER SCHOOL,4TH,1,8,35,25,21,90,69,77%
0880,DENVER COUNTY 1,6508,OMAR D BLAIR CHARTER SCHOOL,5TH,0,7,39,25,19,90,71,79%
0880,DENVER COUNTY 1,6508,OMAR D BLAIR CHARTER SCHOOL,6TH,1,5,29,29,13,77,64,83%
0880,DENVER COUNTY 1,6508,OMAR D BLAIR CHARTER SCHOOL,7TH,0,3,28,29,18,78,60,77%
0880,DENVER COUNTY 1,6508,OMAR D BLAIR CHARTER SCHOOL,8TH,0,4,37,23,8,72,64,89%
0880,DENVER COUNTY 1,6508,OMAR D BLAIR CHARTER SCHOOL,SCHOOL TOTAL,7,63,274,229,226,799,573,72%
0880,DENVER COUNTY 1,6509,ONLINE HIGH SCHOOL,9TH,0,1,10,15,15,41,26,63%
0880,DENVER COUNTY 1,6509,ONLINE HIGH SCHOOL,10TH,1,1,6,8,13,29,16,55%
0880,DENVER COUNTY 1,6509,ONLINE HIGH SCHOOL,11TH,0,2,8,10,4,24,20,83%
0880,DENVER COUNTY 1,6509,ONLINE HIGH SCHOOL,12TH,0,2,8,7,17,34,17,50%
0880,DENVER COUNTY 1,6509,ONLINE HIGH SCHOOL,SCHOOL TOTAL,1,6,32,40,49,128,79,62%
0880,DENVER COUNTY 1,6676,PALMER ELEMENTARY SCHOOL,PK,0,0,15,11,25,51,26,51%
0880,DENVER COUNTY 1,6676,PALMER ELEMENTARY SCHOOL,KINDERGARTEN,0,8,19,9,42,78,36,46%
0880,DENVER COUNTY 1,6676,PALMER ELEMENTARY SCHOOL,1ST,0,0,13,10,26,49,23,47%
0880,DENVER COUNTY 1,6676,PALMER ELEMENTARY SCHOOL,2ND,0,1,19,5,18,43,25,58%
0880,DENVER COUNTY 1,6676,PALMER ELEMENTARY SCHOOL,3RD,0,1,22,9,13,45,32,71%
0880,DENVER COUNTY 1,6676,PALMER ELEMENTARY SCHOOL,4TH,0,3,19,12,9,43,34,79%
0880,DENVER COUNTY 1,6676,PALMER ELEMENTARY SCHOOL,5TH,1,2,22,7,9,41,32,78%
0880,DENVER COUNTY 1,6676,PALMER ELEMENTARY SCHOOL,SCHOOL TOTAL,1,15,129,63,142,350,208,59%
0880,DENVER COUNTY 1,6754,PARK HILL SCHOOL,PK,1,1,0,1,20,23,3,13%
0880,DENVER COUNTY 1,6754,PARK HILL SCHOOL,HALF DAY K,0,0,0,0,1,1,0,0%
0880,DENVER COUNTY 1,6754,PARK HILL SCHOOL,KINDERGARTEN,0,6,12,7,44,69,25,36%
0880,DENVER COUNTY 1,6754,PARK HILL SCHOOL,1ST,1,5,16,20,52,94,42,45%
0880,DENVER COUNTY 1,6754,PARK HILL SCHOOL,2ND,0,2,17,15,50,84,34,40%
0880,DENVER COUNTY 1,6754,PARK HILL SCHOOL,3RD,1,4,19,14,39,77,38,49%
0880,DENVER COUNTY 1,6754,PARK HILL SCHOOL,4TH,0,2,24,25,26,77,51,66%
0880,DENVER COUNTY 1,6754,PARK HILL SCHOOL,5TH,0,4,34,14,23,75,52,69%
0880,DENVER COUNTY 1,6754,PARK HILL SCHOOL,SCHOOL TOTAL,3,24,122,96,255,500,245,49%
0880,DENVER COUNTY 1,6784,NOEL MIDDLE SCHOOL,6TH,1,2,79,182,16,280,264,94%
0880,DENVER COUNTY 1,6784,NOEL MIDDLE SCHOOL,7TH,1,2,62,143,15,223,208,93%
0880,DENVER COUNTY 1,6784,NOEL MIDDLE SCHOOL,8TH,3,5,57,157,15,237,222,94%
0880,DENVER COUNTY 1,6784,NOEL MIDDLE SCHOOL,SCHOOL TOTAL,5,9,198,482,46,740,694,94%
0880,DENVER COUNTY 1,6912,PHILIPS ELEMENTARY SCHOOL,PK,2,0,19,3,9,33,24,73%
0880,DENVER COUNTY 1,6912,PHILIPS ELEMENTARY SCHOOL,KINDERGARTEN,2,0,20,6,5,33,28,85%
0880,DENVER COUNTY 1,6912,PHILIPS ELEMENTARY SCHOOL,1ST,1,0,19,4,2,26,24,92%
0880,DENVER COUNTY 1,6912,PHILIPS ELEMENTARY SCHOOL,2ND,0,0,21,4,2,27,25,93%
0880,DENVER COUNTY 1,6912,PHILIPS ELEMENTARY SCHOOL,3RD,0,0,11,5,0,16,16,100%
0880,DENVER COUNTY 1,6912,PHILIPS ELEMENTARY SCHOOL,4TH,0,0,17,4,3,24,21,88%
0880,DENVER COUNTY 1,6912,PHILIPS ELEMENTARY SCHOOL,5TH,0,0,16,2,1,19,18,95%
0880,DENVER COUNTY 1,6912,PHILIPS ELEMENTARY SCHOOL,SCHOOL TOTAL,5,0,123,28,22,178,156,88%
0880,DENVER COUNTY 1,6957,PIONEER CHARTER SCHOOL,PK,0,0,2,22,0,24,24,100%
0880,DENVER COUNTY 1,6957,PIONEER CHARTER SCHOOL,KINDERGARTEN,0,0,1,43,0,44,44,100%
0880,DENVER COUNTY 1,6957,PIONEER CHARTER SCHOOL,1ST,0,0,3,43,1,47,46,98%
0880,DENVER COUNTY 1,6957,PIONEER CHARTER SCHOOL,2ND,0,0,1,42,1,44,43,98%
0880,DENVER COUNTY 1,6957,PIONEER CHARTER SCHOOL,3RD,0,0,0,38,1,39,38,97%
0880,DENVER COUNTY 1,6957,PIONEER CHARTER SCHOOL,4TH,0,0,0,43,0,43,43,100%
0880,DENVER COUNTY 1,6957,PIONEER CHARTER SCHOOL,5TH,0,0,1,34,0,35,35,100%
0880,DENVER COUNTY 1,6957,PIONEER CHARTER SCHOOL,6TH,0,0,0,25,0,25,25,100%
0880,DENVER COUNTY 1,6957,PIONEER CHARTER SCHOOL,SCHOOL TOTAL,0,0,8,290,3,301,298,99%
0880,DENVER COUNTY 1,6970,PITT-WALLER K-8 SCHOOL,PK,1,4,7,10,31,53,22,42%
0880,DENVER COUNTY 1,6970,PITT-WALLER K-8 SCHOOL,HALF DAY K,1,1,4,5,20,31,11,35%
0880,DENVER COUNTY 1,6970,PITT-WALLER K-8 SCHOOL,KINDERGARTEN,1,1,13,10,24,49,25,51%
0880,DENVER COUNTY 1,6970,PITT-WALLER K-8 SCHOOL,1ST,0,12,30,33,29,104,75,72%
0880,DENVER COUNTY 1,6970,PITT-WALLER K-8 SCHOOL,2ND,2,5,46,20,22,95,73,77%
0880,DENVER COUNTY 1,6970,PITT-WALLER K-8 SCHOOL,3RD,2,15,37,28,31,113,82,73%
0880,DENVER COUNTY 1,6970,PITT-WALLER K-8 SCHOOL,4TH,2,10,43,32,21,108,87,81%
0880,DENVER COUNTY 1,6970,PITT-WALLER K-8 SCHOOL,5TH,0,7,53,29,12,101,89,88%
0880,DENVER COUNTY 1,6970,PITT-WALLER K-8 SCHOOL,6TH,1,6,44,46,19,116,97,84%
0880,DENVER COUNTY 1,6970,PITT-WALLER K-8 SCHOOL,7TH,0,14,31,28,9,82,73,89%
0880,DENVER COUNTY 1,6970,PITT-WALLER K-8 SCHOOL,8TH,1,6,31,31,10,79,69,87%
0880,DENVER COUNTY 1,6970,PITT-WALLER K-8 SCHOOL,SCHOOL TOTAL,11,81,339,272,228,931,703,76%
0880,DENVER COUNTY 1,7045,PLACE BRIDGE ACADEMY,PK,0,4,8,28,3,43,40,93%
0880,DENVER COUNTY 1,7045,PLACE BRIDGE ACADEMY,HALF DAY K,0,1,0,0,1,2,1,50%
0880,DENVER COUNTY 1,7045,PLACE BRIDGE ACADEMY,KINDERGARTEN,1,16,22,52,9,100,91,91%
0880,DENVER COUNTY 1,7045,PLACE BRIDGE ACADEMY,1ST,3,15,24,40,13,95,82,86%
0880,DENVER COUNTY 1,7045,PLACE BRIDGE ACADEMY,2ND,2,20,21,38,14,95,81,85%
0880,DENVER COUNTY 1,7045,PLACE BRIDGE ACADEMY,3RD,1,27,27,34,14,103,89,86%
0880,DENVER COUNTY 1,7045,PLACE BRIDGE ACADEMY,4TH,0,19,27,42,14,102,88,86%
0880,DENVER COUNTY 1,7045,PLACE BRIDGE ACADEMY,5TH,0,21,30,38,11,100,89,89%
0880,DENVER COUNTY 1,7045,PLACE BRIDGE ACADEMY,6TH,1,18,22,40,8,89,81,91%
0880,DENVER COUNTY 1,7045,PLACE BRIDGE ACADEMY,7TH,0,3,14,51,6,74,68,92%
0880,DENVER COUNTY 1,7045,PLACE BRIDGE ACADEMY,8TH,0,3,14,36,5,58,53,91%
0880,DENVER COUNTY 1,7045,PLACE BRIDGE ACADEMY,SCHOOL TOTAL,8,147,209,399,98,861,763,89%
0880,DENVER COUNTY 1,7163,PREP ASSESSMENT CENTER,7TH,0,0,5,2,2,9,7,78%
0880,DENVER COUNTY 1,7163,PREP ASSESSMENT CENTER,8TH,0,0,1,5,1,7,6,86%
0880,DENVER COUNTY 1,7163,PREP ASSESSMENT CENTER,9TH,0,0,5,7,0,12,12,100%
0880,DENVER COUNTY 1,7163,PREP ASSESSMENT CENTER,12TH,5,1,35,62,10,113,103,91%
0880,DENVER COUNTY 1,7163,PREP ASSESSMENT CENTER,SCHOOL TOTAL,5,1,46,76,13,141,128,91%
0880,DENVER COUNTY 1,7199,P.S.1 CHARTER SCHOOL,6TH,0,0,2,3,3,8,5,63%
0880,DENVER COUNTY 1,7199,P.S.1 CHARTER SCHOOL,7TH,0,0,2,2,5,9,4,44%
0880,DENVER COUNTY 1,7199,P.S.1 CHARTER SCHOOL,8TH,2,0,0,5,3,10,7,70%
0880,DENVER COUNTY 1,7199,P.S.1 CHARTER SCHOOL,9TH,4,0,16,50,11,81,70,86%
0880,DENVER COUNTY 1,7199,P.S.1 CHARTER SCHOOL,10TH,3,1,13,30,15,62,47,76%
0880,DENVER COUNTY 1,7199,P.S.1 CHARTER SCHOOL,11TH,4,0,10,17,7,38,31,82%
0880,DENVER COUNTY 1,7199,P.S.1 CHARTER SCHOOL,12TH,2,0,3,9,11,25,14,56%
0880,DENVER COUNTY 1,7199,P.S.1 CHARTER SCHOOL,SCHOOL TOTAL,15,1,46,116,55,233,178,76%
0880,DENVER COUNTY 1,7370,RISHEL MIDDLE SCHOOL,7TH,1,1,3,122,8,135,127,94%
0880,DENVER COUNTY 1,7370,RISHEL MIDDLE SCHOOL,8TH,1,1,3,113,8,126,118,94%
0880,DENVER COUNTY 1,7370,RISHEL MIDDLE SCHOOL,SCHOOL TOTAL,2,2,6,235,16,261,245,94%
0880,DENVER COUNTY 1,7554,SABIN WORLD SCHOOL,PK,2,6,0,36,17,61,44,72%
0880,DENVER COUNTY 1,7554,SABIN WORLD SCHOOL,HALF DAY K,0,0,0,0,1,1,0,0%
0880,DENVER COUNTY 1,7554,SABIN WORLD SCHOOL,KINDERGARTEN,0,7,4,64,14,89,75,84%
0880,DENVER COUNTY 1,7554,SABIN WORLD SCHOOL,1ST,0,8,5,54,17,84,67,80%
0880,DENVER COUNTY 1,7554,SABIN WORLD SCHOOL,2ND,1,8,1,47,17,74,57,77%
0880,DENVER COUNTY 1,7554,SABIN WORLD SCHOOL,3RD,1,5,0,63,19,88,69,78%
0880,DENVER COUNTY 1,7554,SABIN WORLD SCHOOL,4TH,0,7,1,69,19,96,77,80%
0880,DENVER COUNTY 1,7554,SABIN WORLD SCHOOL,5TH,1,5,2,51,13,72,59,82%
0880,DENVER COUNTY 1,7554,SABIN WORLD SCHOOL,SCHOOL TOTAL,5,46,13,384,117,565,448,79%
0880,DENVER COUNTY 1,7578,SAMUELS ELEMENTARY SCHOOL,PK,0,10,17,26,25,78,53,68%
0880,DENVER COUNTY 1,7578,SAMUELS ELEMENTARY SCHOOL,HALF DAY K,0,1,8,7,11,27,16,59%
0880,DENVER COUNTY 1,7578,SAMUELS ELEMENTARY SCHOOL,KINDERGARTEN,0,6,10,34,22,72,50,69%
0880,DENVER COUNTY 1,7578,SAMUELS ELEMENTARY SCHOOL,1ST,0,5,22,38,22,87,65,75%
0880,DENVER COUNTY 1,7578,SAMUELS ELEMENTARY SCHOOL,2ND,2,5,23,44,17,91,74,81%
0880,DENVER COUNTY 1,7578,SAMUELS ELEMENTARY SCHOOL,3RD,3,3,23,37,28,94,66,70%
0880,DENVER COUNTY 1,7578,SAMUELS ELEMENTARY SCHOOL,4TH,1,3,16,31,25,76,51,67%
0880,DENVER COUNTY 1,7578,SAMUELS ELEMENTARY SCHOOL,5TH,0,6,20,32,14,72,58,81%
0880,DENVER COUNTY 1,7578,SAMUELS ELEMENTARY SCHOOL,SCHOOL TOTAL,6,39,139,249,164,597,433,73%
0880,DENVER COUNTY 1,7694,CHARLES M. SCHENCK (CMS) COMMUNITY SCHOOL,PK,1,1,1,52,7,62,55,89%
0880,DENVER COUNTY 1,7694,CHARLES M. SCHENCK (CMS) COMMUNITY SCHOOL,KINDERGARTEN,2,1,2,98,7,110,103,94%
0880,DENVER COUNTY 1,7694,CHARLES M. SCHENCK (CMS) COMMUNITY SCHOOL,1ST,0,3,3,104,11,121,110,91%
0880,DENVER COUNTY 1,7694,CHARLES M. SCHENCK (CMS) COMMUNITY SCHOOL,2ND,0,8,1,82,9,100,91,91%
0880,DENVER COUNTY 1,7694,CHARLES M. SCHENCK (CMS) COMMUNITY SCHOOL,3RD,0,6,2,90,7,105,98,93%
0880,DENVER COUNTY 1,7694,CHARLES M. SCHENCK (CMS) COMMUNITY SCHOOL,4TH,0,3,1,70,11,85,74,87%
0880,DENVER COUNTY 1,7694,CHARLES M. SCHENCK (CMS) COMMUNITY SCHOOL,5TH,0,2,0,62,6,70,64,91%
0880,DENVER COUNTY 1,7694,CHARLES M. SCHENCK (CMS) COMMUNITY SCHOOL,SCHOOL TOTAL,3,24,10,558,58,653,595,91%
0880,DENVER COUNTY 1,7698,SCHMITT ELEMENTARY SCHOOL,PK,0,2,1,29,16,48,32,67%
0880,DENVER COUNTY 1,7698,SCHMITT ELEMENTARY SCHOOL,KINDERGARTEN,1,2,1,54,15,73,58,79%
0880,DENVER COUNTY 1,7698,SCHMITT ELEMENTARY SCHOOL,1ST,1,8,2,53,2,66,64,97%
0880,DENVER COUNTY 1,7698,SCHMITT ELEMENTARY SCHOOL,2ND,0,3,5,50,6,64,58,91%
0880,DENVER COUNTY 1,7698,SCHMITT ELEMENTARY SCHOOL,3RD,0,6,5,39,6,56,50,89%
0880,DENVER COUNTY 1,7698,SCHMITT ELEMENTARY SCHOOL,4TH,0,2,3,43,3,51,48,94%
0880,DENVER COUNTY 1,7698,SCHMITT ELEMENTARY SCHOOL,5TH,1,3,7,38,4,53,49,92%
0880,DENVER COUNTY 1,7698,SCHMITT ELEMENTARY SCHOOL,SCHOOL TOTAL,3,26,24,306,52,411,359,87%
0880,DENVER COUNTY 1,7942,SKINNER MIDDLE SCHOOL,6TH,2,2,3,105,10,122,112,92%
0880,DENVER COUNTY 1,7942,SKINNER MIDDLE SCHOOL,7TH,2,2,0,83,10,97,87,90%
0880,DENVER COUNTY 1,7942,SKINNER MIDDLE SCHOOL,8TH,0,1,1,87,6,95,89,94%
0880,DENVER COUNTY 1,7942,SKINNER MIDDLE SCHOOL,SCHOOL TOTAL,4,5,4,275,26,314,288,92%
0880,DENVER COUNTY 1,7947,SKYLAND COMMUNITY HIGH SCHOOL,9TH,0,0,7,8,3,18,15,83%
0880,DENVER COUNTY 1,7947,SKYLAND COMMUNITY HIGH SCHOOL,10TH,2,0,17,11,3,33,30,91%
0880,DENVER COUNTY 1,7947,SKYLAND COMMUNITY HIGH SCHOOL,11TH,0,0,9,7,2,18,16,89%
0880,DENVER COUNTY 1,7947,SKYLAND COMMUNITY HIGH SCHOOL,12TH,0,0,17,12,3,32,29,91%
0880,DENVER COUNTY 1,7947,SKYLAND COMMUNITY HIGH SCHOOL,SCHOOL TOTAL,2,0,50,38,11,101,90,89%
0880,DENVER COUNTY 1,7972,SLAVENS K-8 SCHOOL,PK,0,0,1,0,20,21,1,5%
0880,DENVER COUNTY 1,7972,SLAVENS K-8 SCHOOL,KINDERGARTEN,0,1,1,1,57,60,3,5%
0880,DENVER COUNTY 1,7972,SLAVENS K-8 SCHOOL,1ST,0,2,3,1,50,56,6,11%
0880,DENVER COUNTY 1,7972,SLAVENS K-8 SCHOOL,2ND,0,5,1,1,64,71,7,10%
0880,DENVER COUNTY 1,7972,SLAVENS K-8 SCHOOL,3RD,0,2,1,4,44,51,7,14%
0880,DENVER COUNTY 1,7972,SLAVENS K-8 SCHOOL,4TH,1,3,0,2,43,49,6,12%
0880,DENVER COUNTY 1,7972,SLAVENS K-8 SCHOOL,5TH,0,2,0,3,49,54,5,9%
0880,DENVER COUNTY 1,7972,SLAVENS K-8 SCHOOL,6TH,0,3,0,4,45,52,7,13%
0880,DENVER COUNTY 1,7972,SLAVENS K-8 SCHOOL,7TH,0,2,3,5,42,52,10,19%
0880,DENVER COUNTY 1,7972,SLAVENS K-8 SCHOOL,8TH,0,1,0,5,37,43,6,14%
0880,DENVER COUNTY 1,7972,SLAVENS K-8 SCHOOL,SCHOOL TOTAL,1,21,10,26,451,509,58,11%
0880,DENVER COUNTY 1,7992,SMILEY MIDDLE SCHOOL,6TH,3,0,44,14,10,71,61,86%
0880,DENVER COUNTY 1,7992,SMILEY MIDDLE SCHOOL,7TH,1,2,78,38,7,126,119,94%
0880,DENVER COUNTY 1,7992,SMILEY MIDDLE SCHOOL,8TH,3,3,91,44,16,157,141,90%
0880,DENVER COUNTY 1,7992,SMILEY MIDDLE SCHOOL,SCHOOL TOTAL,7,5,213,96,33,354,321,91%
0880,DENVER COUNTY 1,8006,SMITH ELEMENTARY SCHOOL,PK,2,0,17,32,31,82,51,62%
0880,DENVER COUNTY 1,8006,SMITH ELEMENTARY SCHOOL,KINDERGARTEN,1,0,30,28,22,81,59,73%
0880,DENVER COUNTY 1,8006,SMITH ELEMENTARY SCHOOL,1ST,0,0,25,21,13,59,46,78%
0880,DENVER COUNTY 1,8006,SMITH ELEMENTARY SCHOOL,2ND,0,0,31,31,12,74,62,84%
0880,DENVER COUNTY 1,8006,SMITH ELEMENTARY SCHOOL,3RD,0,0,29,29,4,62,58,94%
0880,DENVER COUNTY 1,8006,SMITH ELEMENTARY SCHOOL,4TH,0,0,33,28,4,65,61,94%
0880,DENVER COUNTY 1,8006,SMITH ELEMENTARY SCHOOL,5TH,1,0,25,21,4,51,47,92%
0880,DENVER COUNTY 1,8006,SMITH ELEMENTARY SCHOOL,SCHOOL TOTAL,4,0,190,190,90,474,384,81%
0880,DENVER COUNTY 1,8054,HENRY WORLD SCHOOL GRADES 6-8,6TH,8,31,6,217,53,315,262,83%
0880,DENVER COUNTY 1,8054,HENRY WORLD SCHOOL GRADES 6-8,7TH,6,22,7,236,41,312,271,87%
0880,DENVER COUNTY 1,8054,HENRY WORLD SCHOOL GRADES 6-8,8TH,7,23,11,187,60,288,228,79%
0880,DENVER COUNTY 1,8054,HENRY WORLD SCHOOL GRADES 6-8,SCHOOL TOTAL,21,76,24,640,154,915,761,83%
0880,DENVER COUNTY 1,8085,WEST DENVER PREP:  FEDERAL CAMPUS,6TH,1,0,0,117,2,120,118,98%
0880,DENVER COUNTY 1,8085,WEST DENVER PREP:  FEDERAL CAMPUS,7TH,0,1,0,107,2,110,108,98%
0880,DENVER COUNTY 1,8085,WEST DENVER PREP:  FEDERAL CAMPUS,8TH,2,1,0,88,5,96,91,95%
0880,DENVER COUNTY 1,8085,WEST DENVER PREP:  FEDERAL CAMPUS,SCHOOL TOTAL,3,2,0,312,9,326,317,97%
0880,DENVER COUNTY 1,8086,SOUTH HIGH SCHOOL,9TH,9,83,111,165,128,496,368,74%
0880,DENVER COUNTY 1,8086,SOUTH HIGH SCHOOL,10TH,6,57,73,127,88,351,263,75%
0880,DENVER COUNTY 1,8086,SOUTH HIGH SCHOOL,11TH,2,20,62,76,76,236,160,68%
0880,DENVER COUNTY 1,8086,SOUTH HIGH SCHOOL,12TH,0,13,89,104,103,309,206,67%
0880,DENVER COUNTY 1,8086,SOUTH HIGH SCHOOL,SCHOOL TOTAL,17,173,335,472,395,1392,997,72%
0880,DENVER COUNTY 1,8132,SOUTHWEST EARLY COLLEGE CHARTER SCHOOL,9TH,1,3,1,51,6,62,56,90%
0880,DENVER COUNTY 1,8132,SOUTHWEST EARLY COLLEGE CHARTER SCHOOL,10TH,2,2,6,71,6,87,81,93%
0880,DENVER COUNTY 1,8132,SOUTHWEST EARLY COLLEGE CHARTER SCHOOL,11TH,1,0,7,60,20,88,68,77%
0880,DENVER COUNTY 1,8132,SOUTHWEST EARLY COLLEGE CHARTER SCHOOL,12TH,0,6,5,62,24,97,73,75%
0880,DENVER COUNTY 1,8132,SOUTHWEST EARLY COLLEGE CHARTER SCHOOL,SCHOOL TOTAL,4,11,19,244,56,334,278,83%
0880,DENVER COUNTY 1,8138,SOUTHMOOR ELEMENTARY SCHOOL,PK,0,4,2,5,24,35,11,31%
0880,DENVER COUNTY 1,8138,SOUTHMOOR ELEMENTARY SCHOOL,HALF DAY K,0,1,0,0,2,3,1,33%
0880,DENVER COUNTY 1,8138,SOUTHMOOR ELEMENTARY SCHOOL,KINDERGARTEN,0,2,6,8,37,53,16,30%
0880,DENVER COUNTY 1,8138,SOUTHMOOR ELEMENTARY SCHOOL,1ST,1,6,6,5,53,71,18,25%
0880,DENVER COUNTY 1,8138,SOUTHMOOR ELEMENTARY SCHOOL,2ND,1,7,7,9,61,85,24,28%
0880,DENVER COUNTY 1,8138,SOUTHMOOR ELEMENTARY SCHOOL,3RD,0,6,14,7,46,73,27,37%
0880,DENVER COUNTY 1,8138,SOUTHMOOR ELEMENTARY SCHOOL,4TH,0,12,8,10,54,84,30,36%
0880,DENVER COUNTY 1,8138,SOUTHMOOR ELEMENTARY SCHOOL,5TH,0,2,9,8,45,64,19,30%
0880,DENVER COUNTY 1,8138,SOUTHMOOR ELEMENTARY SCHOOL,SCHOOL TOTAL,2,40,52,52,322,468,146,31%
0880,DENVER COUNTY 1,8222,STECK ELEMENTARY SCHOOL,PK,0,1,2,3,24,30,6,20%
0880,DENVER COUNTY 1,8222,STECK ELEMENTARY SCHOOL,KINDERGARTEN,0,2,2,7,40,51,11,22%
0880,DENVER COUNTY 1,8222,STECK ELEMENTARY SCHOOL,1ST,0,9,2,4,55,70,15,21%
0880,DENVER COUNTY 1,8222,STECK ELEMENTARY SCHOOL,2ND,0,2,1,3,48,54,6,11%
0880,DENVER COUNTY 1,8222,STECK ELEMENTARY SCHOOL,3RD,0,5,0,4,42,51,9,18%
0880,DENVER COUNTY 1,8222,STECK ELEMENTARY SCHOOL,4TH,0,3,3,5,42,53,11,21%
0880,DENVER COUNTY 1,8222,STECK ELEMENTARY SCHOOL,5TH,0,1,5,9,36,51,15,29%
0880,DENVER COUNTY 1,8222,STECK ELEMENTARY SCHOOL,SCHOOL TOTAL,0,23,15,35,287,360,73,20%
0880,DENVER COUNTY 1,8232,STEDMAN ELEMENTARY SCHOOL,PK,0,0,14,14,22,50,28,56%
0880,DENVER COUNTY 1,8232,STEDMAN ELEMENTARY SCHOOL,KINDERGARTEN,0,0,31,23,23,77,54,70%
0880,DENVER COUNTY 1,8232,STEDMAN ELEMENTARY SCHOOL,1ST,0,3,38,9,7,57,50,88%
0880,DENVER COUNTY 1,8232,STEDMAN ELEMENTARY SCHOOL,2ND,0,0,28,20,7,55,48,87%
0880,DENVER COUNTY 1,8232,STEDMAN ELEMENTARY SCHOOL,3RD,1,0,31,16,8,56,48,86%
0880,DENVER COUNTY 1,8232,STEDMAN ELEMENTARY SCHOOL,4TH,0,0,29,22,5,56,51,91%
0880,DENVER COUNTY 1,8232,STEDMAN ELEMENTARY SCHOOL,5TH,0,0,25,14,3,42,39,93%
0880,DENVER COUNTY 1,8232,STEDMAN ELEMENTARY SCHOOL,SCHOOL TOTAL,1,3,196,118,75,393,318,81%
0880,DENVER COUNTY 1,8242,STEELE ELEMENTARY SCHOOL,PK,0,1,1,1,28,31,3,10%
0880,DENVER COUNTY 1,8242,STEELE ELEMENTARY SCHOOL,HALF DAY K,0,1,0,1,24,26,2,8%
0880,DENVER COUNTY 1,8242,STEELE ELEMENTARY SCHOOL,KINDERGARTEN,0,0,1,2,49,52,3,6%
0880,DENVER COUNTY 1,8242,STEELE ELEMENTARY SCHOOL,1ST,0,1,0,4,71,76,5,7%
0880,DENVER COUNTY 1,8242,STEELE ELEMENTARY SCHOOL,2ND,1,2,3,2,62,70,8,11%
0880,DENVER COUNTY 1,8242,STEELE ELEMENTARY SCHOOL,3RD,0,4,0,10,58,72,14,19%
0880,DENVER COUNTY 1,8242,STEELE ELEMENTARY SCHOOL,4TH,1,2,4,5,55,67,12,18%
0880,DENVER COUNTY 1,8242,STEELE ELEMENTARY SCHOOL,5TH,1,3,2,10,36,52,16,31%
0880,DENVER COUNTY 1,8242,STEELE ELEMENTARY SCHOOL,SCHOOL TOTAL,3,14,11,35,383,446,63,14%
0880,DENVER COUNTY 1,8422,SWANSEA ELEMENTARY SCHOOL,PK,0,0,1,60,5,66,61,92%
0880,DENVER COUNTY 1,8422,SWANSEA ELEMENTARY SCHOOL,HALF DAY K,1,0,1,11,4,17,13,76%
0880,DENVER COUNTY 1,8422,SWANSEA ELEMENTARY SCHOOL,KINDERGARTEN,0,0,2,72,1,75,74,99%
0880,DENVER COUNTY 1,8422,SWANSEA ELEMENTARY SCHOOL,1ST,0,0,2,85,11,98,87,89%
0880,DENVER COUNTY 1,8422,SWANSEA ELEMENTARY SCHOOL,2ND,0,0,5,79,4,88,84,95%
0880,DENVER COUNTY 1,8422,SWANSEA ELEMENTARY SCHOOL,3RD,0,0,3,72,6,81,75,93%
0880,DENVER COUNTY 1,8422,SWANSEA ELEMENTARY SCHOOL,4TH,2,0,5,62,2,71,69,97%
0880,DENVER COUNTY 1,8422,SWANSEA ELEMENTARY SCHOOL,5TH,2,0,2,65,3,72,69,96%
0880,DENVER COUNTY 1,8422,SWANSEA ELEMENTARY SCHOOL,SCHOOL TOTAL,5,0,21,506,36,568,532,94%
0880,DENVER COUNTY 1,8776,TELLER ELEMENTARY SCHOOL,PK,0,1,6,3,28,38,10,26%
0880,DENVER COUNTY 1,8776,TELLER ELEMENTARY SCHOOL,KINDERGARTEN,0,1,1,10,39,51,12,24%
0880,DENVER COUNTY 1,8776,TELLER ELEMENTARY SCHOOL,1ST,0,2,11,13,54,80,26,33%
0880,DENVER COUNTY 1,8776,TELLER ELEMENTARY SCHOOL,2ND,0,1,3,12,48,64,16,25%
0880,DENVER COUNTY 1,8776,TELLER ELEMENTARY SCHOOL,3RD,0,2,9,13,32,56,24,43%
0880,DENVER COUNTY 1,8776,TELLER ELEMENTARY SCHOOL,4TH,1,0,10,9,26,46,20,43%
0880,DENVER COUNTY 1,8776,TELLER ELEMENTARY SCHOOL,5TH,1,6,9,12,27,55,28,51%
0880,DENVER COUNTY 1,8776,TELLER ELEMENTARY SCHOOL,SCHOOL TOTAL,2,13,49,72,254,390,136,35%
0880,DENVER COUNTY 1,8822,THOMAS JEFFERSON HIGH SCHOOL,9TH,4,12,98,98,138,350,212,61%
0880,DENVER COUNTY 1,8822,THOMAS JEFFERSON HIGH SCHOOL,10TH,2,10,81,56,109,258,149,58%
0880,DENVER COUNTY 1,8822,THOMAS JEFFERSON HIGH SCHOOL,11TH,1,12,64,39,117,233,116,50%
0880,DENVER COUNTY 1,8822,THOMAS JEFFERSON HIGH SCHOOL,12TH,2,5,71,41,118,237,119,50%
0880,DENVER COUNTY 1,8822,THOMAS JEFFERSON HIGH SCHOOL,SCHOOL TOTAL,9,39,314,234,482,1078,596,55%
0880,DENVER COUNTY 1,8888,TRAYLOR ELEMENTARY SCHOOL,PK,0,6,1,28,14,49,35,71%
0880,DENVER COUNTY 1,8888,TRAYLOR ELEMENTARY SCHOOL,HALF DAY K,1,2,0,10,11,24,13,54%
0880,DENVER COUNTY 1,8888,TRAYLOR ELEMENTARY SCHOOL,KINDERGARTEN,0,2,0,33,15,50,35,70%
0880,DENVER COUNTY 1,8888,TRAYLOR ELEMENTARY SCHOOL,1ST,3,9,3,61,20,96,76,79%
0880,DENVER COUNTY 1,8888,TRAYLOR ELEMENTARY SCHOOL,2ND,2,5,0,50,27,84,57,68%
0880,DENVER COUNTY 1,8888,TRAYLOR ELEMENTARY SCHOOL,3RD,2,10,0,71,26,109,83,76%
0880,DENVER COUNTY 1,8888,TRAYLOR ELEMENTARY SCHOOL,4TH,2,6,1,57,21,87,66,76%
0880,DENVER COUNTY 1,8888,TRAYLOR ELEMENTARY SCHOOL,5TH,2,6,3,52,29,92,63,68%
0880,DENVER COUNTY 1,8888,TRAYLOR ELEMENTARY SCHOOL,SCHOOL TOTAL,12,46,8,362,163,591,428,72%
0880,DENVER COUNTY 1,8909,TREVISTA ECE-8 AT HORACE MANN,PK,0,0,2,36,3,41,38,93%
0880,DENVER COUNTY 1,8909,TREVISTA ECE-8 AT HORACE MANN,KINDERGARTEN,1,0,4,75,8,88,80,91%
0880,DENVER COUNTY 1,8909,TREVISTA ECE-8 AT HORACE MANN,1ST,3,0,5,64,7,79,72,91%
0880,DENVER COUNTY 1,8909,TREVISTA ECE-8 AT HORACE MANN,2ND,0,0,4,53,4,61,57,93%
0880,DENVER COUNTY 1,8909,TREVISTA ECE-8 AT HORACE MANN,3RD,1,0,3,47,5,56,51,91%
0880,DENVER COUNTY 1,8909,TREVISTA ECE-8 AT HORACE MANN,4TH,1,0,7,57,3,68,65,96%
0880,DENVER COUNTY 1,8909,TREVISTA ECE-8 AT HORACE MANN,5TH,1,0,6,58,6,71,65,92%
0880,DENVER COUNTY 1,8909,TREVISTA ECE-8 AT HORACE MANN,6TH,1,1,4,67,4,77,73,95%
0880,DENVER COUNTY 1,8909,TREVISTA ECE-8 AT HORACE MANN,7TH,6,0,4,64,3,77,74,96%
0880,DENVER COUNTY 1,8909,TREVISTA ECE-8 AT HORACE MANN,8TH,2,1,5,64,4,76,72,95%
0880,DENVER COUNTY 1,8909,TREVISTA ECE-8 AT HORACE MANN,SCHOOL TOTAL,16,2,44,585,47,694,647,93%
0880,DENVER COUNTY 1,8970,UNIVERSITY PARK ELEMENTARY SCHOOL,PK,1,1,5,7,57,71,14,20%
0880,DENVER COUNTY 1,8970,UNIVERSITY PARK ELEMENTARY SCHOOL,HALF DAY K,0,2,1,6,19,28,9,32%
0880,DENVER COUNTY 1,8970,UNIVERSITY PARK ELEMENTARY SCHOOL,KINDERGARTEN,0,4,1,3,43,51,8,16%
0880,DENVER COUNTY 1,8970,UNIVERSITY PARK ELEMENTARY SCHOOL,1ST,0,8,5,9,54,76,22,29%
0880,DENVER COUNTY 1,8970,UNIVERSITY PARK ELEMENTARY SCHOOL,2ND,3,6,8,8,46,71,25,35%
0880,DENVER COUNTY 1,8970,UNIVERSITY PARK ELEMENTARY SCHOOL,3RD,0,2,8,17,50,77,27,35%
0880,DENVER COUNTY 1,8970,UNIVERSITY PARK ELEMENTARY SCHOOL,4TH,1,5,4,5,42,57,15,26%
0880,DENVER COUNTY 1,8970,UNIVERSITY PARK ELEMENTARY SCHOOL,5TH,0,2,6,12,30,50,20,40%
0880,DENVER COUNTY 1,8970,UNIVERSITY PARK ELEMENTARY SCHOOL,SCHOOL TOTAL,5,30,38,67,341,481,140,29%
0880,DENVER COUNTY 1,9050,VALVERDE ELEMENTARY SCHOOL,PK,1,2,1,31,0,35,35,100%
0880,DENVER COUNTY 1,9050,VALVERDE ELEMENTARY SCHOOL,KINDERGARTEN,1,0,2,68,6,77,71,92%
0880,DENVER COUNTY 1,9050,VALVERDE ELEMENTARY SCHOOL,1ST,0,2,2,68,3,75,72,96%
0880,DENVER COUNTY 1,9050,VALVERDE ELEMENTARY SCHOOL,2ND,0,0,4,61,2,67,65,97%
0880,DENVER COUNTY 1,9050,VALVERDE ELEMENTARY SCHOOL,3RD,0,1,0,60,1,62,61,98%
0880,DENVER COUNTY 1,9050,VALVERDE ELEMENTARY SCHOOL,4TH,1,1,4,62,3,71,68,96%
0880,DENVER COUNTY 1,9050,VALVERDE ELEMENTARY SCHOOL,5TH,0,4,3,48,0,55,55,100%
0880,DENVER COUNTY 1,9050,VALVERDE ELEMENTARY SCHOOL,SCHOOL TOTAL,3,10,16,398,15,442,427,97%
0880,DENVER COUNTY 1,9389,WEST DENVER PREP: HARVEY PARK CAMPUS,6TH,1,4,3,107,5,120,115,96%
0880,DENVER COUNTY 1,9389,WEST DENVER PREP: HARVEY PARK CAMPUS,SCHOOL TOTAL,1,4,3,107,5,120,115,96%
0880,DENVER COUNTY 1,9408,WEST HIGH SCHOOL,9TH,7,2,21,234,14,278,264,95%
0880,DENVER COUNTY 1,9408,WEST HIGH SCHOOL,10TH,4,2,8,170,11,195,184,94%
0880,DENVER COUNTY 1,9408,WEST HIGH SCHOOL,11TH,5,2,5,122,7,141,134,95%
0880,DENVER COUNTY 1,9408,WEST HIGH SCHOOL,12TH,0,4,8,161,9,182,173,95%
0880,DENVER COUNTY 1,9408,WEST HIGH SCHOOL,SCHOOL TOTAL,16,10,42,687,41,796,755,95%
0880,DENVER COUNTY 1,9425,WESTERLY CREEK ELEMENTARY,PK,0,4,4,2,69,79,10,13%
0880,DENVER COUNTY 1,9425,WESTERLY CREEK ELEMENTARY,HALF DAY K,0,0,0,0,4,4,0,0%
0880,DENVER COUNTY 1,9425,WESTERLY CREEK ELEMENTARY,KINDERGARTEN,0,6,7,8,70,91,21,23%
0880,DENVER COUNTY 1,9425,WESTERLY CREEK ELEMENTARY,1ST,0,5,7,8,55,75,20,27%
0880,DENVER COUNTY 1,9425,WESTERLY CREEK ELEMENTARY,2ND,0,5,2,5,56,68,12,18%
0880,DENVER COUNTY 1,9425,WESTERLY CREEK ELEMENTARY,3RD,0,7,2,4,39,52,13,25%
0880,DENVER COUNTY 1,9425,WESTERLY CREEK ELEMENTARY,SCHOOL TOTAL,0,27,22,27,293,369,76,21%
0880,DENVER COUNTY 1,9496,CASTRO ELEMENTARY SCHOOL,PK,0,3,3,53,7,66,59,89%
0880,DENVER COUNTY 1,9496,CASTRO ELEMENTARY SCHOOL,HALF DAY K,1,0,0,10,0,11,11,100%
0880,DENVER COUNTY 1,9496,CASTRO ELEMENTARY SCHOOL,KINDERGARTEN,0,9,4,80,2,95,93,98%
0880,DENVER COUNTY 1,9496,CASTRO ELEMENTARY SCHOOL,1ST,3,5,2,109,6,125,119,95%
0880,DENVER COUNTY 1,9496,CASTRO ELEMENTARY SCHOOL,2ND,2,4,2,101,2,111,109,98%
0880,DENVER COUNTY 1,9496,CASTRO ELEMENTARY SCHOOL,3RD,3,5,2,89,5,104,99,95%
0880,DENVER COUNTY 1,9496,CASTRO ELEMENTARY SCHOOL,4TH,2,4,0,73,4,83,79,95%
0880,DENVER COUNTY 1,9496,CASTRO ELEMENTARY SCHOOL,5TH,2,6,2,81,3,94,91,97%
0880,DENVER COUNTY 1,9496,CASTRO ELEMENTARY SCHOOL,SCHOOL TOTAL,13,36,15,596,29,689,660,96%
0880,DENVER COUNTY 1,9548,WHITTIER K-8 SCHOOL,PK,0,0,14,9,2,25,23,92%
0880,DENVER COUNTY 1,9548,WHITTIER K-8 SCHOOL,KINDERGARTEN,1,1,20,16,12,50,38,76%
0880,DENVER COUNTY 1,9548,WHITTIER K-8 SCHOOL,1ST,0,0,11,19,3,33,30,91%
0880,DENVER COUNTY 1,9548,WHITTIER K-8 SCHOOL,2ND,0,0,9,14,3,26,23,88%
0880,DENVER COUNTY 1,9548,WHITTIER K-8 SCHOOL,3RD,0,1,18,8,4,31,27,87%
0880,DENVER COUNTY 1,9548,WHITTIER K-8 SCHOOL,4TH,0,1,9,8,4,22,18,82%
0880,DENVER COUNTY 1,9548,WHITTIER K-8 SCHOOL,5TH,2,0,13,9,3,27,24,89%
0880,DENVER COUNTY 1,9548,WHITTIER K-8 SCHOOL,6TH,0,0,13,10,2,25,23,92%
0880,DENVER COUNTY 1,9548,WHITTIER K-8 SCHOOL,7TH,0,0,15,12,4,31,27,87%
0880,DENVER COUNTY 1,9548,WHITTIER K-8 SCHOOL,8TH,0,0,11,7,1,19,18,95%
0880,DENVER COUNTY 1,9548,WHITTIER K-8 SCHOOL,SCHOOL TOTAL,3,3,133,112,38,289,251,87%
0880,DENVER COUNTY 1,9623,WILLIAM (BILL) ROBERTS K-8 SCHOOL,PK,0,2,3,6,111,122,11,9%
0880,DENVER COUNTY 1,9623,WILLIAM (BILL) ROBERTS K-8 SCHOOL,KINDERGARTEN,0,9,4,4,133,150,17,11%
0880,DENVER COUNTY 1,9623,WILLIAM (BILL) ROBERTS K-8 SCHOOL,1ST,0,6,7,3,86,102,16,16%
0880,DENVER COUNTY 1,9623,WILLIAM (BILL) ROBERTS K-8 SCHOOL,2ND,0,4,3,2,66,75,9,12%
0880,DENVER COUNTY 1,9623,WILLIAM (BILL) ROBERTS K-8 SCHOOL,3RD,0,3,10,5,58,76,18,24%
0880,DENVER COUNTY 1,9623,WILLIAM (BILL) ROBERTS K-8 SCHOOL,4TH,0,5,14,6,53,78,25,32%
0880,DENVER COUNTY 1,9623,WILLIAM (BILL) ROBERTS K-8 SCHOOL,5TH,0,3,17,7,42,69,27,39%
0880,DENVER COUNTY 1,9623,WILLIAM (BILL) ROBERTS K-8 SCHOOL,6TH,0,3,15,7,15,40,25,63%
0880,DENVER COUNTY 1,9623,WILLIAM (BILL) ROBERTS K-8 SCHOOL,7TH,0,0,11,6,8,25,17,68%
0880,DENVER COUNTY 1,9623,WILLIAM (BILL) ROBERTS K-8 SCHOOL,8TH,0,3,14,7,14,38,24,63%
0880,DENVER COUNTY 1,9623,WILLIAM (BILL) ROBERTS K-8 SCHOOL,SCHOOL TOTAL,0,38,98,53,586,775,189,24%
0880,DENVER COUNTY 1,9739,WYATT-EDISON CHARTER ELEMENTARY SCHOOL,KINDERGARTEN,1,0,25,57,6,89,83,93%
0880,DENVER COUNTY 1,9739,WYATT-EDISON CHARTER ELEMENTARY SCHOOL,1ST,2,1,23,48,10,84,74,88%
0880,DENVER COUNTY 1,9739,WYATT-EDISON CHARTER ELEMENTARY SCHOOL,2ND,0,0,34,45,5,84,79,94%
0880,DENVER COUNTY 1,9739,WYATT-EDISON CHARTER ELEMENTARY SCHOOL,3RD,0,0,19,54,4,77,73,95%
0880,DENVER COUNTY 1,9739,WYATT-EDISON CHARTER ELEMENTARY SCHOOL,4TH,0,0,24,58,2,84,82,98%
0880,DENVER COUNTY 1,9739,WYATT-EDISON CHARTER ELEMENTARY SCHOOL,5TH,0,0,19,63,1,83,82,99%
0880,DENVER COUNTY 1,9739,WYATT-EDISON CHARTER ELEMENTARY SCHOOL,6TH,0,0,16,40,0,56,56,100%
0880,DENVER COUNTY 1,9739,WYATT-EDISON CHARTER ELEMENTARY SCHOOL,7TH,0,0,12,50,0,62,62,100%
0880,DENVER COUNTY 1,9739,WYATT-EDISON CHARTER ELEMENTARY SCHOOL,8TH,0,0,18,40,1,59,58,98%
0880,DENVER COUNTY 1,9739,WYATT-EDISON CHARTER ELEMENTARY SCHOOL,SCHOOL TOTAL,3,1,190,455,29,678,649,96%
0880,DENVER COUNTY 1,,DISTRICT TOTAL,,840,2731,12413,42060,19211,77255,58044,75%
0890,DOLORES COUNTY RE NO.2,0050,RICO ELEMENTARY SCHOOL,PK,0,0,0,0,6,6,0,0%
0890,DOLORES COUNTY RE NO.2,0050,RICO ELEMENTARY SCHOOL,KINDERGARTEN,0,0,0,0,1,1,0,0%
0890,DOLORES COUNTY RE NO.2,0050,RICO ELEMENTARY SCHOOL,1ST,0,0,0,0,2,2,0,0%
0890,DOLORES COUNTY RE NO.2,0050,RICO ELEMENTARY SCHOOL,2ND,0,0,0,0,1,1,0,0%
0890,DOLORES COUNTY RE NO.2,0050,RICO ELEMENTARY SCHOOL,3RD,0,0,0,0,4,4,0,0%
0890,DOLORES COUNTY RE NO.2,0050,RICO ELEMENTARY SCHOOL,4TH,0,0,0,0,1,1,0,0%
0890,DOLORES COUNTY RE NO.2,0050,RICO ELEMENTARY SCHOOL,6TH,0,0,0,0,1,1,0,0%
0890,DOLORES COUNTY RE NO.2,0050,RICO ELEMENTARY SCHOOL,SCHOOL TOTAL,0,0,0,0,16,16,0,0%
0890,DOLORES COUNTY RE NO.2,2216,DOVE CREEK HIGH SCHOOL,7TH,0,0,0,1,16,17,1,6%
0890,DOLORES COUNTY RE NO.2,2216,DOVE CREEK HIGH SCHOOL,8TH,1,0,1,2,29,33,4,12%
0890,DOLORES COUNTY RE NO.2,2216,DOVE CREEK HIGH SCHOOL,9TH,1,0,1,1,13,16,3,19%
0890,DOLORES COUNTY RE NO.2,2216,DOVE CREEK HIGH SCHOOL,10TH,1,0,0,0,16,17,1,6%
0890,DOLORES COUNTY RE NO.2,2216,DOVE CREEK HIGH SCHOOL,11TH,0,0,0,0,18,18,0,0%
0890,DOLORES COUNTY RE NO.2,2216,DOVE CREEK HIGH SCHOOL,12TH,0,0,1,2,21,24,3,13%
0890,DOLORES COUNTY RE NO.2,2216,DOVE CREEK HIGH SCHOOL,SCHOOL TOTAL,3,0,3,6,113,125,12,10%
0890,DOLORES COUNTY RE NO.2,7764,SEVENTH STREET ELEMENTARY SCHOOL,PK,1,0,0,1,18,20,2,10%
0890,DOLORES COUNTY RE NO.2,7764,SEVENTH STREET ELEMENTARY SCHOOL,KINDERGARTEN,0,0,0,1,21,22,1,5%
0890,DOLORES COUNTY RE NO.2,7764,SEVENTH STREET ELEMENTARY SCHOOL,1ST,1,0,0,2,21,24,3,13%
0890,DOLORES COUNTY RE NO.2,7764,SEVENTH STREET ELEMENTARY SCHOOL,2ND,1,0,0,0,15,16,1,6%
0890,DOLORES COUNTY RE NO.2,7764,SEVENTH STREET ELEMENTARY SCHOOL,3RD,0,0,0,2,20,22,2,9%
0890,DOLORES COUNTY RE NO.2,7764,SEVENTH STREET ELEMENTARY SCHOOL,4TH,0,1,0,1,15,17,2,12%
0890,DOLORES COUNTY RE NO.2,7764,SEVENTH STREET ELEMENTARY SCHOOL,5TH,0,0,0,1,15,16,1,6%
0890,DOLORES COUNTY RE NO.2,7764,SEVENTH STREET ELEMENTARY SCHOOL,6TH,0,0,0,2,11,13,2,15%
0890,DOLORES COUNTY RE NO.2,7764,SEVENTH STREET ELEMENTARY SCHOOL,SCHOOL TOTAL,3,1,0,10,136,150,14,9%
0890,DOLORES COUNTY RE NO.2,,DISTRICT TOTAL,,6,1,3,16,265,291,26,9%
0900,DOUGLAS COUNTY RE 1,0011,ACADEMY CHARTER SCHOOL,HALF DAY K,0,1,0,2,70,73,3,4%
0900,DOUGLAS COUNTY RE 1,0011,ACADEMY CHARTER SCHOOL,KINDERGARTEN,0,0,0,1,0,1,1,100%
0900,DOUGLAS COUNTY RE 1,0011,ACADEMY CHARTER SCHOOL,1ST,1,0,2,4,71,78,7,9%
0900,DOUGLAS COUNTY RE 1,0011,ACADEMY CHARTER SCHOOL,2ND,1,2,0,5,72,80,8,10%
0900,DOUGLAS COUNTY RE 1,0011,ACADEMY CHARTER SCHOOL,3RD,2,1,0,6,62,71,9,13%
0900,DOUGLAS COUNTY RE 1,0011,ACADEMY CHARTER SCHOOL,4TH,0,1,1,5,68,75,7,9%
0900,DOUGLAS COUNTY RE 1,0011,ACADEMY CHARTER SCHOOL,5TH,2,2,0,8,61,73,12,16%
0900,DOUGLAS COUNTY RE 1,0011,ACADEMY CHARTER SCHOOL,6TH,2,1,1,5,57,66,9,14%
0900,DOUGLAS COUNTY RE 1,0011,ACADEMY CHARTER SCHOOL,7TH,2,0,0,2,53,57,4,7%
0900,DOUGLAS COUNTY RE 1,0011,ACADEMY CHARTER SCHOOL,8TH,0,2,2,5,54,63,9,14%
0900,DOUGLAS COUNTY RE 1,0011,ACADEMY CHARTER SCHOOL,SCHOOL TOTAL,10,10,6,43,568,637,69,11%
0900,DOUGLAS COUNTY RE 1,0012,ACRES GREEN ELEMENTARY SCHOOL,HALF DAY K,0,14,2,11,61,88,27,31%
0900,DOUGLAS COUNTY RE 1,0012,ACRES GREEN ELEMENTARY SCHOOL,KINDERGARTEN,0,1,1,1,7,10,3,30%
0900,DOUGLAS COUNTY RE 1,0012,ACRES GREEN ELEMENTARY SCHOOL,1ST,0,9,2,11,57,79,22,28%
0900,DOUGLAS COUNTY RE 1,0012,ACRES GREEN ELEMENTARY SCHOOL,2ND,0,14,2,10,70,96,26,27%
0900,DOUGLAS COUNTY RE 1,0012,ACRES GREEN ELEMENTARY SCHOOL,3RD,0,15,7,15,89,126,37,29%
0900,DOUGLAS COUNTY RE 1,0012,ACRES GREEN ELEMENTARY SCHOOL,4TH,2,16,5,19,60,102,42,41%
0900,DOUGLAS COUNTY RE 1,0012,ACRES GREEN ELEMENTARY SCHOOL,5TH,2,13,3,16,79,113,34,30%
0900,DOUGLAS COUNTY RE 1,0012,ACRES GREEN ELEMENTARY SCHOOL,6TH,0,14,1,13,66,94,28,30%
0900,DOUGLAS COUNTY RE 1,0012,ACRES GREEN ELEMENTARY SCHOOL,SCHOOL TOTAL,4,96,23,96,489,708,219,31%
0900,DOUGLAS COUNTY RE 1,0201,DANIEL C OAKES HIGH SCHOOL--CASTLE ROCK,9TH,0,1,0,2,13,16,3,19%
0900,DOUGLAS COUNTY RE 1,0201,DANIEL C OAKES HIGH SCHOOL--CASTLE ROCK,10TH,0,1,0,2,27,30,3,10%
0900,DOUGLAS COUNTY RE 1,0201,DANIEL C OAKES HIGH SCHOOL--CASTLE ROCK,11TH,0,2,0,5,37,44,7,16%
0900,DOUGLAS COUNTY RE 1,0201,DANIEL C OAKES HIGH SCHOOL--CASTLE ROCK,12TH,0,0,1,8,48,57,9,16%
0900,DOUGLAS COUNTY RE 1,0201,DANIEL C OAKES HIGH SCHOOL--CASTLE ROCK,SCHOOL TOTAL,0,4,1,17,125,147,22,15%
0900,DOUGLAS COUNTY RE 1,0215,AMERICAN ACADEMY AT CASTLE PINES CHARTER,HALF DAY K,0,7,0,5,101,113,12,11%
0900,DOUGLAS COUNTY RE 1,0215,AMERICAN ACADEMY AT CASTLE PINES CHARTER,1ST,0,6,0,1,97,104,7,7%
0900,DOUGLAS COUNTY RE 1,0215,AMERICAN ACADEMY AT CASTLE PINES CHARTER,2ND,0,9,0,1,94,104,10,10%
0900,DOUGLAS COUNTY RE 1,0215,AMERICAN ACADEMY AT CASTLE PINES CHARTER,3RD,1,7,1,4,92,105,13,12%
0900,DOUGLAS COUNTY RE 1,0215,AMERICAN ACADEMY AT CASTLE PINES CHARTER,4TH,1,11,0,5,92,109,17,16%
0900,DOUGLAS COUNTY RE 1,0215,AMERICAN ACADEMY AT CASTLE PINES CHARTER,5TH,0,11,0,5,84,100,16,16%
0900,DOUGLAS COUNTY RE 1,0215,AMERICAN ACADEMY AT CASTLE PINES CHARTER,6TH,2,10,0,2,70,84,14,17%
0900,DOUGLAS COUNTY RE 1,0215,AMERICAN ACADEMY AT CASTLE PINES CHARTER,7TH,1,4,3,2,58,68,10,15%
0900,DOUGLAS COUNTY RE 1,0215,AMERICAN ACADEMY AT CASTLE PINES CHARTER,8TH,0,9,0,1,20,30,10,33%
0900,DOUGLAS COUNTY RE 1,0215,AMERICAN ACADEMY AT CASTLE PINES CHARTER,SCHOOL TOTAL,5,74,4,26,708,817,109,13%
0900,DOUGLAS COUNTY RE 1,0264,CIMARRON MIDDLE,7TH,3,13,9,31,362,418,56,13%
0900,DOUGLAS COUNTY RE 1,0264,CIMARRON MIDDLE,8TH,3,18,12,22,376,431,55,13%
0900,DOUGLAS COUNTY RE 1,0264,CIMARRON MIDDLE,SCHOOL TOTAL,6,31,21,53,738,849,111,13%
0900,DOUGLAS COUNTY RE 1,0265,CLEAR SKY ELEMENTARY,HALF DAY K,0,4,1,10,102,117,15,13%
0900,DOUGLAS COUNTY RE 1,0265,CLEAR SKY ELEMENTARY,1ST,0,6,1,13,85,105,20,19%
0900,DOUGLAS COUNTY RE 1,0265,CLEAR SKY ELEMENTARY,2ND,0,4,0,10,85,99,14,14%
0900,DOUGLAS COUNTY RE 1,0265,CLEAR SKY ELEMENTARY,3RD,0,4,0,5,72,81,9,11%
0900,DOUGLAS COUNTY RE 1,0265,CLEAR SKY ELEMENTARY,4TH,0,3,1,12,82,98,16,16%
0900,DOUGLAS COUNTY RE 1,0265,CLEAR SKY ELEMENTARY,5TH,1,5,1,6,81,94,13,14%
0900,DOUGLAS COUNTY RE 1,0265,CLEAR SKY ELEMENTARY,6TH,0,1,0,6,65,72,7,10%
0900,DOUGLAS COUNTY RE 1,0265,CLEAR SKY ELEMENTARY,SCHOOL TOTAL,1,27,4,62,572,666,94,14%
0900,DOUGLAS COUNTY RE 1,0266,GOLD RUSH ELEMENTARY,HALF DAY K,0,7,3,5,91,106,15,14%
0900,DOUGLAS COUNTY RE 1,0266,GOLD RUSH ELEMENTARY,KINDERGARTEN,0,0,0,0,2,2,0,0%
0900,DOUGLAS COUNTY RE 1,0266,GOLD RUSH ELEMENTARY,1ST,1,4,2,4,107,118,11,9%
0900,DOUGLAS COUNTY RE 1,0266,GOLD RUSH ELEMENTARY,2ND,0,3,4,3,81,91,10,11%
0900,DOUGLAS COUNTY RE 1,0266,GOLD RUSH ELEMENTARY,3RD,1,1,3,1,75,81,6,7%
0900,DOUGLAS COUNTY RE 1,0266,GOLD RUSH ELEMENTARY,4TH,0,3,4,3,78,88,10,11%
0900,DOUGLAS COUNTY RE 1,0266,GOLD RUSH ELEMENTARY,5TH,1,6,3,4,68,82,14,17%
0900,DOUGLAS COUNTY RE 1,0266,GOLD RUSH ELEMENTARY,6TH,1,2,3,2,54,62,8,13%
0900,DOUGLAS COUNTY RE 1,0266,GOLD RUSH ELEMENTARY,SCHOOL TOTAL,4,26,22,22,556,630,74,12%
0900,DOUGLAS COUNTY RE 1,0267,MESA MIDDLE SCHOOL,7TH,7,13,9,36,371,436,65,15%
0900,DOUGLAS COUNTY RE 1,0267,MESA MIDDLE SCHOOL,8TH,7,9,6,39,381,442,61,14%
0900,DOUGLAS COUNTY RE 1,0267,MESA MIDDLE SCHOOL,SCHOOL TOTAL,14,22,15,75,752,878,126,14%
0900,DOUGLAS COUNTY RE 1,0354,ARROWWOOD ELEMENTARY SCHOOL,HALF DAY K,0,12,4,8,72,96,24,25%
0900,DOUGLAS COUNTY RE 1,0354,ARROWWOOD ELEMENTARY SCHOOL,1ST,0,11,2,10,78,101,23,23%
0900,DOUGLAS COUNTY RE 1,0354,ARROWWOOD ELEMENTARY SCHOOL,2ND,0,6,3,13,64,86,22,26%
0900,DOUGLAS COUNTY RE 1,0354,ARROWWOOD ELEMENTARY SCHOOL,3RD,0,8,2,7,63,80,17,21%
0900,DOUGLAS COUNTY RE 1,0354,ARROWWOOD ELEMENTARY SCHOOL,4TH,0,9,2,12,41,64,23,36%
0900,DOUGLAS COUNTY RE 1,0354,ARROWWOOD ELEMENTARY SCHOOL,5TH,2,7,2,10,62,83,21,25%
0900,DOUGLAS COUNTY RE 1,0354,ARROWWOOD ELEMENTARY SCHOOL,6TH,1,4,2,7,51,65,14,22%
0900,DOUGLAS COUNTY RE 1,0354,ARROWWOOD ELEMENTARY SCHOOL,SCHOOL TOTAL,3,57,17,67,431,575,144,25%
0900,DOUGLAS COUNTY RE 1,0651,BEAR CANYON ELEMENTARY SCHOOL,HALF DAY K,0,7,0,10,62,79,17,22%
0900,DOUGLAS COUNTY RE 1,0651,BEAR CANYON ELEMENTARY SCHOOL,1ST,0,2,3,5,81,91,10,11%
0900,DOUGLAS COUNTY RE 1,0651,BEAR CANYON ELEMENTARY SCHOOL,2ND,0,6,1,5,81,93,12,13%
0900,DOUGLAS COUNTY RE 1,0651,BEAR CANYON ELEMENTARY SCHOOL,3RD,1,6,1,7,81,96,15,16%
0900,DOUGLAS COUNTY RE 1,0651,BEAR CANYON ELEMENTARY SCHOOL,4TH,0,4,1,9,89,103,14,14%
0900,DOUGLAS COUNTY RE 1,0651,BEAR CANYON ELEMENTARY SCHOOL,5TH,0,1,1,6,77,85,8,9%
0900,DOUGLAS COUNTY RE 1,0651,BEAR CANYON ELEMENTARY SCHOOL,6TH,0,8,3,6,77,94,17,18%
0900,DOUGLAS COUNTY RE 1,0651,BEAR CANYON ELEMENTARY SCHOOL,SCHOOL TOTAL,1,34,10,48,548,641,93,15%
0900,DOUGLAS COUNTY RE 1,1131,BUFFALO RIDGE ELEMENTARY SCHOOL,HALF DAY K,0,2,1,4,56,63,7,11%
0900,DOUGLAS COUNTY RE 1,1131,BUFFALO RIDGE ELEMENTARY SCHOOL,1ST,0,2,0,7,90,99,9,9%
0900,DOUGLAS COUNTY RE 1,1131,BUFFALO RIDGE ELEMENTARY SCHOOL,2ND,0,3,2,6,74,85,11,13%
0900,DOUGLAS COUNTY RE 1,1131,BUFFALO RIDGE ELEMENTARY SCHOOL,3RD,1,4,3,4,84,96,12,13%
0900,DOUGLAS COUNTY RE 1,1131,BUFFALO RIDGE ELEMENTARY SCHOOL,4TH,0,1,0,6,73,80,7,9%
0900,DOUGLAS COUNTY RE 1,1131,BUFFALO RIDGE ELEMENTARY SCHOOL,5TH,0,1,2,1,116,120,4,3%
0900,DOUGLAS COUNTY RE 1,1131,BUFFALO RIDGE ELEMENTARY SCHOOL,SCHOOL TOTAL,1,13,8,28,493,543,50,9%
0900,DOUGLAS COUNTY RE 1,1270,CANTRIL SCHOOL,PK,2,66,15,100,1236,1419,183,13%
0900,DOUGLAS COUNTY RE 1,1270,CANTRIL SCHOOL,SCHOOL TOTAL,2,66,15,100,1236,1419,183,13%
0900,DOUGLAS COUNTY RE 1,1362,CASTLE ROCK ELEMENTARY SCHOOL,HALF DAY K,0,2,1,8,84,95,11,12%
0900,DOUGLAS COUNTY RE 1,1362,CASTLE ROCK ELEMENTARY SCHOOL,1ST,0,2,1,10,109,122,13,11%
0900,DOUGLAS COUNTY RE 1,1362,CASTLE ROCK ELEMENTARY SCHOOL,2ND,0,4,0,11,112,127,15,12%
0900,DOUGLAS COUNTY RE 1,1362,CASTLE ROCK ELEMENTARY SCHOOL,3RD,0,4,2,7,119,132,13,10%
0900,DOUGLAS COUNTY RE 1,1362,CASTLE ROCK ELEMENTARY SCHOOL,4TH,0,5,2,4,90,101,11,11%
0900,DOUGLAS COUNTY RE 1,1362,CASTLE ROCK ELEMENTARY SCHOOL,5TH,0,4,0,9,100,113,13,12%
0900,DOUGLAS COUNTY RE 1,1362,CASTLE ROCK ELEMENTARY SCHOOL,6TH,2,9,1,10,106,128,22,17%
0900,DOUGLAS COUNTY RE 1,1362,CASTLE ROCK ELEMENTARY SCHOOL,SCHOOL TOTAL,2,30,7,59,720,818,98,12%
0900,DOUGLAS COUNTY RE 1,1367,CASTLE VIEW HIGH SCHOOL,9TH,3,13,8,53,355,432,77,18%
0900,DOUGLAS COUNTY RE 1,1367,CASTLE VIEW HIGH SCHOOL,10TH,2,7,6,31,338,384,46,12%
0900,DOUGLAS COUNTY RE 1,1367,CASTLE VIEW HIGH SCHOOL,11TH,4,7,3,26,318,358,40,11%
0900,DOUGLAS COUNTY RE 1,1367,CASTLE VIEW HIGH SCHOOL,12TH,4,9,4,35,288,340,52,15%
0900,DOUGLAS COUNTY RE 1,1367,CASTLE VIEW HIGH SCHOOL,SCHOOL TOTAL,13,36,21,145,1299,1514,215,14%
0900,DOUGLAS COUNTY RE 1,1503,CHAPARRAL HIGH SCHOOL,9TH,6,23,4,51,454,538,84,16%
0900,DOUGLAS COUNTY RE 1,1503,CHAPARRAL HIGH SCHOOL,10TH,5,19,11,47,382,464,82,18%
0900,DOUGLAS COUNTY RE 1,1503,CHAPARRAL HIGH SCHOOL,11TH,5,18,16,46,511,596,85,14%
0900,DOUGLAS COUNTY RE 1,1503,CHAPARRAL HIGH SCHOOL,12TH,2,20,14,47,495,578,83,14%
0900,DOUGLAS COUNTY RE 1,1503,CHAPARRAL HIGH SCHOOL,SCHOOL TOTAL,18,80,45,191,1842,2176,334,15%
0900,DOUGLAS COUNTY RE 1,1512,CHALLENGE TO EXCELLENCE CHARTER SCHOOL,HALF DAY K,0,4,1,1,42,48,6,13%
0900,DOUGLAS COUNTY RE 1,1512,CHALLENGE TO EXCELLENCE CHARTER SCHOOL,1ST,0,2,0,1,47,50,3,6%
0900,DOUGLAS COUNTY RE 1,1512,CHALLENGE TO EXCELLENCE CHARTER SCHOOL,2ND,0,3,1,3,41,48,7,15%
0900,DOUGLAS COUNTY RE 1,1512,CHALLENGE TO EXCELLENCE CHARTER SCHOOL,3RD,0,10,2,2,58,72,14,19%
0900,DOUGLAS COUNTY RE 1,1512,CHALLENGE TO EXCELLENCE CHARTER SCHOOL,4TH,0,3,1,5,39,48,9,19%
0900,DOUGLAS COUNTY RE 1,1512,CHALLENGE TO EXCELLENCE CHARTER SCHOOL,5TH,0,5,2,2,38,47,9,19%
0900,DOUGLAS COUNTY RE 1,1512,CHALLENGE TO EXCELLENCE CHARTER SCHOOL,6TH,0,4,1,1,65,71,6,8%
0900,DOUGLAS COUNTY RE 1,1512,CHALLENGE TO EXCELLENCE CHARTER SCHOOL,7TH,0,2,0,4,31,37,6,16%
0900,DOUGLAS COUNTY RE 1,1512,CHALLENGE TO EXCELLENCE CHARTER SCHOOL,8TH,0,3,4,2,22,31,9,29%
0900,DOUGLAS COUNTY RE 1,1512,CHALLENGE TO EXCELLENCE CHARTER SCHOOL,SCHOOL TOTAL,0,36,12,21,383,452,69,15%
0900,DOUGLAS COUNTY RE 1,1578,CHERRY VALLEY ELEMENTARY SCHOOL,HALF DAY K,0,1,0,0,11,12,1,8%
0900,DOUGLAS COUNTY RE 1,1578,CHERRY VALLEY ELEMENTARY SCHOOL,1ST,0,0,0,1,7,8,1,13%
0900,DOUGLAS COUNTY RE 1,1578,CHERRY VALLEY ELEMENTARY SCHOOL,2ND,0,0,0,0,11,11,0,0%
0900,DOUGLAS COUNTY RE 1,1578,CHERRY VALLEY ELEMENTARY SCHOOL,3RD,0,0,0,0,4,4,0,0%
0900,DOUGLAS COUNTY RE 1,1578,CHERRY VALLEY ELEMENTARY SCHOOL,4TH,0,0,0,1,9,10,1,10%
0900,DOUGLAS COUNTY RE 1,1578,CHERRY VALLEY ELEMENTARY SCHOOL,5TH,0,0,0,0,10,10,0,0%
0900,DOUGLAS COUNTY RE 1,1578,CHERRY VALLEY ELEMENTARY SCHOOL,6TH,0,0,0,1,14,15,1,7%
0900,DOUGLAS COUNTY RE 1,1578,CHERRY VALLEY ELEMENTARY SCHOOL,SCHOOL TOTAL,0,1,0,3,66,70,4,6%
0900,DOUGLAS COUNTY RE 1,1579,NORTH STAR ACADEMY,HALF DAY K,0,4,2,5,64,75,11,15%
0900,DOUGLAS COUNTY RE 1,1579,NORTH STAR ACADEMY,1ST,0,5,1,5,63,74,11,15%
0900,DOUGLAS COUNTY RE 1,1579,NORTH STAR ACADEMY,2ND,0,3,1,2,67,73,6,8%
0900,DOUGLAS COUNTY RE 1,1579,NORTH STAR ACADEMY,3RD,0,10,0,8,81,99,18,18%
0900,DOUGLAS COUNTY RE 1,1579,NORTH STAR ACADEMY,4TH,0,9,3,6,82,100,18,18%
0900,DOUGLAS COUNTY RE 1,1579,NORTH STAR ACADEMY,5TH,0,3,1,3,43,50,7,14%
0900,DOUGLAS COUNTY RE 1,1579,NORTH STAR ACADEMY,6TH,0,1,0,1,42,44,2,5%
0900,DOUGLAS COUNTY RE 1,1579,NORTH STAR ACADEMY,7TH,0,3,0,3,27,33,6,18%
0900,DOUGLAS COUNTY RE 1,1579,NORTH STAR ACADEMY,SCHOOL TOTAL,0,38,8,33,469,548,79,14%
0900,DOUGLAS COUNTY RE 1,1873,CORE KNOWLEDGE CHARTER SCHOOL,HALF DAY K,0,3,0,0,43,46,3,7%
0900,DOUGLAS COUNTY RE 1,1873,CORE KNOWLEDGE CHARTER SCHOOL,1ST,0,5,0,3,61,69,8,12%
0900,DOUGLAS COUNTY RE 1,1873,CORE KNOWLEDGE CHARTER SCHOOL,2ND,0,3,0,0,43,46,3,7%
0900,DOUGLAS COUNTY RE 1,1873,CORE KNOWLEDGE CHARTER SCHOOL,3RD,0,2,1,2,41,46,5,11%
0900,DOUGLAS COUNTY RE 1,1873,CORE KNOWLEDGE CHARTER SCHOOL,4TH,0,2,1,1,43,47,4,9%
0900,DOUGLAS COUNTY RE 1,1873,CORE KNOWLEDGE CHARTER SCHOOL,5TH,0,1,0,1,44,46,2,4%
0900,DOUGLAS COUNTY RE 1,1873,CORE KNOWLEDGE CHARTER SCHOOL,6TH,0,1,0,2,45,48,3,6%
0900,DOUGLAS COUNTY RE 1,1873,CORE KNOWLEDGE CHARTER SCHOOL,7TH,0,5,1,0,42,48,6,13%
0900,DOUGLAS COUNTY RE 1,1873,CORE KNOWLEDGE CHARTER SCHOOL,8TH,0,2,1,5,33,41,8,20%
0900,DOUGLAS COUNTY RE 1,1873,CORE KNOWLEDGE CHARTER SCHOOL,SCHOOL TOTAL,0,24,4,14,395,437,42,10%
0900,DOUGLAS COUNTY RE 1,1899,COPPER MESA ELEMENTARY SCHOOL,HALF DAY K,0,7,1,2,78,88,10,11%
0900,DOUGLAS COUNTY RE 1,1899,COPPER MESA ELEMENTARY SCHOOL,1ST,0,6,1,11,100,118,18,15%
0900,DOUGLAS COUNTY RE 1,1899,COPPER MESA ELEMENTARY SCHOOL,2ND,1,10,1,7,103,122,19,16%
0900,DOUGLAS COUNTY RE 1,1899,COPPER MESA ELEMENTARY SCHOOL,3RD,2,5,2,4,73,86,13,15%
0900,DOUGLAS COUNTY RE 1,1899,COPPER MESA ELEMENTARY SCHOOL,4TH,0,3,2,6,85,96,11,11%
0900,DOUGLAS COUNTY RE 1,1899,COPPER MESA ELEMENTARY SCHOOL,5TH,0,3,2,4,63,72,9,13%
0900,DOUGLAS COUNTY RE 1,1899,COPPER MESA ELEMENTARY SCHOOL,6TH,0,1,1,2,60,64,4,6%
0900,DOUGLAS COUNTY RE 1,1899,COPPER MESA ELEMENTARY SCHOOL,SCHOOL TOTAL,3,35,10,36,562,646,84,13%
0900,DOUGLAS COUNTY RE 1,1925,COUGAR RUN ELEMENTARY SCHOOL,HALF DAY K,0,10,0,10,63,83,20,24%
0900,DOUGLAS COUNTY RE 1,1925,COUGAR RUN ELEMENTARY SCHOOL,1ST,0,5,1,8,75,89,14,16%
0900,DOUGLAS COUNTY RE 1,1925,COUGAR RUN ELEMENTARY SCHOOL,2ND,0,8,1,9,68,86,18,21%
0900,DOUGLAS COUNTY RE 1,1925,COUGAR RUN ELEMENTARY SCHOOL,3RD,1,9,3,7,70,90,20,22%
0900,DOUGLAS COUNTY RE 1,1925,COUGAR RUN ELEMENTARY SCHOOL,4TH,0,8,1,6,67,82,15,18%
0900,DOUGLAS COUNTY RE 1,1925,COUGAR RUN ELEMENTARY SCHOOL,5TH,0,5,2,7,62,76,14,18%
0900,DOUGLAS COUNTY RE 1,1925,COUGAR RUN ELEMENTARY SCHOOL,6TH,0,13,0,12,56,81,25,31%
0900,DOUGLAS COUNTY RE 1,1925,COUGAR RUN ELEMENTARY SCHOOL,SCHOOL TOTAL,1,58,8,59,461,587,126,21%
0900,DOUGLAS COUNTY RE 1,1934,COYOTE CREEK ELEMENTARY SCHOOL,HALF DAY K,0,1,0,1,60,62,2,3%
0900,DOUGLAS COUNTY RE 1,1934,COYOTE CREEK ELEMENTARY SCHOOL,1ST,1,3,0,6,66,76,10,13%
0900,DOUGLAS COUNTY RE 1,1934,COYOTE CREEK ELEMENTARY SCHOOL,2ND,0,0,0,5,42,47,5,11%
0900,DOUGLAS COUNTY RE 1,1934,COYOTE CREEK ELEMENTARY SCHOOL,3RD,1,3,2,8,60,74,14,19%
0900,DOUGLAS COUNTY RE 1,1934,COYOTE CREEK ELEMENTARY SCHOOL,4TH,1,2,0,5,69,77,8,10%
0900,DOUGLAS COUNTY RE 1,1934,COYOTE CREEK ELEMENTARY SCHOOL,5TH,1,3,2,12,64,82,18,22%
0900,DOUGLAS COUNTY RE 1,1934,COYOTE CREEK ELEMENTARY SCHOOL,6TH,0,2,2,9,66,79,13,16%
0900,DOUGLAS COUNTY RE 1,1934,COYOTE CREEK ELEMENTARY SCHOOL,SCHOOL TOTAL,4,14,6,46,427,497,70,14%
0900,DOUGLAS COUNTY RE 1,2012,CRESTHILL MIDDLE SCHOOL,7TH,0,33,23,37,369,462,93,20%
0900,DOUGLAS COUNTY RE 1,2012,CRESTHILL MIDDLE SCHOOL,8TH,4,32,15,33,377,461,84,18%
0900,DOUGLAS COUNTY RE 1,2012,CRESTHILL MIDDLE SCHOOL,SCHOOL TOTAL,4,65,38,70,746,923,177,19%
0900,DOUGLAS COUNTY RE 1,2226,CASTLE ROCK MIDDLE SCHOOL,7TH,5,8,8,41,312,374,62,17%
0900,DOUGLAS COUNTY RE 1,2226,CASTLE ROCK MIDDLE SCHOOL,8TH,1,8,5,38,298,350,52,15%
0900,DOUGLAS COUNTY RE 1,2226,CASTLE ROCK MIDDLE SCHOOL,SCHOOL TOTAL,6,16,13,79,610,724,114,16%
0900,DOUGLAS COUNTY RE 1,2230,DOUGLAS COUNTY HIGH SCHOOL,9TH,10,30,7,63,421,531,110,21%
0900,DOUGLAS COUNTY RE 1,2230,DOUGLAS COUNTY HIGH SCHOOL,10TH,1,26,8,49,381,465,84,18%
0900,DOUGLAS COUNTY RE 1,2230,DOUGLAS COUNTY HIGH SCHOOL,11TH,5,21,5,35,344,410,66,16%
0900,DOUGLAS COUNTY RE 1,2230,DOUGLAS COUNTY HIGH SCHOOL,12TH,1,23,7,29,296,356,60,17%
0900,DOUGLAS COUNTY RE 1,2230,DOUGLAS COUNTY HIGH SCHOOL,SCHOOL TOTAL,17,100,27,176,1442,1762,320,18%
0900,DOUGLAS COUNTY RE 1,2232,ROCK RIDGE ELEMENTARY SCHOOL,HALF DAY K,0,1,2,16,80,99,19,19%
0900,DOUGLAS COUNTY RE 1,2232,ROCK RIDGE ELEMENTARY SCHOOL,1ST,1,2,3,8,107,121,14,12%
0900,DOUGLAS COUNTY RE 1,2232,ROCK RIDGE ELEMENTARY SCHOOL,2ND,1,4,3,9,95,112,17,15%
0900,DOUGLAS COUNTY RE 1,2232,ROCK RIDGE ELEMENTARY SCHOOL,3RD,1,3,4,5,97,110,13,12%
0900,DOUGLAS COUNTY RE 1,2232,ROCK RIDGE ELEMENTARY SCHOOL,4TH,0,4,3,8,93,108,15,14%
0900,DOUGLAS COUNTY RE 1,2232,ROCK RIDGE ELEMENTARY SCHOOL,5TH,1,1,6,7,108,123,15,12%
0900,DOUGLAS COUNTY RE 1,2232,ROCK RIDGE ELEMENTARY SCHOOL,6TH,2,2,3,4,97,108,11,10%
0900,DOUGLAS COUNTY RE 1,2232,ROCK RIDGE ELEMENTARY SCHOOL,SCHOOL TOTAL,6,17,24,57,677,781,104,13%
0900,DOUGLAS COUNTY RE 1,2233,CHEROKEE TRAIL ELEMENTARY SCHOOL,HALF DAY K,0,2,1,6,69,78,9,12%
0900,DOUGLAS COUNTY RE 1,2233,CHEROKEE TRAIL ELEMENTARY SCHOOL,1ST,0,5,0,10,75,90,15,17%
0900,DOUGLAS COUNTY RE 1,2233,CHEROKEE TRAIL ELEMENTARY SCHOOL,2ND,0,4,1,5,79,89,10,11%
0900,DOUGLAS COUNTY RE 1,2233,CHEROKEE TRAIL ELEMENTARY SCHOOL,3RD,0,4,4,11,78,97,19,20%
0900,DOUGLAS COUNTY RE 1,2233,CHEROKEE TRAIL ELEMENTARY SCHOOL,4TH,1,2,1,14,82,100,18,18%
0900,DOUGLAS COUNTY RE 1,2233,CHEROKEE TRAIL ELEMENTARY SCHOOL,5TH,1,4,3,11,78,97,19,20%
0900,DOUGLAS COUNTY RE 1,2233,CHEROKEE TRAIL ELEMENTARY SCHOOL,6TH,1,3,2,6,88,100,12,12%
0900,DOUGLAS COUNTY RE 1,2233,CHEROKEE TRAIL ELEMENTARY SCHOOL,SCHOOL TOTAL,3,24,12,63,549,651,102,16%
0900,DOUGLAS COUNTY RE 1,2234,EAGLE RIDGE ELEMENTARY SCHOOL,HALF DAY K,1,3,1,7,50,62,12,19%
0900,DOUGLAS COUNTY RE 1,2234,EAGLE RIDGE ELEMENTARY SCHOOL,KINDERGARTEN,0,0,0,2,0,2,2,100%
0900,DOUGLAS COUNTY RE 1,2234,EAGLE RIDGE ELEMENTARY SCHOOL,1ST,1,3,3,2,86,95,9,9%
0900,DOUGLAS COUNTY RE 1,2234,EAGLE RIDGE ELEMENTARY SCHOOL,2ND,0,1,2,4,74,81,7,9%
0900,DOUGLAS COUNTY RE 1,2234,EAGLE RIDGE ELEMENTARY SCHOOL,3RD,1,4,4,7,66,82,16,20%
0900,DOUGLAS COUNTY RE 1,2234,EAGLE RIDGE ELEMENTARY SCHOOL,4TH,1,2,4,6,73,86,13,15%
0900,DOUGLAS COUNTY RE 1,2234,EAGLE RIDGE ELEMENTARY SCHOOL,5TH,0,0,2,4,79,85,6,7%
0900,DOUGLAS COUNTY RE 1,2234,EAGLE RIDGE ELEMENTARY SCHOOL,6TH,0,2,4,4,82,92,10,11%
0900,DOUGLAS COUNTY RE 1,2234,EAGLE RIDGE ELEMENTARY SCHOOL,SCHOOL TOTAL,4,15,20,36,510,585,75,13%
0900,DOUGLAS COUNTY RE 1,2338,EAGLE ACADEMY,10TH,0,0,0,0,1,1,0,0%
0900,DOUGLAS COUNTY RE 1,2338,EAGLE ACADEMY,11TH,0,1,1,5,33,40,7,18%
0900,DOUGLAS COUNTY RE 1,2338,EAGLE ACADEMY,12TH,1,2,4,4,39,50,11,22%
0900,DOUGLAS COUNTY RE 1,2338,EAGLE ACADEMY,SCHOOL TOTAL,1,3,5,9,73,91,18,20%
0900,DOUGLAS COUNTY RE 1,2656,ELDORADO ELEMENTARY SCHOOL,HALF DAY K,0,2,2,2,72,78,6,8%
0900,DOUGLAS COUNTY RE 1,2656,ELDORADO ELEMENTARY SCHOOL,1ST,1,7,1,1,93,103,10,10%
0900,DOUGLAS COUNTY RE 1,2656,ELDORADO ELEMENTARY SCHOOL,2ND,1,8,1,12,76,98,22,22%
0900,DOUGLAS COUNTY RE 1,2656,ELDORADO ELEMENTARY SCHOOL,3RD,0,6,3,10,74,93,19,20%
0900,DOUGLAS COUNTY RE 1,2656,ELDORADO ELEMENTARY SCHOOL,4TH,0,8,1,4,87,100,13,13%
0900,DOUGLAS COUNTY RE 1,2656,ELDORADO ELEMENTARY SCHOOL,5TH,1,9,1,9,83,103,20,19%
0900,DOUGLAS COUNTY RE 1,2656,ELDORADO ELEMENTARY SCHOOL,6TH,1,2,3,10,63,79,16,20%
0900,DOUGLAS COUNTY RE 1,2656,ELDORADO ELEMENTARY SCHOOL,SCHOOL TOTAL,4,42,12,48,548,654,106,16%
0900,DOUGLAS COUNTY RE 1,2952,MAMMOTH HEIGHTS ELEMENTARY,HALF DAY K,1,4,2,8,101,116,15,13%
0900,DOUGLAS COUNTY RE 1,2952,MAMMOTH HEIGHTS ELEMENTARY,1ST,1,5,2,6,116,130,14,11%
0900,DOUGLAS COUNTY RE 1,2952,MAMMOTH HEIGHTS ELEMENTARY,2ND,1,7,0,8,105,121,16,13%
0900,DOUGLAS COUNTY RE 1,2952,MAMMOTH HEIGHTS ELEMENTARY,3RD,0,4,3,7,88,102,14,14%
0900,DOUGLAS COUNTY RE 1,2952,MAMMOTH HEIGHTS ELEMENTARY,4TH,0,8,3,7,76,94,18,19%
0900,DOUGLAS COUNTY RE 1,2952,MAMMOTH HEIGHTS ELEMENTARY,5TH,0,4,8,14,70,96,26,27%
0900,DOUGLAS COUNTY RE 1,2952,MAMMOTH HEIGHTS ELEMENTARY,6TH,0,7,4,6,72,89,17,19%
0900,DOUGLAS COUNTY RE 1,2952,MAMMOTH HEIGHTS ELEMENTARY,SCHOOL TOTAL,3,39,22,56,628,748,120,16%
0900,DOUGLAS COUNTY RE 1,2953,STONE MOUNTAIN ELEMENTARY,HALF DAY K,0,1,0,3,50,54,4,7%
0900,DOUGLAS COUNTY RE 1,2953,STONE MOUNTAIN ELEMENTARY,1ST,1,2,1,2,49,55,6,11%
0900,DOUGLAS COUNTY RE 1,2953,STONE MOUNTAIN ELEMENTARY,2ND,0,2,2,5,60,69,9,13%
0900,DOUGLAS COUNTY RE 1,2953,STONE MOUNTAIN ELEMENTARY,3RD,0,4,0,0,58,62,4,6%
0900,DOUGLAS COUNTY RE 1,2953,STONE MOUNTAIN ELEMENTARY,4TH,0,0,2,2,51,55,4,7%
0900,DOUGLAS COUNTY RE 1,2953,STONE MOUNTAIN ELEMENTARY,5TH,0,3,1,4,48,56,8,14%
0900,DOUGLAS COUNTY RE 1,2953,STONE MOUNTAIN ELEMENTARY,6TH,0,0,2,4,72,78,6,8%
0900,DOUGLAS COUNTY RE 1,2953,STONE MOUNTAIN ELEMENTARY,SCHOOL TOTAL,1,12,8,20,388,429,41,10%
0900,DOUGLAS COUNTY RE 1,2954,ROXBOROUGH INTERMEDIATE,3RD,1,1,2,9,124,137,13,9%
0900,DOUGLAS COUNTY RE 1,2954,ROXBOROUGH INTERMEDIATE,4TH,0,4,5,11,109,129,20,16%
0900,DOUGLAS COUNTY RE 1,2954,ROXBOROUGH INTERMEDIATE,5TH,0,4,4,9,98,115,17,15%
0900,DOUGLAS COUNTY RE 1,2954,ROXBOROUGH INTERMEDIATE,6TH,1,3,3,12,100,119,19,16%
0900,DOUGLAS COUNTY RE 1,2954,ROXBOROUGH INTERMEDIATE,SCHOOL TOTAL,2,12,14,41,431,500,69,14%
0900,DOUGLAS COUNTY RE 1,2965,FLAGSTONE ELEMENTARY SCHOOL,HALF DAY K,1,1,2,7,88,99,11,11%
0900,DOUGLAS COUNTY RE 1,2965,FLAGSTONE ELEMENTARY SCHOOL,1ST,0,3,2,8,99,112,13,12%
0900,DOUGLAS COUNTY RE 1,2965,FLAGSTONE ELEMENTARY SCHOOL,2ND,0,1,0,12,93,106,13,12%
0900,DOUGLAS COUNTY RE 1,2965,FLAGSTONE ELEMENTARY SCHOOL,3RD,2,0,2,9,103,116,13,11%
0900,DOUGLAS COUNTY RE 1,2965,FLAGSTONE ELEMENTARY SCHOOL,4TH,1,3,2,14,111,131,20,15%
0900,DOUGLAS COUNTY RE 1,2965,FLAGSTONE ELEMENTARY SCHOOL,5TH,1,0,1,13,85,100,15,15%
0900,DOUGLAS COUNTY RE 1,2965,FLAGSTONE ELEMENTARY SCHOOL,6TH,2,3,1,10,85,101,16,16%
0900,DOUGLAS COUNTY RE 1,2965,FLAGSTONE ELEMENTARY SCHOOL,SCHOOL TOTAL,7,11,10,73,664,765,101,13%
0900,DOUGLAS COUNTY RE 1,3138,FOX CREEK ELEMENTARY SCHOOL,HALF DAY K,0,4,2,2,67,75,8,11%
0900,DOUGLAS COUNTY RE 1,3138,FOX CREEK ELEMENTARY SCHOOL,1ST,0,4,5,4,63,76,13,17%
0900,DOUGLAS COUNTY RE 1,3138,FOX CREEK ELEMENTARY SCHOOL,2ND,0,6,2,3,72,83,11,13%
0900,DOUGLAS COUNTY RE 1,3138,FOX CREEK ELEMENTARY SCHOOL,3RD,1,3,1,3,66,74,8,11%
0900,DOUGLAS COUNTY RE 1,3138,FOX CREEK ELEMENTARY SCHOOL,4TH,1,3,1,7,76,88,12,14%
0900,DOUGLAS COUNTY RE 1,3138,FOX CREEK ELEMENTARY SCHOOL,5TH,0,4,5,1,74,84,10,12%
0900,DOUGLAS COUNTY RE 1,3138,FOX CREEK ELEMENTARY SCHOOL,6TH,1,4,3,7,77,92,15,16%
0900,DOUGLAS COUNTY RE 1,3138,FOX CREEK ELEMENTARY SCHOOL,SCHOOL TOTAL,3,28,19,27,495,572,77,13%
0900,DOUGLAS COUNTY RE 1,3172,FRANKTOWN ELEMENTARY SCHOOL,HALF DAY K,0,0,0,2,32,34,2,6%
0900,DOUGLAS COUNTY RE 1,3172,FRANKTOWN ELEMENTARY SCHOOL,1ST,1,0,0,7,32,40,8,20%
0900,DOUGLAS COUNTY RE 1,3172,FRANKTOWN ELEMENTARY SCHOOL,2ND,1,1,0,0,45,47,2,4%
0900,DOUGLAS COUNTY RE 1,3172,FRANKTOWN ELEMENTARY SCHOOL,3RD,1,1,0,4,35,41,6,15%
0900,DOUGLAS COUNTY RE 1,3172,FRANKTOWN ELEMENTARY SCHOOL,4TH,0,0,0,3,47,50,3,6%
0900,DOUGLAS COUNTY RE 1,3172,FRANKTOWN ELEMENTARY SCHOOL,5TH,1,1,1,3,43,49,6,12%
0900,DOUGLAS COUNTY RE 1,3172,FRANKTOWN ELEMENTARY SCHOOL,6TH,1,1,1,1,42,46,4,9%
0900,DOUGLAS COUNTY RE 1,3172,FRANKTOWN ELEMENTARY SCHOOL,SCHOOL TOTAL,5,4,2,20,276,307,31,10%
0900,DOUGLAS COUNTY RE 1,3241,FRONTIER VALLEY ELEMENTARY SCHOOL,HALF DAY K,0,2,2,4,119,127,8,6%
0900,DOUGLAS COUNTY RE 1,3241,FRONTIER VALLEY ELEMENTARY SCHOOL,1ST,0,6,2,9,102,119,17,14%
0900,DOUGLAS COUNTY RE 1,3241,FRONTIER VALLEY ELEMENTARY SCHOOL,2ND,1,4,2,8,108,123,15,12%
0900,DOUGLAS COUNTY RE 1,3241,FRONTIER VALLEY ELEMENTARY SCHOOL,3RD,0,5,1,6,118,130,12,9%
0900,DOUGLAS COUNTY RE 1,3241,FRONTIER VALLEY ELEMENTARY SCHOOL,4TH,0,2,3,9,104,118,14,12%
0900,DOUGLAS COUNTY RE 1,3241,FRONTIER VALLEY ELEMENTARY SCHOOL,5TH,2,2,4,6,122,136,14,10%
0900,DOUGLAS COUNTY RE 1,3241,FRONTIER VALLEY ELEMENTARY SCHOOL,6TH,1,3,2,6,92,104,12,12%
0900,DOUGLAS COUNTY RE 1,3241,FRONTIER VALLEY ELEMENTARY SCHOOL,SCHOOL TOTAL,4,24,16,48,765,857,92,11%
0900,DOUGLAS COUNTY RE 1,3928,HERITAGE ELEMENTARY SCHOOL,HALF DAY K,2,7,1,2,90,102,12,12%
0900,DOUGLAS COUNTY RE 1,3928,HERITAGE ELEMENTARY SCHOOL,1ST,1,5,2,6,91,105,14,13%
0900,DOUGLAS COUNTY RE 1,3928,HERITAGE ELEMENTARY SCHOOL,2ND,0,7,2,5,84,98,14,14%
0900,DOUGLAS COUNTY RE 1,3928,HERITAGE ELEMENTARY SCHOOL,3RD,0,8,1,2,92,103,11,11%
0900,DOUGLAS COUNTY RE 1,3928,HERITAGE ELEMENTARY SCHOOL,4TH,0,11,4,4,78,97,19,20%
0900,DOUGLAS COUNTY RE 1,3928,HERITAGE ELEMENTARY SCHOOL,5TH,0,5,1,4,73,83,10,12%
0900,DOUGLAS COUNTY RE 1,3928,HERITAGE ELEMENTARY SCHOOL,6TH,0,7,2,6,65,80,15,19%
0900,DOUGLAS COUNTY RE 1,3928,HERITAGE ELEMENTARY SCHOOL,SCHOOL TOTAL,3,50,13,29,573,668,95,14%
0900,DOUGLAS COUNTY RE 1,3980,HIGHLANDS RANCH HIGH SCHOOL,9TH,1,35,26,56,352,470,118,25%
0900,DOUGLAS COUNTY RE 1,3980,HIGHLANDS RANCH HIGH SCHOOL,10TH,5,24,13,41,321,404,83,21%
0900,DOUGLAS COUNTY RE 1,3980,HIGHLANDS RANCH HIGH SCHOOL,11TH,5,28,20,56,363,472,109,23%
0900,DOUGLAS COUNTY RE 1,3980,HIGHLANDS RANCH HIGH SCHOOL,12TH,0,28,11,33,264,336,72,21%
0900,DOUGLAS COUNTY RE 1,3980,HIGHLANDS RANCH HIGH SCHOOL,SCHOOL TOTAL,11,115,70,186,1300,1682,382,23%
0900,DOUGLAS COUNTY RE 1,3995,HOPE ON-LINE,KINDERGARTEN,2,11,95,134,61,303,242,80%
0900,DOUGLAS COUNTY RE 1,3995,HOPE ON-LINE,1ST,0,15,85,106,42,248,206,83%
0900,DOUGLAS COUNTY RE 1,3995,HOPE ON-LINE,2ND,2,7,80,107,45,241,196,81%
0900,DOUGLAS COUNTY RE 1,3995,HOPE ON-LINE,3RD,3,11,66,84,33,197,164,83%
0900,DOUGLAS COUNTY RE 1,3995,HOPE ON-LINE,4TH,0,9,54,95,41,199,158,79%
0900,DOUGLAS COUNTY RE 1,3995,HOPE ON-LINE,5TH,2,7,52,91,35,187,152,81%
0900,DOUGLAS COUNTY RE 1,3995,HOPE ON-LINE,6TH,2,6,46,100,27,181,154,85%
0900,DOUGLAS COUNTY RE 1,3995,HOPE ON-LINE,7TH,2,6,49,82,34,173,139,80%
0900,DOUGLAS COUNTY RE 1,3995,HOPE ON-LINE,8TH,2,4,35,103,41,185,144,78%
0900,DOUGLAS COUNTY RE 1,3995,HOPE ON-LINE,9TH,8,1,65,181,112,367,255,69%
0900,DOUGLAS COUNTY RE 1,3995,HOPE ON-LINE,10TH,3,3,47,118,127,298,171,57%
0900,DOUGLAS COUNTY RE 1,3995,HOPE ON-LINE,11TH,4,3,32,68,82,189,107,57%
0900,DOUGLAS COUNTY RE 1,3995,HOPE ON-LINE,12TH,0,3,9,27,32,71,39,55%
0900,DOUGLAS COUNTY RE 1,3995,HOPE ON-LINE,SCHOOL TOTAL,30,86,715,1296,712,2839,2127,75%
0900,DOUGLAS COUNTY RE 1,4271,LEGEND HIGH SCHOOL,9TH,2,11,16,26,399,454,55,12%
0900,DOUGLAS COUNTY RE 1,4271,LEGEND HIGH SCHOOL,10TH,2,10,10,22,344,388,44,11%
0900,DOUGLAS COUNTY RE 1,4271,LEGEND HIGH SCHOOL,SCHOOL TOTAL,4,21,26,48,743,842,99,12%
0900,DOUGLAS COUNTY RE 1,4292,IRON HORSE ELEMENTARY SCHOOL,HALF DAY K,1,3,1,4,81,90,9,10%
0900,DOUGLAS COUNTY RE 1,4292,IRON HORSE ELEMENTARY SCHOOL,1ST,1,2,1,9,80,93,13,14%
0900,DOUGLAS COUNTY RE 1,4292,IRON HORSE ELEMENTARY SCHOOL,2ND,1,2,3,8,81,95,14,15%
0900,DOUGLAS COUNTY RE 1,4292,IRON HORSE ELEMENTARY SCHOOL,3RD,0,1,3,8,70,82,12,15%
0900,DOUGLAS COUNTY RE 1,4292,IRON HORSE ELEMENTARY SCHOOL,4TH,1,4,0,8,87,100,13,13%
0900,DOUGLAS COUNTY RE 1,4292,IRON HORSE ELEMENTARY SCHOOL,5TH,0,1,3,8,75,87,12,14%
0900,DOUGLAS COUNTY RE 1,4292,IRON HORSE ELEMENTARY SCHOOL,6TH,0,0,2,6,90,98,8,8%
0900,DOUGLAS COUNTY RE 1,4292,IRON HORSE ELEMENTARY SCHOOL,SCHOOL TOTAL,4,13,13,51,564,645,81,13%
0900,DOUGLAS COUNTY RE 1,4980,LARKSPUR ELEMENTARY SCHOOL,HALF DAY K,0,1,1,1,25,28,3,11%
0900,DOUGLAS COUNTY RE 1,4980,LARKSPUR ELEMENTARY SCHOOL,1ST,0,1,0,3,45,49,4,8%
0900,DOUGLAS COUNTY RE 1,4980,LARKSPUR ELEMENTARY SCHOOL,2ND,0,3,0,0,35,38,3,8%
0900,DOUGLAS COUNTY RE 1,4980,LARKSPUR ELEMENTARY SCHOOL,3RD,0,2,0,2,40,44,4,9%
0900,DOUGLAS COUNTY RE 1,4980,LARKSPUR ELEMENTARY SCHOOL,4TH,0,4,0,5,35,44,9,20%
0900,DOUGLAS COUNTY RE 1,4980,LARKSPUR ELEMENTARY SCHOOL,5TH,1,1,0,3,48,53,5,9%
0900,DOUGLAS COUNTY RE 1,4980,LARKSPUR ELEMENTARY SCHOOL,6TH,0,1,0,5,53,59,6,10%
0900,DOUGLAS COUNTY RE 1,4980,LARKSPUR ELEMENTARY SCHOOL,SCHOOL TOTAL,1,13,1,19,281,315,34,11%
0900,DOUGLAS COUNTY RE 1,5045,LEGACY POINT ELEMENTARY SCHOOL,HALF DAY K,1,1,2,4,83,91,8,9%
0900,DOUGLAS COUNTY RE 1,5045,LEGACY POINT ELEMENTARY SCHOOL,1ST,0,5,2,9,72,88,16,18%
0900,DOUGLAS COUNTY RE 1,5045,LEGACY POINT ELEMENTARY SCHOOL,2ND,0,1,2,6,77,86,9,10%
0900,DOUGLAS COUNTY RE 1,5045,LEGACY POINT ELEMENTARY SCHOOL,3RD,0,1,1,6,76,84,8,10%
0900,DOUGLAS COUNTY RE 1,5045,LEGACY POINT ELEMENTARY SCHOOL,4TH,0,3,2,15,67,87,20,23%
0900,DOUGLAS COUNTY RE 1,5045,LEGACY POINT ELEMENTARY SCHOOL,5TH,0,3,3,9,75,90,15,17%
0900,DOUGLAS COUNTY RE 1,5045,LEGACY POINT ELEMENTARY SCHOOL,6TH,0,1,2,10,66,79,13,16%
0900,DOUGLAS COUNTY RE 1,5045,LEGACY POINT ELEMENTARY SCHOOL,SCHOOL TOTAL,1,15,14,59,516,605,89,15%
0900,DOUGLAS COUNTY RE 1,5405,EDCSD ON-LINE EDUCATION,HALF DAY K,0,0,0,0,2,2,0,0%
0900,DOUGLAS COUNTY RE 1,5405,EDCSD ON-LINE EDUCATION,1ST,0,0,0,0,6,6,0,0%
0900,DOUGLAS COUNTY RE 1,5405,EDCSD ON-LINE EDUCATION,2ND,0,0,0,0,3,3,0,0%
0900,DOUGLAS COUNTY RE 1,5405,EDCSD ON-LINE EDUCATION,3RD,0,0,0,0,2,2,0,0%
0900,DOUGLAS COUNTY RE 1,5405,EDCSD ON-LINE EDUCATION,4TH,0,0,0,0,6,6,0,0%
0900,DOUGLAS COUNTY RE 1,5405,EDCSD ON-LINE EDUCATION,5TH,0,0,1,0,9,10,1,10%
0900,DOUGLAS COUNTY RE 1,5405,EDCSD ON-LINE EDUCATION,6TH,0,0,0,1,7,8,1,13%
0900,DOUGLAS COUNTY RE 1,5405,EDCSD ON-LINE EDUCATION,7TH,0,0,1,1,11,13,2,15%
0900,DOUGLAS COUNTY RE 1,5405,EDCSD ON-LINE EDUCATION,8TH,0,2,0,1,11,14,3,21%
0900,DOUGLAS COUNTY RE 1,5405,EDCSD ON-LINE EDUCATION,9TH,0,0,1,0,27,28,1,4%
0900,DOUGLAS COUNTY RE 1,5405,EDCSD ON-LINE EDUCATION,10TH,0,1,0,1,18,20,2,10%
0900,DOUGLAS COUNTY RE 1,5405,EDCSD ON-LINE EDUCATION,11TH,0,0,0,3,24,27,3,11%
0900,DOUGLAS COUNTY RE 1,5405,EDCSD ON-LINE EDUCATION,12TH,0,0,0,2,16,18,2,11%
0900,DOUGLAS COUNTY RE 1,5405,EDCSD ON-LINE EDUCATION,SCHOOL TOTAL,0,3,3,9,142,157,15,10%
0900,DOUGLAS COUNTY RE 1,5745,MEADOW VIEW ELEMENTARY SCHOOL,HALF DAY K,1,1,0,6,76,84,8,10%
0900,DOUGLAS COUNTY RE 1,5745,MEADOW VIEW ELEMENTARY SCHOOL,1ST,0,2,0,4,70,76,6,8%
0900,DOUGLAS COUNTY RE 1,5745,MEADOW VIEW ELEMENTARY SCHOOL,2ND,0,2,1,7,70,80,10,13%
0900,DOUGLAS COUNTY RE 1,5745,MEADOW VIEW ELEMENTARY SCHOOL,3RD,0,1,2,10,76,89,13,15%
0900,DOUGLAS COUNTY RE 1,5745,MEADOW VIEW ELEMENTARY SCHOOL,4TH,0,1,1,7,81,90,9,10%
0900,DOUGLAS COUNTY RE 1,5745,MEADOW VIEW ELEMENTARY SCHOOL,5TH,0,1,2,5,70,78,8,10%
0900,DOUGLAS COUNTY RE 1,5745,MEADOW VIEW ELEMENTARY SCHOOL,6TH,0,3,0,8,77,88,11,13%
0900,DOUGLAS COUNTY RE 1,5745,MEADOW VIEW ELEMENTARY SCHOOL,SCHOOL TOTAL,1,11,6,47,520,585,65,11%
0900,DOUGLAS COUNTY RE 1,5843,LONE TREE ELEMENTARY,HALF DAY K,0,5,2,10,77,94,17,18%
0900,DOUGLAS COUNTY RE 1,5843,LONE TREE ELEMENTARY,KINDERGARTEN,0,0,0,0,1,1,0,0%
0900,DOUGLAS COUNTY RE 1,5843,LONE TREE ELEMENTARY,1ST,0,9,2,3,81,95,14,15%
0900,DOUGLAS COUNTY RE 1,5843,LONE TREE ELEMENTARY,2ND,0,7,1,4,75,87,12,14%
0900,DOUGLAS COUNTY RE 1,5843,LONE TREE ELEMENTARY,3RD,0,3,2,6,70,81,11,14%
0900,DOUGLAS COUNTY RE 1,5843,LONE TREE ELEMENTARY,4TH,0,8,2,2,66,78,12,15%
0900,DOUGLAS COUNTY RE 1,5843,LONE TREE ELEMENTARY,5TH,0,4,2,1,45,52,7,13%
0900,DOUGLAS COUNTY RE 1,5843,LONE TREE ELEMENTARY,6TH,2,3,1,3,38,47,9,19%
0900,DOUGLAS COUNTY RE 1,5843,LONE TREE ELEMENTARY,SCHOOL TOTAL,2,39,12,29,453,535,82,15%
0900,DOUGLAS COUNTY RE 1,5997,D C S MONTESSORI CHARTER SCHOOL,PK,2,4,1,3,96,106,10,9%
0900,DOUGLAS COUNTY RE 1,5997,D C S MONTESSORI CHARTER SCHOOL,HALF DAY K,1,6,0,3,66,76,10,13%
0900,DOUGLAS COUNTY RE 1,5997,D C S MONTESSORI CHARTER SCHOOL,1ST,0,4,1,1,55,61,6,10%
0900,DOUGLAS COUNTY RE 1,5997,D C S MONTESSORI CHARTER SCHOOL,2ND,0,7,0,3,45,55,10,18%
0900,DOUGLAS COUNTY RE 1,5997,D C S MONTESSORI CHARTER SCHOOL,3RD,0,1,0,1,50,52,2,4%
0900,DOUGLAS COUNTY RE 1,5997,D C S MONTESSORI CHARTER SCHOOL,4TH,0,0,1,3,42,46,4,9%
0900,DOUGLAS COUNTY RE 1,5997,D C S MONTESSORI CHARTER SCHOOL,5TH,0,1,1,1,38,41,3,7%
0900,DOUGLAS COUNTY RE 1,5997,D C S MONTESSORI CHARTER SCHOOL,6TH,0,1,1,0,20,22,2,9%
0900,DOUGLAS COUNTY RE 1,5997,D C S MONTESSORI CHARTER SCHOOL,SCHOOL TOTAL,3,24,5,15,412,459,47,10%
0900,DOUGLAS COUNTY RE 1,6152,MOUNTAIN VIEW ELEMENTARY SCHOOL,HALF DAY K,0,6,1,6,124,137,13,9%
0900,DOUGLAS COUNTY RE 1,6152,MOUNTAIN VIEW ELEMENTARY SCHOOL,1ST,0,2,3,5,120,130,10,8%
0900,DOUGLAS COUNTY RE 1,6152,MOUNTAIN VIEW ELEMENTARY SCHOOL,2ND,1,7,0,8,151,167,16,10%
0900,DOUGLAS COUNTY RE 1,6152,MOUNTAIN VIEW ELEMENTARY SCHOOL,3RD,1,3,3,8,132,147,15,10%
0900,DOUGLAS COUNTY RE 1,6152,MOUNTAIN VIEW ELEMENTARY SCHOOL,SCHOOL TOTAL,2,18,7,27,527,581,54,9%
0900,DOUGLAS COUNTY RE 1,6164,MOUNTAIN RIDGE MIDDLE SCHOOL,7TH,2,25,5,36,433,501,68,14%
0900,DOUGLAS COUNTY RE 1,6164,MOUNTAIN RIDGE MIDDLE SCHOOL,8TH,1,32,12,35,459,539,80,15%
0900,DOUGLAS COUNTY RE 1,6164,MOUNTAIN RIDGE MIDDLE SCHOOL,SCHOOL TOTAL,3,57,17,71,892,1040,148,14%
0900,DOUGLAS COUNTY RE 1,6165,MOUNTAIN VISTA HIGH SCHOOL,9TH,4,36,9,39,476,564,88,16%
0900,DOUGLAS COUNTY RE 1,6165,MOUNTAIN VISTA HIGH SCHOOL,10TH,3,28,11,42,393,477,84,18%
0900,DOUGLAS COUNTY RE 1,6165,MOUNTAIN VISTA HIGH SCHOOL,11TH,1,21,11,29,402,464,62,13%
0900,DOUGLAS COUNTY RE 1,6165,MOUNTAIN VISTA HIGH SCHOOL,12TH,0,24,8,23,416,471,55,12%
0900,DOUGLAS COUNTY RE 1,6165,MOUNTAIN VISTA HIGH SCHOOL,SCHOOL TOTAL,8,109,39,133,1687,1976,289,15%
0900,DOUGLAS COUNTY RE 1,6396,NORTHEAST ELEMENTARY SCHOOL,4TH,2,8,2,14,158,184,26,14%
0900,DOUGLAS COUNTY RE 1,6396,NORTHEAST ELEMENTARY SCHOOL,5TH,0,2,0,19,132,153,21,14%
0900,DOUGLAS COUNTY RE 1,6396,NORTHEAST ELEMENTARY SCHOOL,6TH,3,6,6,12,180,207,27,13%
0900,DOUGLAS COUNTY RE 1,6396,NORTHEAST ELEMENTARY SCHOOL,SCHOOL TOTAL,5,16,8,45,470,544,74,14%
0900,DOUGLAS COUNTY RE 1,6406,NORTHRIDGE ELEMENTARY SCHOOL,HALF DAY K,0,10,1,3,94,108,14,13%
0900,DOUGLAS COUNTY RE 1,6406,NORTHRIDGE ELEMENTARY SCHOOL,1ST,1,17,0,3,91,112,21,19%
0900,DOUGLAS COUNTY RE 1,6406,NORTHRIDGE ELEMENTARY SCHOOL,2ND,0,11,1,8,84,104,20,19%
0900,DOUGLAS COUNTY RE 1,6406,NORTHRIDGE ELEMENTARY SCHOOL,3RD,0,17,3,7,91,118,27,23%
0900,DOUGLAS COUNTY RE 1,6406,NORTHRIDGE ELEMENTARY SCHOOL,4TH,1,15,0,10,76,102,26,25%
0900,DOUGLAS COUNTY RE 1,6406,NORTHRIDGE ELEMENTARY SCHOOL,5TH,0,8,1,6,81,96,15,16%
0900,DOUGLAS COUNTY RE 1,6406,NORTHRIDGE ELEMENTARY SCHOOL,6TH,1,14,3,9,74,101,27,27%
0900,DOUGLAS COUNTY RE 1,6406,NORTHRIDGE ELEMENTARY SCHOOL,SCHOOL TOTAL,3,92,9,46,591,741,150,20%
0900,DOUGLAS COUNTY RE 1,6772,SAGEWOOD MIDDLE SCHOOL,7TH,2,15,7,14,251,289,38,13%
0900,DOUGLAS COUNTY RE 1,6772,SAGEWOOD MIDDLE SCHOOL,8TH,2,7,7,25,281,322,41,13%
0900,DOUGLAS COUNTY RE 1,6772,SAGEWOOD MIDDLE SCHOOL,SCHOOL TOTAL,4,22,14,39,532,611,79,13%
0900,DOUGLAS COUNTY RE 1,6773,SIERRA MIDDLE SCHOOL,7TH,4,27,14,45,415,505,90,18%
0900,DOUGLAS COUNTY RE 1,6773,SIERRA MIDDLE SCHOOL,8TH,0,14,10,45,413,482,69,14%
0900,DOUGLAS COUNTY RE 1,6773,SIERRA MIDDLE SCHOOL,SCHOOL TOTAL,4,41,24,90,828,987,159,16%
0900,DOUGLAS COUNTY RE 1,6938,PINE GROVE ELEMENTARY SCHOOL,HALF DAY K,0,9,1,3,63,76,13,17%
0900,DOUGLAS COUNTY RE 1,6938,PINE GROVE ELEMENTARY SCHOOL,1ST,0,5,1,8,76,90,14,16%
0900,DOUGLAS COUNTY RE 1,6938,PINE GROVE ELEMENTARY SCHOOL,2ND,0,4,1,2,80,87,7,8%
0900,DOUGLAS COUNTY RE 1,6938,PINE GROVE ELEMENTARY SCHOOL,3RD,0,5,0,8,68,81,13,16%
0900,DOUGLAS COUNTY RE 1,6938,PINE GROVE ELEMENTARY SCHOOL,4TH,0,6,1,6,89,102,13,13%
0900,DOUGLAS COUNTY RE 1,6938,PINE GROVE ELEMENTARY SCHOOL,5TH,0,1,0,2,68,71,3,4%
0900,DOUGLAS COUNTY RE 1,6938,PINE GROVE ELEMENTARY SCHOOL,6TH,0,4,0,6,95,105,10,10%
0900,DOUGLAS COUNTY RE 1,6938,PINE GROVE ELEMENTARY SCHOOL,SCHOOL TOTAL,0,34,4,35,539,612,73,12%
0900,DOUGLAS COUNTY RE 1,6940,PINE LANE ELEMENTARY,HALF DAY K,0,3,5,17,91,116,25,22%
0900,DOUGLAS COUNTY RE 1,6940,PINE LANE ELEMENTARY,KINDERGARTEN,1,0,0,1,5,7,2,29%
0900,DOUGLAS COUNTY RE 1,6940,PINE LANE ELEMENTARY,1ST,1,5,3,15,127,151,24,16%
0900,DOUGLAS COUNTY RE 1,6940,PINE LANE ELEMENTARY,2ND,1,7,7,17,116,148,32,22%
0900,DOUGLAS COUNTY RE 1,6940,PINE LANE ELEMENTARY,3RD,0,7,2,20,123,152,29,19%
0900,DOUGLAS COUNTY RE 1,6940,PINE LANE ELEMENTARY,4TH,4,5,6,20,119,154,35,23%
0900,DOUGLAS COUNTY RE 1,6940,PINE LANE ELEMENTARY,5TH,0,7,6,23,127,163,36,22%
0900,DOUGLAS COUNTY RE 1,6940,PINE LANE ELEMENTARY,6TH,0,15,6,19,109,149,40,27%
0900,DOUGLAS COUNTY RE 1,6940,PINE LANE ELEMENTARY,SCHOOL TOTAL,7,49,35,132,817,1040,223,21%
0900,DOUGLAS COUNTY RE 1,6961,PIONEER ELEMENTARY SCHOOL,HALF DAY K,0,3,1,8,83,95,12,13%
0900,DOUGLAS COUNTY RE 1,6961,PIONEER ELEMENTARY SCHOOL,1ST,0,2,3,8,79,92,13,14%
0900,DOUGLAS COUNTY RE 1,6961,PIONEER ELEMENTARY SCHOOL,2ND,1,2,1,6,78,88,10,11%
0900,DOUGLAS COUNTY RE 1,6961,PIONEER ELEMENTARY SCHOOL,3RD,2,4,0,10,76,92,16,17%
0900,DOUGLAS COUNTY RE 1,6961,PIONEER ELEMENTARY SCHOOL,4TH,1,4,5,7,83,100,17,17%
0900,DOUGLAS COUNTY RE 1,6961,PIONEER ELEMENTARY SCHOOL,5TH,1,1,1,8,86,97,11,11%
0900,DOUGLAS COUNTY RE 1,6961,PIONEER ELEMENTARY SCHOOL,6TH,2,1,2,6,93,104,11,11%
0900,DOUGLAS COUNTY RE 1,6961,PIONEER ELEMENTARY SCHOOL,SCHOOL TOTAL,7,17,13,53,578,668,90,13%
0900,DOUGLAS COUNTY RE 1,7047,PLATTE RIVER CHARTER ACADEMY,HALF DAY K,1,2,1,5,45,54,9,17%
0900,DOUGLAS COUNTY RE 1,7047,PLATTE RIVER CHARTER ACADEMY,1ST,0,7,2,2,44,55,11,20%
0900,DOUGLAS COUNTY RE 1,7047,PLATTE RIVER CHARTER ACADEMY,2ND,0,9,2,2,44,57,13,23%
0900,DOUGLAS COUNTY RE 1,7047,PLATTE RIVER CHARTER ACADEMY,3RD,0,0,1,2,51,54,3,6%
0900,DOUGLAS COUNTY RE 1,7047,PLATTE RIVER CHARTER ACADEMY,4TH,1,5,0,3,44,53,9,17%
0900,DOUGLAS COUNTY RE 1,7047,PLATTE RIVER CHARTER ACADEMY,5TH,0,8,0,2,44,54,10,19%
0900,DOUGLAS COUNTY RE 1,7047,PLATTE RIVER CHARTER ACADEMY,6TH,1,4,3,1,43,52,9,17%
0900,DOUGLAS COUNTY RE 1,7047,PLATTE RIVER CHARTER ACADEMY,7TH,0,5,1,2,69,77,8,10%
0900,DOUGLAS COUNTY RE 1,7047,PLATTE RIVER CHARTER ACADEMY,8TH,0,6,0,1,44,51,7,14%
0900,DOUGLAS COUNTY RE 1,7047,PLATTE RIVER CHARTER ACADEMY,SCHOOL TOTAL,3,46,10,20,428,507,79,16%
0900,DOUGLAS COUNTY RE 1,7091,PLUM CREEK ACADEMY,7TH,0,0,0,0,2,2,0,0%
0900,DOUGLAS COUNTY RE 1,7091,PLUM CREEK ACADEMY,8TH,0,1,0,1,2,4,2,50%
0900,DOUGLAS COUNTY RE 1,7091,PLUM CREEK ACADEMY,9TH,0,0,0,1,4,5,1,20%
0900,DOUGLAS COUNTY RE 1,7091,PLUM CREEK ACADEMY,10TH,0,0,0,1,5,6,1,17%
0900,DOUGLAS COUNTY RE 1,7091,PLUM CREEK ACADEMY,11TH,0,0,0,3,4,7,3,43%
0900,DOUGLAS COUNTY RE 1,7091,PLUM CREEK ACADEMY,12TH,0,0,0,0,5,5,0,0%
0900,DOUGLAS COUNTY RE 1,7091,PLUM CREEK ACADEMY,SCHOOL TOTAL,0,1,0,6,22,29,7,24%
0900,DOUGLAS COUNTY RE 1,7096,ROXBOROUGH ELEMENTARY SCHOOL,HALF DAY K,2,0,1,7,142,152,10,7%
0900,DOUGLAS COUNTY RE 1,7096,ROXBOROUGH ELEMENTARY SCHOOL,1ST,1,3,2,8,142,156,14,9%
0900,DOUGLAS COUNTY RE 1,7096,ROXBOROUGH ELEMENTARY SCHOOL,2ND,0,2,2,16,120,140,20,14%
0900,DOUGLAS COUNTY RE 1,7096,ROXBOROUGH ELEMENTARY SCHOOL,SCHOOL TOTAL,3,5,5,31,404,448,44,10%
0900,DOUGLAS COUNTY RE 1,7118,PONDEROSA HIGH SCHOOL,9TH,1,12,3,26,310,352,42,12%
0900,DOUGLAS COUNTY RE 1,7118,PONDEROSA HIGH SCHOOL,10TH,2,4,4,23,307,340,33,10%
0900,DOUGLAS COUNTY RE 1,7118,PONDEROSA HIGH SCHOOL,11TH,3,15,6,32,438,494,56,11%
0900,DOUGLAS COUNTY RE 1,7118,PONDEROSA HIGH SCHOOL,12TH,3,18,9,21,440,491,51,10%
0900,DOUGLAS COUNTY RE 1,7118,PONDEROSA HIGH SCHOOL,SCHOOL TOTAL,9,49,22,102,1495,1677,182,11%
0900,DOUGLAS COUNTY RE 1,7134,PRAIRIE CROSSING ELEMENTARY SCHOOL,HALF DAY K,0,2,3,4,94,103,9,9%
0900,DOUGLAS COUNTY RE 1,7134,PRAIRIE CROSSING ELEMENTARY SCHOOL,1ST,0,9,1,8,65,83,18,22%
0900,DOUGLAS COUNTY RE 1,7134,PRAIRIE CROSSING ELEMENTARY SCHOOL,2ND,0,8,3,5,66,82,16,20%
0900,DOUGLAS COUNTY RE 1,7134,PRAIRIE CROSSING ELEMENTARY SCHOOL,3RD,1,4,1,5,80,91,11,12%
0900,DOUGLAS COUNTY RE 1,7134,PRAIRIE CROSSING ELEMENTARY SCHOOL,4TH,0,5,2,7,68,82,14,17%
0900,DOUGLAS COUNTY RE 1,7134,PRAIRIE CROSSING ELEMENTARY SCHOOL,5TH,0,4,0,6,49,59,10,17%
0900,DOUGLAS COUNTY RE 1,7134,PRAIRIE CROSSING ELEMENTARY SCHOOL,6TH,0,2,0,5,42,49,7,14%
0900,DOUGLAS COUNTY RE 1,7134,PRAIRIE CROSSING ELEMENTARY SCHOOL,SCHOOL TOTAL,1,34,10,40,464,549,85,15%
0900,DOUGLAS COUNTY RE 1,7245,RANCH VIEW MIDDLE SCHOOL,7TH,3,20,7,40,454,524,70,13%
0900,DOUGLAS COUNTY RE 1,7245,RANCH VIEW MIDDLE SCHOOL,8TH,6,20,10,44,412,492,80,16%
0900,DOUGLAS COUNTY RE 1,7245,RANCH VIEW MIDDLE SCHOOL,SCHOOL TOTAL,9,40,17,84,866,1016,150,15%
0900,DOUGLAS COUNTY RE 1,7297,REDSTONE ELEMENTARY SCHOOL,HALF DAY K,0,5,3,6,101,115,14,12%
0900,DOUGLAS COUNTY RE 1,7297,REDSTONE ELEMENTARY SCHOOL,1ST,0,14,1,2,151,168,17,10%
0900,DOUGLAS COUNTY RE 1,7297,REDSTONE ELEMENTARY SCHOOL,2ND,1,10,1,7,109,128,19,15%
0900,DOUGLAS COUNTY RE 1,7297,REDSTONE ELEMENTARY SCHOOL,3RD,0,16,2,8,88,114,26,23%
0900,DOUGLAS COUNTY RE 1,7297,REDSTONE ELEMENTARY SCHOOL,4TH,0,11,1,5,101,118,17,14%
0900,DOUGLAS COUNTY RE 1,7297,REDSTONE ELEMENTARY SCHOOL,5TH,0,7,0,8,100,115,15,13%
0900,DOUGLAS COUNTY RE 1,7297,REDSTONE ELEMENTARY SCHOOL,SCHOOL TOTAL,1,63,8,36,650,758,108,14%
0900,DOUGLAS COUNTY RE 1,7319,RENAISSANCE EXPEDITION LEARN OUTWARD BOUND SCHOOL,HALF DAY K,0,3,1,3,44,51,7,14%
0900,DOUGLAS COUNTY RE 1,7319,RENAISSANCE EXPEDITION LEARN OUTWARD BOUND SCHOOL,1ST,0,2,1,1,51,55,4,7%
0900,DOUGLAS COUNTY RE 1,7319,RENAISSANCE EXPEDITION LEARN OUTWARD BOUND SCHOOL,2ND,0,5,0,2,51,58,7,12%
0900,DOUGLAS COUNTY RE 1,7319,RENAISSANCE EXPEDITION LEARN OUTWARD BOUND SCHOOL,3RD,0,2,1,4,50,57,7,12%
0900,DOUGLAS COUNTY RE 1,7319,RENAISSANCE EXPEDITION LEARN OUTWARD BOUND SCHOOL,4TH,1,5,0,4,68,78,10,13%
0900,DOUGLAS COUNTY RE 1,7319,RENAISSANCE EXPEDITION LEARN OUTWARD BOUND SCHOOL,5TH,0,3,1,5,53,62,9,15%
0900,DOUGLAS COUNTY RE 1,7319,RENAISSANCE EXPEDITION LEARN OUTWARD BOUND SCHOOL,6TH,0,0,0,4,48,52,4,8%
0900,DOUGLAS COUNTY RE 1,7319,RENAISSANCE EXPEDITION LEARN OUTWARD BOUND SCHOOL,SCHOOL TOTAL,1,20,4,23,365,413,48,12%
0900,DOUGLAS COUNTY RE 1,7435,ROCK CANYON HIGH SCHOOL,9TH,0,26,11,19,365,421,56,13%
0900,DOUGLAS COUNTY RE 1,7435,ROCK CANYON HIGH SCHOOL,10TH,2,17,2,19,341,381,40,10%
0900,DOUGLAS COUNTY RE 1,7435,ROCK CANYON HIGH SCHOOL,11TH,1,13,6,19,310,349,39,11%
0900,DOUGLAS COUNTY RE 1,7435,ROCK CANYON HIGH SCHOOL,12TH,0,13,3,14,284,314,30,10%
0900,DOUGLAS COUNTY RE 1,7435,ROCK CANYON HIGH SCHOOL,SCHOOL TOTAL,3,69,22,71,1300,1465,165,11%
0900,DOUGLAS COUNTY RE 1,7448,ROCKY HEIGHTS MIDDLE SCHOOL,6TH,1,20,7,16,347,391,44,11%
0900,DOUGLAS COUNTY RE 1,7448,ROCKY HEIGHTS MIDDLE SCHOOL,7TH,0,25,7,18,375,425,50,12%
0900,DOUGLAS COUNTY RE 1,7448,ROCKY HEIGHTS MIDDLE SCHOOL,8TH,1,42,5,22,351,421,70,17%
0900,DOUGLAS COUNTY RE 1,7448,ROCKY HEIGHTS MIDDLE SCHOOL,SCHOOL TOTAL,2,87,19,56,1073,1237,164,13%
0900,DOUGLAS COUNTY RE 1,7562,SADDLE RANCH ELEMENTARY SCHOOL,HALF DAY K,0,5,0,3,56,64,8,13%
0900,DOUGLAS COUNTY RE 1,7562,SADDLE RANCH ELEMENTARY SCHOOL,1ST,0,7,2,8,76,93,17,18%
0900,DOUGLAS COUNTY RE 1,7562,SADDLE RANCH ELEMENTARY SCHOOL,2ND,0,5,1,4,86,96,10,10%
0900,DOUGLAS COUNTY RE 1,7562,SADDLE RANCH ELEMENTARY SCHOOL,3RD,0,7,1,7,70,85,15,18%
0900,DOUGLAS COUNTY RE 1,7562,SADDLE RANCH ELEMENTARY SCHOOL,4TH,1,7,0,2,81,91,10,11%
0900,DOUGLAS COUNTY RE 1,7562,SADDLE RANCH ELEMENTARY SCHOOL,5TH,1,7,0,3,85,96,11,11%
0900,DOUGLAS COUNTY RE 1,7562,SADDLE RANCH ELEMENTARY SCHOOL,6TH,1,5,0,5,75,86,11,13%
0900,DOUGLAS COUNTY RE 1,7562,SADDLE RANCH ELEMENTARY SCHOOL,SCHOOL TOTAL,3,43,4,32,529,611,82,13%
0900,DOUGLAS COUNTY RE 1,7610,SAND CREEK ELEMENTARY SCHOOL,HALF DAY K,1,2,0,5,84,92,8,9%
0900,DOUGLAS COUNTY RE 1,7610,SAND CREEK ELEMENTARY SCHOOL,1ST,0,5,1,9,95,110,15,14%
0900,DOUGLAS COUNTY RE 1,7610,SAND CREEK ELEMENTARY SCHOOL,2ND,1,0,2,8,68,79,11,14%
0900,DOUGLAS COUNTY RE 1,7610,SAND CREEK ELEMENTARY SCHOOL,3RD,1,5,1,6,88,101,13,13%
0900,DOUGLAS COUNTY RE 1,7610,SAND CREEK ELEMENTARY SCHOOL,4TH,0,3,3,7,70,83,13,16%
0900,DOUGLAS COUNTY RE 1,7610,SAND CREEK ELEMENTARY SCHOOL,5TH,0,5,3,7,66,81,15,19%
0900,DOUGLAS COUNTY RE 1,7610,SAND CREEK ELEMENTARY SCHOOL,6TH,2,5,2,4,74,87,13,15%
0900,DOUGLAS COUNTY RE 1,7610,SAND CREEK ELEMENTARY SCHOOL,SCHOOL TOTAL,5,25,12,46,545,633,88,14%
0900,DOUGLAS COUNTY RE 1,7718,SEDALIA ELEMENTARY SCHOOL,HALF DAY K,0,1,1,5,27,34,7,21%
0900,DOUGLAS COUNTY RE 1,7718,SEDALIA ELEMENTARY SCHOOL,KINDERGARTEN,0,0,1,1,10,12,2,17%
0900,DOUGLAS COUNTY RE 1,7718,SEDALIA ELEMENTARY SCHOOL,1ST,0,1,2,7,36,46,10,22%
0900,DOUGLAS COUNTY RE 1,7718,SEDALIA ELEMENTARY SCHOOL,2ND,0,0,0,11,35,46,11,24%
0900,DOUGLAS COUNTY RE 1,7718,SEDALIA ELEMENTARY SCHOOL,3RD,1,1,1,12,44,59,15,25%
0900,DOUGLAS COUNTY RE 1,7718,SEDALIA ELEMENTARY SCHOOL,4TH,0,0,4,8,33,45,12,27%
0900,DOUGLAS COUNTY RE 1,7718,SEDALIA ELEMENTARY SCHOOL,5TH,1,2,3,8,36,50,14,28%
0900,DOUGLAS COUNTY RE 1,7718,SEDALIA ELEMENTARY SCHOOL,6TH,1,1,0,8,35,45,10,22%
0900,DOUGLAS COUNTY RE 1,7718,SEDALIA ELEMENTARY SCHOOL,SCHOOL TOTAL,3,6,12,60,256,337,81,24%
0900,DOUGLAS COUNTY RE 1,8106,SOARING HAWK ELEMENTARY SCHOOL,HALF DAY K,0,2,2,2,82,88,6,7%
0900,DOUGLAS COUNTY RE 1,8106,SOARING HAWK ELEMENTARY SCHOOL,1ST,2,1,0,3,107,113,6,5%
0900,DOUGLAS COUNTY RE 1,8106,SOARING HAWK ELEMENTARY SCHOOL,2ND,1,1,2,5,88,97,9,9%
0900,DOUGLAS COUNTY RE 1,8106,SOARING HAWK ELEMENTARY SCHOOL,3RD,0,4,2,6,81,93,12,13%
0900,DOUGLAS COUNTY RE 1,8106,SOARING HAWK ELEMENTARY SCHOOL,4TH,0,2,1,8,89,100,11,11%
0900,DOUGLAS COUNTY RE 1,8106,SOARING HAWK ELEMENTARY SCHOOL,5TH,0,3,2,6,72,83,11,13%
0900,DOUGLAS COUNTY RE 1,8106,SOARING HAWK ELEMENTARY SCHOOL,6TH,0,2,1,4,70,77,7,9%
0900,DOUGLAS COUNTY RE 1,8106,SOARING HAWK ELEMENTARY SCHOOL,SCHOOL TOTAL,3,15,10,34,589,651,62,10%
0900,DOUGLAS COUNTY RE 1,8126,SOUTH STREET ELEMENTARY SCHOOL,HALF DAY K,0,0,0,7,68,75,7,9%
0900,DOUGLAS COUNTY RE 1,8126,SOUTH STREET ELEMENTARY SCHOOL,KINDERGARTEN,0,0,3,13,15,31,16,52%
0900,DOUGLAS COUNTY RE 1,8126,SOUTH STREET ELEMENTARY SCHOOL,1ST,0,3,0,25,66,94,28,30%
0900,DOUGLAS COUNTY RE 1,8126,SOUTH STREET ELEMENTARY SCHOOL,2ND,0,1,1,11,80,93,13,14%
0900,DOUGLAS COUNTY RE 1,8126,SOUTH STREET ELEMENTARY SCHOOL,3RD,0,0,3,25,74,102,28,27%
0900,DOUGLAS COUNTY RE 1,8126,SOUTH STREET ELEMENTARY SCHOOL,4TH,1,1,5,21,64,92,28,30%
0900,DOUGLAS COUNTY RE 1,8126,SOUTH STREET ELEMENTARY SCHOOL,5TH,1,3,2,11,68,85,17,20%
0900,DOUGLAS COUNTY RE 1,8126,SOUTH STREET ELEMENTARY SCHOOL,6TH,0,1,2,17,43,63,20,32%
0900,DOUGLAS COUNTY RE 1,8126,SOUTH STREET ELEMENTARY SCHOOL,SCHOOL TOTAL,2,9,16,130,478,635,157,25%
0900,DOUGLAS COUNTY RE 1,8382,SUMMIT VIEW ELEMENTARY SCHOOL,HALF DAY K,0,5,0,1,65,71,6,8%
0900,DOUGLAS COUNTY RE 1,8382,SUMMIT VIEW ELEMENTARY SCHOOL,1ST,0,6,0,4,71,81,10,12%
0900,DOUGLAS COUNTY RE 1,8382,SUMMIT VIEW ELEMENTARY SCHOOL,2ND,0,11,2,5,78,96,18,19%
0900,DOUGLAS COUNTY RE 1,8382,SUMMIT VIEW ELEMENTARY SCHOOL,3RD,0,5,0,7,76,88,12,14%
0900,DOUGLAS COUNTY RE 1,8382,SUMMIT VIEW ELEMENTARY SCHOOL,4TH,0,3,1,4,88,96,8,8%
0900,DOUGLAS COUNTY RE 1,8382,SUMMIT VIEW ELEMENTARY SCHOOL,5TH,1,8,2,4,75,90,15,17%
0900,DOUGLAS COUNTY RE 1,8382,SUMMIT VIEW ELEMENTARY SCHOOL,6TH,0,7,2,5,79,93,14,15%
0900,DOUGLAS COUNTY RE 1,8382,SUMMIT VIEW ELEMENTARY SCHOOL,SCHOOL TOTAL,1,45,7,30,532,615,83,13%
0900,DOUGLAS COUNTY RE 1,8847,THUNDERRIDGE HIGH SCHOOL,9TH,1,21,13,43,467,545,78,14%
0900,DOUGLAS COUNTY RE 1,8847,THUNDERRIDGE HIGH SCHOOL,10TH,3,18,9,42,375,447,72,16%
0900,DOUGLAS COUNTY RE 1,8847,THUNDERRIDGE HIGH SCHOOL,11TH,1,12,5,26,348,392,44,11%
0900,DOUGLAS COUNTY RE 1,8847,THUNDERRIDGE HIGH SCHOOL,12TH,3,15,7,32,362,419,57,14%
0900,DOUGLAS COUNTY RE 1,8847,THUNDERRIDGE HIGH SCHOOL,SCHOOL TOTAL,8,66,34,143,1552,1803,251,14%
0900,DOUGLAS COUNTY RE 1,8853,TIMBER TRAIL ELEMENTARY SCHOOL,HALF DAY K,0,6,1,3,91,101,10,10%
0900,DOUGLAS COUNTY RE 1,8853,TIMBER TRAIL ELEMENTARY SCHOOL,1ST,0,4,1,2,80,87,7,8%
0900,DOUGLAS COUNTY RE 1,8853,TIMBER TRAIL ELEMENTARY SCHOOL,2ND,0,6,3,7,99,115,16,14%
0900,DOUGLAS COUNTY RE 1,8853,TIMBER TRAIL ELEMENTARY SCHOOL,3RD,0,6,0,8,72,86,14,16%
0900,DOUGLAS COUNTY RE 1,8853,TIMBER TRAIL ELEMENTARY SCHOOL,4TH,0,2,2,7,94,105,11,10%
0900,DOUGLAS COUNTY RE 1,8853,TIMBER TRAIL ELEMENTARY SCHOOL,5TH,0,6,2,4,89,101,12,12%
0900,DOUGLAS COUNTY RE 1,8853,TIMBER TRAIL ELEMENTARY SCHOOL,SCHOOL TOTAL,0,30,9,31,525,595,70,12%
0900,DOUGLAS COUNTY RE 1,8897,TRAILBLAZER ELEMENTARY SCHOOL,HALF DAY K,1,5,1,11,76,94,18,19%
0900,DOUGLAS COUNTY RE 1,8897,TRAILBLAZER ELEMENTARY SCHOOL,1ST,0,4,1,4,76,85,9,11%
0900,DOUGLAS COUNTY RE 1,8897,TRAILBLAZER ELEMENTARY SCHOOL,2ND,0,4,1,9,70,84,14,17%
0900,DOUGLAS COUNTY RE 1,8897,TRAILBLAZER ELEMENTARY SCHOOL,3RD,0,2,1,6,83,92,9,10%
0900,DOUGLAS COUNTY RE 1,8897,TRAILBLAZER ELEMENTARY SCHOOL,4TH,0,3,1,4,85,93,8,9%
0900,DOUGLAS COUNTY RE 1,8897,TRAILBLAZER ELEMENTARY SCHOOL,5TH,1,3,1,7,82,94,12,13%
0900,DOUGLAS COUNTY RE 1,8897,TRAILBLAZER ELEMENTARY SCHOOL,6TH,0,4,1,7,62,74,12,16%
0900,DOUGLAS COUNTY RE 1,8897,TRAILBLAZER ELEMENTARY SCHOOL,SCHOOL TOTAL,2,25,7,48,534,616,82,13%
0900,DOUGLAS COUNTY RE 1,9592,WILDCAT MOUNTAIN ELEMENTARY SCHOOL,HALF DAY K,0,5,0,5,81,91,10,11%
0900,DOUGLAS COUNTY RE 1,9592,WILDCAT MOUNTAIN ELEMENTARY SCHOOL,1ST,0,10,0,10,77,97,20,21%
0900,DOUGLAS COUNTY RE 1,9592,WILDCAT MOUNTAIN ELEMENTARY SCHOOL,2ND,0,12,1,3,89,105,16,15%
0900,DOUGLAS COUNTY RE 1,9592,WILDCAT MOUNTAIN ELEMENTARY SCHOOL,3RD,2,5,0,4,91,102,11,11%
0900,DOUGLAS COUNTY RE 1,9592,WILDCAT MOUNTAIN ELEMENTARY SCHOOL,4TH,1,9,1,2,84,97,13,13%
0900,DOUGLAS COUNTY RE 1,9592,WILDCAT MOUNTAIN ELEMENTARY SCHOOL,5TH,0,6,0,2,101,109,8,7%
0900,DOUGLAS COUNTY RE 1,9592,WILDCAT MOUNTAIN ELEMENTARY SCHOOL,SCHOOL TOTAL,3,47,2,26,523,601,78,13%
0900,DOUGLAS COUNTY RE 1,,DISTRICT TOTAL,,327,2794,1787,5575,49449,59932,10483,17%
0910,EAGLE COUNTY RE 50,0037,RED HILL ELEMENTARY SCHOOL,HALF DAY K,0,0,0,1,4,5,1,20%
0910,EAGLE COUNTY RE 50,0037,RED HILL ELEMENTARY SCHOOL,KINDERGARTEN,0,0,1,37,20,58,38,66%
0910,EAGLE COUNTY RE 50,0037,RED HILL ELEMENTARY SCHOOL,1ST,0,0,0,50,30,80,50,63%
0910,EAGLE COUNTY RE 50,0037,RED HILL ELEMENTARY SCHOOL,2ND,0,0,0,34,38,72,34,47%
0910,EAGLE COUNTY RE 50,0037,RED HILL ELEMENTARY SCHOOL,3RD,0,0,0,38,26,64,38,59%
0910,EAGLE COUNTY RE 50,0037,RED HILL ELEMENTARY SCHOOL,4TH,0,1,2,45,41,89,48,54%
0910,EAGLE COUNTY RE 50,0037,RED HILL ELEMENTARY SCHOOL,5TH,0,2,2,40,21,65,44,68%
0910,EAGLE COUNTY RE 50,0037,RED HILL ELEMENTARY SCHOOL,SCHOOL TOTAL,0,3,5,245,180,433,253,58%
0910,EAGLE COUNTY RE 50,0038,BRUSH CREEK ELEMENTARY SCHOOL,PK,0,0,0,20,14,34,20,59%
0910,EAGLE COUNTY RE 50,0038,BRUSH CREEK ELEMENTARY SCHOOL,HALF DAY K,0,0,0,0,4,4,0,0%
0910,EAGLE COUNTY RE 50,0038,BRUSH CREEK ELEMENTARY SCHOOL,KINDERGARTEN,1,3,0,11,65,80,15,19%
0910,EAGLE COUNTY RE 50,0038,BRUSH CREEK ELEMENTARY SCHOOL,1ST,0,1,0,14,86,101,15,15%
0910,EAGLE COUNTY RE 50,0038,BRUSH CREEK ELEMENTARY SCHOOL,2ND,0,1,0,14,63,78,15,19%
0910,EAGLE COUNTY RE 50,0038,BRUSH CREEK ELEMENTARY SCHOOL,3RD,1,0,0,11,56,68,12,18%
0910,EAGLE COUNTY RE 50,0038,BRUSH CREEK ELEMENTARY SCHOOL,4TH,0,0,0,16,63,79,16,20%
0910,EAGLE COUNTY RE 50,0038,BRUSH CREEK ELEMENTARY SCHOOL,5TH,0,0,0,9,52,61,9,15%
0910,EAGLE COUNTY RE 50,0038,BRUSH CREEK ELEMENTARY SCHOOL,SCHOOL TOTAL,2,5,0,95,403,505,102,20%
0910,EAGLE COUNTY RE 50,0039,GYPSUM CREEK MIDDLE SCHOOL,6TH,0,2,0,77,40,119,79,66%
0910,EAGLE COUNTY RE 50,0039,GYPSUM CREEK MIDDLE SCHOOL,7TH,2,1,1,63,40,107,67,63%
0910,EAGLE COUNTY RE 50,0039,GYPSUM CREEK MIDDLE SCHOOL,8TH,1,1,0,76,46,124,78,63%
0910,EAGLE COUNTY RE 50,0039,GYPSUM CREEK MIDDLE SCHOOL,SCHOOL TOTAL,3,4,1,216,126,350,224,64%
0910,EAGLE COUNTY RE 50,0205,RED CANYON HIGH SCHOOL,9TH,0,0,0,0,5,5,0,0%
0910,EAGLE COUNTY RE 50,0205,RED CANYON HIGH SCHOOL,10TH,0,0,0,5,3,8,5,63%
0910,EAGLE COUNTY RE 50,0205,RED CANYON HIGH SCHOOL,11TH,0,0,0,12,8,20,12,60%
0910,EAGLE COUNTY RE 50,0205,RED CANYON HIGH SCHOOL,12TH,0,2,0,33,28,63,35,56%
0910,EAGLE COUNTY RE 50,0205,RED CANYON HIGH SCHOOL,SCHOOL TOTAL,0,2,0,50,44,96,52,54%
0910,EAGLE COUNTY RE 50,0471,AVON ELEMENTARY SCHOOL,PK,0,0,0,52,4,56,52,93%
0910,EAGLE COUNTY RE 50,0471,AVON ELEMENTARY SCHOOL,HALF DAY K,0,0,0,1,0,1,1,100%
0910,EAGLE COUNTY RE 50,0471,AVON ELEMENTARY SCHOOL,KINDERGARTEN,0,0,1,50,3,54,51,94%
0910,EAGLE COUNTY RE 50,0471,AVON ELEMENTARY SCHOOL,1ST,0,0,0,51,3,54,51,94%
0910,EAGLE COUNTY RE 50,0471,AVON ELEMENTARY SCHOOL,2ND,0,0,0,50,4,54,50,93%
0910,EAGLE COUNTY RE 50,0471,AVON ELEMENTARY SCHOOL,3RD,0,0,0,32,5,37,32,86%
0910,EAGLE COUNTY RE 50,0471,AVON ELEMENTARY SCHOOL,4TH,0,0,1,40,5,46,41,89%
0910,EAGLE COUNTY RE 50,0471,AVON ELEMENTARY SCHOOL,5TH,0,0,0,31,4,35,31,89%
0910,EAGLE COUNTY RE 50,0471,AVON ELEMENTARY SCHOOL,SCHOOL TOTAL,0,0,2,307,28,337,309,92%
0910,EAGLE COUNTY RE 50,0604,BATTLE MOUNTAIN HIGH SCHOOL,9TH,2,1,1,115,91,210,119,57%
0910,EAGLE COUNTY RE 50,0604,BATTLE MOUNTAIN HIGH SCHOOL,10TH,0,2,1,87,91,181,90,50%
0910,EAGLE COUNTY RE 50,0604,BATTLE MOUNTAIN HIGH SCHOOL,11TH,0,2,0,99,73,174,101,58%
0910,EAGLE COUNTY RE 50,0604,BATTLE MOUNTAIN HIGH SCHOOL,12TH,0,1,0,73,97,171,74,43%
0910,EAGLE COUNTY RE 50,0604,BATTLE MOUNTAIN HIGH SCHOOL,SCHOOL TOTAL,2,6,2,374,352,736,384,52%
0910,EAGLE COUNTY RE 50,0793,BERRY CREEK MIDDLE SCHOOL,6TH,0,0,0,97,16,113,97,86%
0910,EAGLE COUNTY RE 50,0793,BERRY CREEK MIDDLE SCHOOL,7TH,0,1,0,87,17,105,88,84%
0910,EAGLE COUNTY RE 50,0793,BERRY CREEK MIDDLE SCHOOL,8TH,0,1,0,80,23,104,81,78%
0910,EAGLE COUNTY RE 50,0793,BERRY CREEK MIDDLE SCHOOL,SCHOOL TOTAL,0,2,0,264,56,322,266,83%
0910,EAGLE COUNTY RE 50,2340,EAGLE COUNTY CHARTER ACADEMY,KINDERGARTEN,0,2,0,1,29,32,3,9%
0910,EAGLE COUNTY RE 50,2340,EAGLE COUNTY CHARTER ACADEMY,1ST,0,2,0,1,29,32,3,9%
0910,EAGLE COUNTY RE 50,2340,EAGLE COUNTY CHARTER ACADEMY,2ND,0,0,0,0,32,32,0,0%
0910,EAGLE COUNTY RE 50,2340,EAGLE COUNTY CHARTER ACADEMY,3RD,0,0,0,4,30,34,4,12%
0910,EAGLE COUNTY RE 50,2340,EAGLE COUNTY CHARTER ACADEMY,4TH,1,0,0,1,30,32,2,6%
0910,EAGLE COUNTY RE 50,2340,EAGLE COUNTY CHARTER ACADEMY,5TH,0,2,0,2,30,34,4,12%
0910,EAGLE COUNTY RE 50,2340,EAGLE COUNTY CHARTER ACADEMY,6TH,0,3,0,0,30,33,3,9%
0910,EAGLE COUNTY RE 50,2340,EAGLE COUNTY CHARTER ACADEMY,7TH,0,1,0,2,29,32,3,9%
0910,EAGLE COUNTY RE 50,2340,EAGLE COUNTY CHARTER ACADEMY,8TH,0,1,0,1,30,32,2,6%
0910,EAGLE COUNTY RE 50,2340,EAGLE COUNTY CHARTER ACADEMY,SCHOOL TOTAL,1,11,0,12,269,293,24,8%
0910,EAGLE COUNTY RE 50,2346,EAGLE VALLEY ELEMENTARY SCHOOL,KINDERGARTEN,0,3,0,24,22,49,27,55%
0910,EAGLE COUNTY RE 50,2346,EAGLE VALLEY ELEMENTARY SCHOOL,1ST,0,3,0,35,16,54,38,70%
0910,EAGLE COUNTY RE 50,2346,EAGLE VALLEY ELEMENTARY SCHOOL,2ND,1,0,0,26,24,51,27,53%
0910,EAGLE COUNTY RE 50,2346,EAGLE VALLEY ELEMENTARY SCHOOL,3RD,0,3,0,36,21,60,39,65%
0910,EAGLE COUNTY RE 50,2346,EAGLE VALLEY ELEMENTARY SCHOOL,4TH,1,2,0,18,21,42,21,50%
0910,EAGLE COUNTY RE 50,2346,EAGLE VALLEY ELEMENTARY SCHOOL,5TH,0,1,1,14,26,42,16,38%
0910,EAGLE COUNTY RE 50,2346,EAGLE VALLEY ELEMENTARY SCHOOL,SCHOOL TOTAL,2,12,1,153,130,298,168,56%
0910,EAGLE COUNTY RE 50,2350,EAGLE VALLEY HIGH SCHOOL,9TH,1,0,1,98,88,188,100,53%
0910,EAGLE COUNTY RE 50,2350,EAGLE VALLEY HIGH SCHOOL,10TH,0,2,2,75,115,194,79,41%
0910,EAGLE COUNTY RE 50,2350,EAGLE VALLEY HIGH SCHOOL,11TH,0,2,0,83,90,175,85,49%
0910,EAGLE COUNTY RE 50,2350,EAGLE VALLEY HIGH SCHOOL,12TH,2,1,0,75,103,181,78,43%
0910,EAGLE COUNTY RE 50,2350,EAGLE VALLEY HIGH SCHOOL,SCHOOL TOTAL,3,5,3,331,396,738,342,46%
0910,EAGLE COUNTY RE 50,2355,EAGLE VALLEY MIDDLE SCHOOL,6TH,0,1,0,32,58,91,33,36%
0910,EAGLE COUNTY RE 50,2355,EAGLE VALLEY MIDDLE SCHOOL,7TH,0,1,1,25,73,100,27,27%
0910,EAGLE COUNTY RE 50,2355,EAGLE VALLEY MIDDLE SCHOOL,8TH,1,1,0,27,59,88,29,33%
0910,EAGLE COUNTY RE 50,2355,EAGLE VALLEY MIDDLE SCHOOL,SCHOOL TOTAL,1,3,1,84,190,279,89,32%
0910,EAGLE COUNTY RE 50,2530,EDWARDS ELEMENTARY SCHOOL,KINDERGARTEN,0,0,0,27,17,44,27,61%
0910,EAGLE COUNTY RE 50,2530,EDWARDS ELEMENTARY SCHOOL,1ST,0,0,0,40,38,78,40,51%
0910,EAGLE COUNTY RE 50,2530,EDWARDS ELEMENTARY SCHOOL,2ND,0,0,0,39,35,74,39,53%
0910,EAGLE COUNTY RE 50,2530,EDWARDS ELEMENTARY SCHOOL,3RD,0,0,0,35,27,62,35,56%
0910,EAGLE COUNTY RE 50,2530,EDWARDS ELEMENTARY SCHOOL,4TH,0,0,0,45,33,78,45,58%
0910,EAGLE COUNTY RE 50,2530,EDWARDS ELEMENTARY SCHOOL,5TH,0,0,0,44,15,59,44,75%
0910,EAGLE COUNTY RE 50,2530,EDWARDS ELEMENTARY SCHOOL,SCHOOL TOTAL,0,0,0,230,165,395,230,58%
0910,EAGLE COUNTY RE 50,3710,GYPSUM ELEMENTARY SCHOOL,PK,2,0,0,24,4,30,26,87%
0910,EAGLE COUNTY RE 50,3710,GYPSUM ELEMENTARY SCHOOL,HALF DAY K,0,0,0,1,0,1,1,100%
0910,EAGLE COUNTY RE 50,3710,GYPSUM ELEMENTARY SCHOOL,KINDERGARTEN,0,0,1,45,23,69,46,67%
0910,EAGLE COUNTY RE 50,3710,GYPSUM ELEMENTARY SCHOOL,1ST,2,0,0,41,9,52,43,83%
0910,EAGLE COUNTY RE 50,3710,GYPSUM ELEMENTARY SCHOOL,2ND,0,0,0,37,19,56,37,66%
0910,EAGLE COUNTY RE 50,3710,GYPSUM ELEMENTARY SCHOOL,3RD,1,0,0,44,11,56,45,80%
0910,EAGLE COUNTY RE 50,3710,GYPSUM ELEMENTARY SCHOOL,4TH,0,0,0,37,12,49,37,76%
0910,EAGLE COUNTY RE 50,3710,GYPSUM ELEMENTARY SCHOOL,5TH,1,0,0,31,16,48,32,67%
0910,EAGLE COUNTY RE 50,3710,GYPSUM ELEMENTARY SCHOOL,SCHOOL TOTAL,6,0,1,260,94,361,267,74%
0910,EAGLE COUNTY RE 50,4838,JUNE CREEK ELEMENTARY SCHOOL,PK,0,0,0,20,10,30,20,67%
0910,EAGLE COUNTY RE 50,4838,JUNE CREEK ELEMENTARY SCHOOL,HALF DAY K,0,0,0,6,2,8,6,75%
0910,EAGLE COUNTY RE 50,4838,JUNE CREEK ELEMENTARY SCHOOL,KINDERGARTEN,0,0,0,40,14,54,40,74%
0910,EAGLE COUNTY RE 50,4838,JUNE CREEK ELEMENTARY SCHOOL,1ST,0,0,0,30,21,51,30,59%
0910,EAGLE COUNTY RE 50,4838,JUNE CREEK ELEMENTARY SCHOOL,2ND,0,0,0,39,7,46,39,85%
0910,EAGLE COUNTY RE 50,4838,JUNE CREEK ELEMENTARY SCHOOL,3RD,0,0,0,17,8,25,17,68%
0910,EAGLE COUNTY RE 50,4838,JUNE CREEK ELEMENTARY SCHOOL,4TH,0,1,0,28,7,36,29,81%
0910,EAGLE COUNTY RE 50,4838,JUNE CREEK ELEMENTARY SCHOOL,5TH,0,2,0,17,3,22,19,86%
0910,EAGLE COUNTY RE 50,4838,JUNE CREEK ELEMENTARY SCHOOL,SCHOOL TOTAL,0,3,0,197,72,272,200,74%
0910,EAGLE COUNTY RE 50,5742,MEADOW MOUNTAIN ELEMENTARY SCHOOL,HALF DAY K,0,0,0,1,0,1,1,100%
0910,EAGLE COUNTY RE 50,5742,MEADOW MOUNTAIN ELEMENTARY SCHOOL,KINDERGARTEN,0,1,0,26,9,36,27,75%
0910,EAGLE COUNTY RE 50,5742,MEADOW MOUNTAIN ELEMENTARY SCHOOL,1ST,0,1,1,37,11,50,39,78%
0910,EAGLE COUNTY RE 50,5742,MEADOW MOUNTAIN ELEMENTARY SCHOOL,2ND,0,0,1,19,8,28,20,71%
0910,EAGLE COUNTY RE 50,5742,MEADOW MOUNTAIN ELEMENTARY SCHOOL,3RD,0,0,0,28,4,32,28,88%
0910,EAGLE COUNTY RE 50,5742,MEADOW MOUNTAIN ELEMENTARY SCHOOL,4TH,0,0,0,18,11,29,18,62%
0910,EAGLE COUNTY RE 50,5742,MEADOW MOUNTAIN ELEMENTARY SCHOOL,5TH,0,1,0,19,5,25,20,80%
0910,EAGLE COUNTY RE 50,5742,MEADOW MOUNTAIN ELEMENTARY SCHOOL,SCHOOL TOTAL,0,3,2,148,48,201,153,76%
0910,EAGLE COUNTY RE 50,5930,MINTURN MIDDLE SCHOOL,6TH,0,3,3,28,34,68,34,50%
0910,EAGLE COUNTY RE 50,5930,MINTURN MIDDLE SCHOOL,7TH,1,1,0,17,26,45,19,42%
0910,EAGLE COUNTY RE 50,5930,MINTURN MIDDLE SCHOOL,8TH,1,0,3,23,41,68,27,40%
0910,EAGLE COUNTY RE 50,5930,MINTURN MIDDLE SCHOOL,SCHOOL TOTAL,2,4,6,68,101,181,80,44%
0910,EAGLE COUNTY RE 50,6238,NEW AMERICA CHARTER SCHOOL,9TH,0,1,0,38,0,39,39,100%
0910,EAGLE COUNTY RE 50,6238,NEW AMERICA CHARTER SCHOOL,10TH,0,0,1,13,0,14,14,100%
0910,EAGLE COUNTY RE 50,6238,NEW AMERICA CHARTER SCHOOL,11TH,0,0,0,16,0,16,16,100%
0910,EAGLE COUNTY RE 50,6238,NEW AMERICA CHARTER SCHOOL,12TH,0,0,0,24,0,24,24,100%
0910,EAGLE COUNTY RE 50,6238,NEW AMERICA CHARTER SCHOOL,SCHOOL TOTAL,0,1,1,91,0,93,93,100%
0910,EAGLE COUNTY RE 50,7285,RED TABLE EARLY LEARNING CENTER,PK,0,1,0,30,4,35,31,89%
0910,EAGLE COUNTY RE 50,7285,RED TABLE EARLY LEARNING CENTER,SCHOOL TOTAL,0,1,0,30,4,35,31,89%
0910,EAGLE COUNTY RE 50,7296,RED SANDSTONE ELEMENTARY SCHOOL,PK,0,0,1,16,11,28,17,61%
0910,EAGLE COUNTY RE 50,7296,RED SANDSTONE ELEMENTARY SCHOOL,HALF DAY K,0,0,0,2,1,3,2,67%
0910,EAGLE COUNTY RE 50,7296,RED SANDSTONE ELEMENTARY SCHOOL,KINDERGARTEN,0,1,1,12,26,40,14,35%
0910,EAGLE COUNTY RE 50,7296,RED SANDSTONE ELEMENTARY SCHOOL,1ST,0,3,0,9,32,44,12,27%
0910,EAGLE COUNTY RE 50,7296,RED SANDSTONE ELEMENTARY SCHOOL,2ND,0,0,0,13,24,37,13,35%
0910,EAGLE COUNTY RE 50,7296,RED SANDSTONE ELEMENTARY SCHOOL,3RD,0,1,0,13,29,43,14,33%
0910,EAGLE COUNTY RE 50,7296,RED SANDSTONE ELEMENTARY SCHOOL,4TH,1,1,1,11,21,35,14,40%
0910,EAGLE COUNTY RE 50,7296,RED SANDSTONE ELEMENTARY SCHOOL,5TH,1,1,0,12,24,38,14,37%
0910,EAGLE COUNTY RE 50,7296,RED SANDSTONE ELEMENTARY SCHOOL,SCHOOL TOTAL,2,7,3,88,168,268,100,37%
0910,EAGLE COUNTY RE 50,9061,VAIL SKI AND SNOWBOARD ACADEMY (USSA),6TH,0,0,0,0,7,7,0,0%
0910,EAGLE COUNTY RE 50,9061,VAIL SKI AND SNOWBOARD ACADEMY (USSA),7TH,0,0,0,0,6,6,0,0%
0910,EAGLE COUNTY RE 50,9061,VAIL SKI AND SNOWBOARD ACADEMY (USSA),8TH,1,0,0,0,5,6,1,17%
0910,EAGLE COUNTY RE 50,9061,VAIL SKI AND SNOWBOARD ACADEMY (USSA),9TH,0,0,0,0,4,4,0,0%
0910,EAGLE COUNTY RE 50,9061,VAIL SKI AND SNOWBOARD ACADEMY (USSA),10TH,0,1,0,0,5,6,1,17%
0910,EAGLE COUNTY RE 50,9061,VAIL SKI AND SNOWBOARD ACADEMY (USSA),11TH,0,0,0,1,15,16,1,6%
0910,EAGLE COUNTY RE 50,9061,VAIL SKI AND SNOWBOARD ACADEMY (USSA),12TH,0,0,0,1,5,6,1,17%
0910,EAGLE COUNTY RE 50,9061,VAIL SKI AND SNOWBOARD ACADEMY (USSA),SCHOOL TOTAL,1,1,0,2,47,51,4,8%
0910,EAGLE COUNTY RE 50,,DISTRICT TOTAL,,25,73,28,3245,2873,6244,3371,54%
0920,ELIZABETH C-1,2572,LEGACY ACADEMY,HALF DAY K,0,0,1,1,32,34,2,6%
0920,ELIZABETH C-1,2572,LEGACY ACADEMY,1ST,0,1,0,3,30,34,4,12%
0920,ELIZABETH C-1,2572,LEGACY ACADEMY,2ND,0,0,0,3,38,41,3,7%
0920,ELIZABETH C-1,2572,LEGACY ACADEMY,3RD,0,0,0,3,38,41,3,7%
0920,ELIZABETH C-1,2572,LEGACY ACADEMY,4TH,0,0,0,1,28,29,1,3%
0920,ELIZABETH C-1,2572,LEGACY ACADEMY,5TH,0,1,0,3,28,32,4,13%
0920,ELIZABETH C-1,2572,LEGACY ACADEMY,6TH,0,0,0,0,39,39,0,0%
0920,ELIZABETH C-1,2572,LEGACY ACADEMY,7TH,0,1,1,1,22,25,3,12%
0920,ELIZABETH C-1,2572,LEGACY ACADEMY,8TH,0,0,0,2,27,29,2,7%
0920,ELIZABETH C-1,2572,LEGACY ACADEMY,SCHOOL TOTAL,0,3,2,17,282,304,22,7%
0920,ELIZABETH C-1,2604,ELIZABETH MIDDLE SCHOOL,6TH,1,0,5,15,148,169,21,12%
0920,ELIZABETH C-1,2604,ELIZABETH MIDDLE SCHOOL,7TH,2,5,2,11,129,149,20,13%
0920,ELIZABETH C-1,2604,ELIZABETH MIDDLE SCHOOL,8TH,4,1,3,20,170,198,28,14%
0920,ELIZABETH C-1,2604,ELIZABETH MIDDLE SCHOOL,SCHOOL TOTAL,7,6,10,46,447,516,69,13%
0920,ELIZABETH C-1,2608,ELIZABETH HIGH SCHOOL,9TH,4,3,3,15,170,195,25,13%
0920,ELIZABETH C-1,2608,ELIZABETH HIGH SCHOOL,10TH,1,0,1,16,171,189,18,10%
0920,ELIZABETH C-1,2608,ELIZABETH HIGH SCHOOL,11TH,4,2,2,17,191,216,25,12%
0920,ELIZABETH C-1,2608,ELIZABETH HIGH SCHOOL,12TH,0,5,2,4,175,186,11,6%
0920,ELIZABETH C-1,2608,ELIZABETH HIGH SCHOOL,SCHOOL TOTAL,9,10,8,52,707,786,79,10%
0920,ELIZABETH C-1,3236,FRONTIER HIGH SCHOOL,9TH,0,0,0,0,8,8,0,0%
0920,ELIZABETH C-1,3236,FRONTIER HIGH SCHOOL,10TH,0,0,0,0,7,7,0,0%
0920,ELIZABETH C-1,3236,FRONTIER HIGH SCHOOL,11TH,0,0,0,1,19,20,1,5%
0920,ELIZABETH C-1,3236,FRONTIER HIGH SCHOOL,12TH,0,1,0,3,20,24,4,17%
0920,ELIZABETH C-1,3236,FRONTIER HIGH SCHOOL,SCHOOL TOTAL,0,1,0,4,54,59,5,8%
0920,ELIZABETH C-1,7300,ELIZABETH RUNNING CREEK PRESCHOOL,PK,0,0,1,9,72,82,10,12%
0920,ELIZABETH C-1,7300,ELIZABETH RUNNING CREEK PRESCHOOL,SCHOOL TOTAL,0,0,1,9,72,82,10,12%
0920,ELIZABETH C-1,7517,RUNNING CREEK ELEMENTARY SCHOOL,HALF DAY K,0,0,0,5,58,63,5,8%
0920,ELIZABETH C-1,7517,RUNNING CREEK ELEMENTARY SCHOOL,1ST,1,1,0,2,66,70,4,6%
0920,ELIZABETH C-1,7517,RUNNING CREEK ELEMENTARY SCHOOL,2ND,1,2,1,5,60,69,9,13%
0920,ELIZABETH C-1,7517,RUNNING CREEK ELEMENTARY SCHOOL,3RD,0,1,0,6,76,83,7,8%
0920,ELIZABETH C-1,7517,RUNNING CREEK ELEMENTARY SCHOOL,4TH,1,1,1,3,69,75,6,8%
0920,ELIZABETH C-1,7517,RUNNING CREEK ELEMENTARY SCHOOL,5TH,1,4,0,9,85,99,14,14%
0920,ELIZABETH C-1,7517,RUNNING CREEK ELEMENTARY SCHOOL,SCHOOL TOTAL,4,9,2,30,414,459,45,10%
0920,ELIZABETH C-1,7924,SINGING HILLS PRESCHOOL,PK,0,4,1,11,52,68,16,24%
0920,ELIZABETH C-1,7924,SINGING HILLS PRESCHOOL,SCHOOL TOTAL,0,4,1,11,52,68,16,24%
0920,ELIZABETH C-1,7925,SINGING HILLS ELEMENTARY SCHOOL,HALF DAY K,1,1,1,8,67,78,11,14%
0920,ELIZABETH C-1,7925,SINGING HILLS ELEMENTARY SCHOOL,KINDERGARTEN,0,0,0,1,0,1,1,100%
0920,ELIZABETH C-1,7925,SINGING HILLS ELEMENTARY SCHOOL,1ST,0,0,0,6,52,58,6,10%
0920,ELIZABETH C-1,7925,SINGING HILLS ELEMENTARY SCHOOL,2ND,0,2,1,6,72,81,9,11%
0920,ELIZABETH C-1,7925,SINGING HILLS ELEMENTARY SCHOOL,3RD,0,0,2,3,84,89,5,6%
0920,ELIZABETH C-1,7925,SINGING HILLS ELEMENTARY SCHOOL,4TH,0,3,1,5,58,67,9,13%
0920,ELIZABETH C-1,7925,SINGING HILLS ELEMENTARY SCHOOL,5TH,0,4,4,6,75,89,14,16%
0920,ELIZABETH C-1,7925,SINGING HILLS ELEMENTARY SCHOOL,SCHOOL TOTAL,1,10,9,35,408,463,55,12%
0920,ELIZABETH C-1,,DISTRICT TOTAL,,21,43,33,204,2436,2737,301,11%
0930,KIOWA C-2,4724,KIOWA ELEMENTARY SCHOOL,PK,0,0,0,1,33,34,1,3%
0930,KIOWA C-2,4724,KIOWA ELEMENTARY SCHOOL,KINDERGARTEN,0,0,1,3,25,29,4,14%
0930,KIOWA C-2,4724,KIOWA ELEMENTARY SCHOOL,1ST,0,0,0,3,15,18,3,17%
0930,KIOWA C-2,4724,KIOWA ELEMENTARY SCHOOL,2ND,0,0,1,3,17,21,4,19%
0930,KIOWA C-2,4724,KIOWA ELEMENTARY SCHOOL,3RD,0,0,0,3,26,29,3,10%
0930,KIOWA C-2,4724,KIOWA ELEMENTARY SCHOOL,4TH,0,1,0,0,24,25,1,4%
0930,KIOWA C-2,4724,KIOWA ELEMENTARY SCHOOL,5TH,0,1,0,0,34,35,1,3%
0930,KIOWA C-2,4724,KIOWA ELEMENTARY SCHOOL,SCHOOL TOTAL,0,2,2,13,174,191,17,9%
0930,KIOWA C-2,4726,KIOWA MIDDLE SCHOOL,6TH,1,0,0,4,20,25,5,20%
0930,KIOWA C-2,4726,KIOWA MIDDLE SCHOOL,7TH,0,2,1,3,22,28,6,21%
0930,KIOWA C-2,4726,KIOWA MIDDLE SCHOOL,8TH,0,0,0,0,36,36,0,0%
0930,KIOWA C-2,4726,KIOWA MIDDLE SCHOOL,SCHOOL TOTAL,1,2,1,7,78,89,11,12%
0930,KIOWA C-2,4728,KIOWA HIGH SCHOOL,9TH,0,1,1,2,28,32,4,13%
0930,KIOWA C-2,4728,KIOWA HIGH SCHOOL,10TH,0,1,0,2,25,28,3,11%
0930,KIOWA C-2,4728,KIOWA HIGH SCHOOL,11TH,0,0,0,1,13,14,1,7%
0930,KIOWA C-2,4728,KIOWA HIGH SCHOOL,12TH,0,0,2,3,24,29,5,17%
0930,KIOWA C-2,4728,KIOWA HIGH SCHOOL,SCHOOL TOTAL,0,2,3,8,90,103,13,13%
0930,KIOWA C-2,,DISTRICT TOTAL,,1,6,6,28,342,383,41,11%
0940,BIG SANDY 100J,7914,SIMLA ELEMENTARY SCHOOL,PK,0,1,0,5,21,27,6,22%
0940,BIG SANDY 100J,7914,SIMLA ELEMENTARY SCHOOL,HALF DAY K,0,0,0,2,18,20,2,10%
0940,BIG SANDY 100J,7914,SIMLA ELEMENTARY SCHOOL,1ST,0,0,1,3,14,18,4,22%
0940,BIG SANDY 100J,7914,SIMLA ELEMENTARY SCHOOL,2ND,0,1,0,0,17,18,1,6%
0940,BIG SANDY 100J,7914,SIMLA ELEMENTARY SCHOOL,3RD,0,0,0,1,20,21,1,5%
0940,BIG SANDY 100J,7914,SIMLA ELEMENTARY SCHOOL,4TH,0,0,0,2,22,24,2,8%
0940,BIG SANDY 100J,7914,SIMLA ELEMENTARY SCHOOL,5TH,0,1,0,1,24,26,2,8%
0940,BIG SANDY 100J,7914,SIMLA ELEMENTARY SCHOOL,SCHOOL TOTAL,0,3,1,14,136,154,18,12%
0940,BIG SANDY 100J,7918,SIMLA JUNIOR HIGH SCHOOL,6TH,0,0,0,2,22,24,2,8%
0940,BIG SANDY 100J,7918,SIMLA JUNIOR HIGH SCHOOL,7TH,0,0,1,2,18,21,3,14%
0940,BIG SANDY 100J,7918,SIMLA JUNIOR HIGH SCHOOL,8TH,0,0,0,2,24,26,2,8%
0940,BIG SANDY 100J,7918,SIMLA JUNIOR HIGH SCHOOL,SCHOOL TOTAL,0,0,1,6,64,71,7,10%
0940,BIG SANDY 100J,7922,SIMLA HIGH SCHOOL,9TH,0,0,0,1,22,23,1,4%
0940,BIG SANDY 100J,7922,SIMLA HIGH SCHOOL,10TH,0,0,1,1,21,23,2,9%
0940,BIG SANDY 100J,7922,SIMLA HIGH SCHOOL,11TH,0,0,0,1,23,24,1,4%
0940,BIG SANDY 100J,7922,SIMLA HIGH SCHOOL,12TH,0,0,0,0,24,24,0,0%
0940,BIG SANDY 100J,7922,SIMLA HIGH SCHOOL,SCHOOL TOTAL,0,0,1,3,90,94,4,4%
0940,BIG SANDY 100J,,DISTRICT TOTAL,,0,3,3,23,290,319,29,9%
0950,ELBERT 200,2570,ELBERT ELEMENTARY SCHOOL,PK,0,0,0,1,15,16,1,6%
0950,ELBERT 200,2570,ELBERT ELEMENTARY SCHOOL,KINDERGARTEN,0,0,0,1,9,10,1,10%
0950,ELBERT 200,2570,ELBERT ELEMENTARY SCHOOL,1ST,0,0,0,0,18,18,0,0%
0950,ELBERT 200,2570,ELBERT ELEMENTARY SCHOOL,2ND,0,1,0,0,8,9,1,11%
0950,ELBERT 200,2570,ELBERT ELEMENTARY SCHOOL,3RD,0,0,0,0,17,17,0,0%
0950,ELBERT 200,2570,ELBERT ELEMENTARY SCHOOL,4TH,0,0,0,1,15,16,1,6%
0950,ELBERT 200,2570,ELBERT ELEMENTARY SCHOOL,5TH,0,1,0,0,15,16,1,6%
0950,ELBERT 200,2570,ELBERT ELEMENTARY SCHOOL,6TH,0,0,0,0,19,19,0,0%
0950,ELBERT 200,2570,ELBERT ELEMENTARY SCHOOL,SCHOOL TOTAL,0,2,0,3,116,121,5,4%
0950,ELBERT 200,2574,ELBERT JUNIOR-SENIOR HIGH SCHOOL,7TH,0,1,0,0,23,24,1,4%
0950,ELBERT 200,2574,ELBERT JUNIOR-SENIOR HIGH SCHOOL,8TH,0,0,0,0,18,18,0,0%
0950,ELBERT 200,2574,ELBERT JUNIOR-SENIOR HIGH SCHOOL,9TH,0,1,0,0,25,26,1,4%
0950,ELBERT 200,2574,ELBERT JUNIOR-SENIOR HIGH SCHOOL,10TH,1,0,0,0,11,12,1,8%
0950,ELBERT 200,2574,ELBERT JUNIOR-SENIOR HIGH SCHOOL,11TH,0,1,0,0,15,16,1,6%
0950,ELBERT 200,2574,ELBERT JUNIOR-SENIOR HIGH SCHOOL,12TH,0,0,0,1,21,22,1,5%
0950,ELBERT 200,2574,ELBERT JUNIOR-SENIOR HIGH SCHOOL,SCHOOL TOTAL,1,3,0,1,113,118,5,4%
0950,ELBERT 200,,DISTRICT TOTAL,,1,5,0,4,229,239,10,4%
0960,AGATE 300,0044,AGATE ELEMENTARY SCHOOL,KINDERGARTEN,0,0,0,0,3,3,0,0%
0960,AGATE 300,0044,AGATE ELEMENTARY SCHOOL,1ST,0,0,0,0,2,2,0,0%
0960,AGATE 300,0044,AGATE ELEMENTARY SCHOOL,3RD,0,0,0,1,1,2,1,50%
0960,AGATE 300,0044,AGATE ELEMENTARY SCHOOL,4TH,0,0,0,0,4,4,0,0%
0960,AGATE 300,0044,AGATE ELEMENTARY SCHOOL,5TH,0,0,0,1,2,3,1,33%
0960,AGATE 300,0044,AGATE ELEMENTARY SCHOOL,SCHOOL TOTAL,0,0,0,2,12,14,2,14%
0960,AGATE 300,0048,AGATE JUNIOR-SENIOR HIGH SCHOOL,6TH,0,0,0,0,2,2,0,0%
0960,AGATE 300,0048,AGATE JUNIOR-SENIOR HIGH SCHOOL,7TH,0,0,0,2,3,5,2,40%
0960,AGATE 300,0048,AGATE JUNIOR-SENIOR HIGH SCHOOL,8TH,0,0,0,0,4,4,0,0%
0960,AGATE 300,0048,AGATE JUNIOR-SENIOR HIGH SCHOOL,9TH,0,0,0,1,2,3,1,33%
0960,AGATE 300,0048,AGATE JUNIOR-SENIOR HIGH SCHOOL,10TH,0,0,0,0,6,6,0,0%
0960,AGATE 300,0048,AGATE JUNIOR-SENIOR HIGH SCHOOL,11TH,0,0,0,0,7,7,0,0%
0960,AGATE 300,0048,AGATE JUNIOR-SENIOR HIGH SCHOOL,12TH,0,0,0,1,3,4,1,25%
0960,AGATE 300,0048,AGATE JUNIOR-SENIOR HIGH SCHOOL,SCHOOL TOTAL,0,0,0,4,27,31,4,13%
0960,AGATE 300,,DISTRICT TOTAL,,0,0,0,6,39,45,6,13%
0970,CALHAN RJ-1,0035,FRONTIER CHARTER ACADEMY,KINDERGARTEN,0,0,0,1,13,14,1,7%
0970,CALHAN RJ-1,0035,FRONTIER CHARTER ACADEMY,1ST,0,0,0,2,7,9,2,22%
0970,CALHAN RJ-1,0035,FRONTIER CHARTER ACADEMY,2ND,0,0,2,1,12,15,3,20%
0970,CALHAN RJ-1,0035,FRONTIER CHARTER ACADEMY,3RD,0,0,0,1,10,11,1,9%
0970,CALHAN RJ-1,0035,FRONTIER CHARTER ACADEMY,4TH,0,0,1,2,10,13,3,23%
0970,CALHAN RJ-1,0035,FRONTIER CHARTER ACADEMY,5TH,0,0,0,0,8,8,0,0%
0970,CALHAN RJ-1,0035,FRONTIER CHARTER ACADEMY,6TH,0,0,0,0,6,6,0,0%
0970,CALHAN RJ-1,0035,FRONTIER CHARTER ACADEMY,7TH,0,0,0,1,3,4,1,25%
0970,CALHAN RJ-1,0035,FRONTIER CHARTER ACADEMY,8TH,0,0,0,0,2,2,0,0%
0970,CALHAN RJ-1,0035,FRONTIER CHARTER ACADEMY,SCHOOL TOTAL,0,0,3,8,71,82,11,13%
0970,CALHAN RJ-1,1210,CALHAN ELEMENTARY SCHOOL,PK,0,1,0,2,21,24,3,13%
0970,CALHAN RJ-1,1210,CALHAN ELEMENTARY SCHOOL,KINDERGARTEN,0,0,0,1,33,34,1,3%
0970,CALHAN RJ-1,1210,CALHAN ELEMENTARY SCHOOL,1ST,0,1,0,1,34,36,2,6%
0970,CALHAN RJ-1,1210,CALHAN ELEMENTARY SCHOOL,2ND,0,0,0,2,36,38,2,5%
0970,CALHAN RJ-1,1210,CALHAN ELEMENTARY SCHOOL,3RD,0,0,0,0,35,35,0,0%
0970,CALHAN RJ-1,1210,CALHAN ELEMENTARY SCHOOL,4TH,0,0,0,3,38,41,3,7%
0970,CALHAN RJ-1,1210,CALHAN ELEMENTARY SCHOOL,5TH,0,0,0,3,31,34,3,9%
0970,CALHAN RJ-1,1210,CALHAN ELEMENTARY SCHOOL,SCHOOL TOTAL,0,2,0,12,228,242,14,6%
0970,CALHAN RJ-1,1215,CALHAN MIDDLE SCHOOL,6TH,0,0,0,0,40,40,0,0%
0970,CALHAN RJ-1,1215,CALHAN MIDDLE SCHOOL,7TH,0,2,1,1,37,41,4,10%
0970,CALHAN RJ-1,1215,CALHAN MIDDLE SCHOOL,8TH,1,1,1,0,38,41,3,7%
0970,CALHAN RJ-1,1215,CALHAN MIDDLE SCHOOL,SCHOOL TOTAL,1,3,2,1,115,122,7,6%
0970,CALHAN RJ-1,1218,CALHAN HIGH SCHOOL,9TH,1,3,0,2,46,52,6,12%
0970,CALHAN RJ-1,1218,CALHAN HIGH SCHOOL,10TH,0,4,0,1,40,45,5,11%
0970,CALHAN RJ-1,1218,CALHAN HIGH SCHOOL,11TH,1,2,0,3,43,49,6,12%
0970,CALHAN RJ-1,1218,CALHAN HIGH SCHOOL,12TH,0,2,1,1,43,47,4,9%
0970,CALHAN RJ-1,1218,CALHAN HIGH SCHOOL,SCHOOL TOTAL,2,11,1,7,172,193,21,11%
0970,CALHAN RJ-1,,DISTRICT TOTAL,,3,16,6,28,586,639,53,8%
0980,HARRISON 2,0029,ADULT & FAMILY LITERACY,12TH,6,3,16,90,36,151,115,76%
0980,HARRISON 2,0029,ADULT & FAMILY LITERACY,SCHOOL TOTAL,6,3,16,90,36,151,115,76%
0980,HARRISON 2,0469,ATLAS PREPATORY SCHOOL,5TH,3,2,33,16,27,81,54,67%
0980,HARRISON 2,0469,ATLAS PREPATORY SCHOOL,SCHOOL TOTAL,3,2,33,16,27,81,54,67%
0980,HARRISON 2,1000,BRICKER ELEMENTARY SCHOOL,PK,0,1,7,13,11,32,21,66%
0980,HARRISON 2,1000,BRICKER ELEMENTARY SCHOOL,KINDERGARTEN,2,3,6,21,19,51,32,63%
0980,HARRISON 2,1000,BRICKER ELEMENTARY SCHOOL,1ST,2,4,14,26,13,59,46,78%
0980,HARRISON 2,1000,BRICKER ELEMENTARY SCHOOL,2ND,4,3,17,35,16,75,59,79%
0980,HARRISON 2,1000,BRICKER ELEMENTARY SCHOOL,3RD,2,3,13,21,19,58,39,67%
0980,HARRISON 2,1000,BRICKER ELEMENTARY SCHOOL,4TH,2,0,12,33,16,63,47,75%
0980,HARRISON 2,1000,BRICKER ELEMENTARY SCHOOL,5TH,0,1,17,22,16,56,40,71%
0980,HARRISON 2,1000,BRICKER ELEMENTARY SCHOOL,SCHOOL TOTAL,12,15,86,171,110,394,284,72%
0980,HARRISON 2,1306,CARMEL MIDDLE SCHOOL,6TH,1,8,37,76,30,152,122,80%
0980,HARRISON 2,1306,CARMEL MIDDLE SCHOOL,7TH,2,12,37,74,33,158,125,79%
0980,HARRISON 2,1306,CARMEL MIDDLE SCHOOL,8TH,3,2,23,74,32,134,102,76%
0980,HARRISON 2,1306,CARMEL MIDDLE SCHOOL,SCHOOL TOTAL,6,22,97,224,95,444,349,79%
0980,HARRISON 2,1383,CENTENNIAL ELEMENTARY SCHOOL,PK,1,4,12,13,7,37,30,81%
0980,HARRISON 2,1383,CENTENNIAL ELEMENTARY SCHOOL,KINDERGARTEN,3,2,25,38,14,82,68,83%
0980,HARRISON 2,1383,CENTENNIAL ELEMENTARY SCHOOL,1ST,0,4,15,31,18,68,50,74%
0980,HARRISON 2,1383,CENTENNIAL ELEMENTARY SCHOOL,2ND,3,4,16,31,10,64,54,84%
0980,HARRISON 2,1383,CENTENNIAL ELEMENTARY SCHOOL,3RD,2,1,12,25,11,51,40,78%
0980,HARRISON 2,1383,CENTENNIAL ELEMENTARY SCHOOL,4TH,0,1,28,27,9,65,56,86%
0980,HARRISON 2,1383,CENTENNIAL ELEMENTARY SCHOOL,5TH,2,3,15,19,6,45,39,87%
0980,HARRISON 2,1383,CENTENNIAL ELEMENTARY SCHOOL,SCHOOL TOTAL,11,19,123,184,75,412,337,82%
0980,HARRISON 2,1490,CHAMBERLIN ACADEMY,PK,0,0,0,8,8,16,8,50%
0980,HARRISON 2,1490,CHAMBERLIN ACADEMY,KINDERGARTEN,6,1,1,13,13,34,21,62%
0980,HARRISON 2,1490,CHAMBERLIN ACADEMY,1ST,0,0,3,9,6,18,12,67%
0980,HARRISON 2,1490,CHAMBERLIN ACADEMY,2ND,3,0,2,14,8,27,19,70%
0980,HARRISON 2,1490,CHAMBERLIN ACADEMY,3RD,0,0,5,6,5,16,11,69%
0980,HARRISON 2,1490,CHAMBERLIN ACADEMY,4TH,1,0,1,12,7,21,14,67%
0980,HARRISON 2,1490,CHAMBERLIN ACADEMY,5TH,0,0,1,10,8,19,11,58%
0980,HARRISON 2,1490,CHAMBERLIN ACADEMY,SCHOOL TOTAL,10,1,13,72,55,151,96,64%
0980,HARRISON 2,3392,GIBERSON ELEMENTARY SCHOOL,PK,0,0,12,13,15,40,25,63%
0980,HARRISON 2,3392,GIBERSON ELEMENTARY SCHOOL,KINDERGARTEN,0,3,14,15,26,58,32,55%
0980,HARRISON 2,3392,GIBERSON ELEMENTARY SCHOOL,1ST,2,3,14,21,13,53,40,75%
0980,HARRISON 2,3392,GIBERSON ELEMENTARY SCHOOL,2ND,0,2,23,26,21,72,51,71%
0980,HARRISON 2,3392,GIBERSON ELEMENTARY SCHOOL,3RD,4,6,12,17,11,50,39,78%
0980,HARRISON 2,3392,GIBERSON ELEMENTARY SCHOOL,4TH,1,1,15,21,15,53,38,72%
0980,HARRISON 2,3392,GIBERSON ELEMENTARY SCHOOL,5TH,0,2,20,25,16,63,47,75%
0980,HARRISON 2,3392,GIBERSON ELEMENTARY SCHOOL,SCHOOL TOTAL,7,17,110,138,117,389,272,70%
0980,HARRISON 2,3522,FOX MEADOW MIDDLE SCHOOL,6TH,2,5,36,84,67,194,127,65%
0980,HARRISON 2,3522,FOX MEADOW MIDDLE SCHOOL,7TH,2,14,28,70,65,179,114,64%
0980,HARRISON 2,3522,FOX MEADOW MIDDLE SCHOOL,8TH,2,7,21,59,47,136,89,65%
0980,HARRISON 2,3522,FOX MEADOW MIDDLE SCHOOL,SCHOOL TOTAL,6,26,85,213,179,509,330,65%
0980,HARRISON 2,3806,HARRISON HIGH SCHOOL,9TH,9,16,76,118,82,301,219,73%
0980,HARRISON 2,3806,HARRISON HIGH SCHOOL,10TH,7,21,61,116,78,283,205,72%
0980,HARRISON 2,3806,HARRISON HIGH SCHOOL,11TH,5,7,39,104,59,214,155,72%
0980,HARRISON 2,3806,HARRISON HIGH SCHOOL,12TH,8,8,49,84,45,194,149,77%
0980,HARRISON 2,3806,HARRISON HIGH SCHOOL,SCHOOL TOTAL,29,52,225,422,264,992,728,73%
0980,HARRISON 2,4378,JAMES IRWIN CHARTER HIGH SCHOOL,9TH,4,6,23,27,71,131,60,46%
0980,HARRISON 2,4378,JAMES IRWIN CHARTER HIGH SCHOOL,10TH,3,4,8,18,63,96,33,34%
0980,HARRISON 2,4378,JAMES IRWIN CHARTER HIGH SCHOOL,11TH,2,10,9,14,46,81,35,43%
0980,HARRISON 2,4378,JAMES IRWIN CHARTER HIGH SCHOOL,12TH,1,11,7,12,39,70,31,44%
0980,HARRISON 2,4378,JAMES IRWIN CHARTER HIGH SCHOOL,SCHOOL TOTAL,10,31,47,71,219,378,159,42%
0980,HARRISON 2,4379,JAMES IRWIN CHARTER MIDDLE SCHOOL,6TH,3,10,23,38,65,139,74,53%
0980,HARRISON 2,4379,JAMES IRWIN CHARTER MIDDLE SCHOOL,7TH,0,11,17,42,61,131,70,53%
0980,HARRISON 2,4379,JAMES IRWIN CHARTER MIDDLE SCHOOL,8TH,0,7,16,32,67,122,55,45%
0980,HARRISON 2,4379,JAMES IRWIN CHARTER MIDDLE SCHOOL,SCHOOL TOTAL,3,28,56,112,193,392,199,51%
0980,HARRISON 2,4380,JAMES IRWIN CHARTER ELEMENTARY SCHOOL,HALF DAY K,1,3,5,14,29,52,23,44%
0980,HARRISON 2,4380,JAMES IRWIN CHARTER ELEMENTARY SCHOOL,KINDERGARTEN,1,1,16,12,20,50,30,60%
0980,HARRISON 2,4380,JAMES IRWIN CHARTER ELEMENTARY SCHOOL,1ST,0,4,11,21,46,82,36,44%
0980,HARRISON 2,4380,JAMES IRWIN CHARTER ELEMENTARY SCHOOL,2ND,1,7,12,20,41,81,40,49%
0980,HARRISON 2,4380,JAMES IRWIN CHARTER ELEMENTARY SCHOOL,3RD,0,8,11,22,41,82,41,50%
0980,HARRISON 2,4380,JAMES IRWIN CHARTER ELEMENTARY SCHOOL,4TH,0,3,12,26,35,76,41,54%
0980,HARRISON 2,4380,JAMES IRWIN CHARTER ELEMENTARY SCHOOL,5TH,1,3,7,12,32,55,23,42%
0980,HARRISON 2,4380,JAMES IRWIN CHARTER ELEMENTARY SCHOOL,SCHOOL TOTAL,4,29,74,127,244,478,234,49%
0980,HARRISON 2,6018,MONTEREY ELEMENTARY SCHOOL,PK,0,1,2,13,7,23,16,70%
0980,HARRISON 2,6018,MONTEREY ELEMENTARY SCHOOL,KINDERGARTEN,4,5,6,46,19,80,61,76%
0980,HARRISON 2,6018,MONTEREY ELEMENTARY SCHOOL,1ST,0,4,11,47,24,86,62,72%
0980,HARRISON 2,6018,MONTEREY ELEMENTARY SCHOOL,2ND,1,2,12,49,18,82,64,78%
0980,HARRISON 2,6018,MONTEREY ELEMENTARY SCHOOL,3RD,2,2,16,40,18,78,60,77%
0980,HARRISON 2,6018,MONTEREY ELEMENTARY SCHOOL,4TH,1,4,8,26,15,54,39,72%
0980,HARRISON 2,6018,MONTEREY ELEMENTARY SCHOOL,5TH,1,1,11,30,14,57,43,75%
0980,HARRISON 2,6018,MONTEREY ELEMENTARY SCHOOL,SCHOOL TOTAL,9,19,66,251,115,460,345,75%
0980,HARRISON 2,6162,MOUNTAIN VISTA COMMUNITY SCHOOL,KINDERGARTEN,0,1,8,22,16,47,31,66%
0980,HARRISON 2,6162,MOUNTAIN VISTA COMMUNITY SCHOOL,1ST,2,0,5,22,26,55,29,53%
0980,HARRISON 2,6162,MOUNTAIN VISTA COMMUNITY SCHOOL,2ND,1,1,8,29,18,57,39,68%
0980,HARRISON 2,6162,MOUNTAIN VISTA COMMUNITY SCHOOL,3RD,0,1,13,18,25,57,32,56%
0980,HARRISON 2,6162,MOUNTAIN VISTA COMMUNITY SCHOOL,4TH,1,1,9,39,28,78,50,64%
0980,HARRISON 2,6162,MOUNTAIN VISTA COMMUNITY SCHOOL,5TH,0,1,5,29,18,53,35,66%
0980,HARRISON 2,6162,MOUNTAIN VISTA COMMUNITY SCHOOL,6TH,3,3,13,29,29,77,48,62%
0980,HARRISON 2,6162,MOUNTAIN VISTA COMMUNITY SCHOOL,7TH,2,1,13,29,31,76,45,59%
0980,HARRISON 2,6162,MOUNTAIN VISTA COMMUNITY SCHOOL,8TH,1,1,16,31,30,79,49,62%
0980,HARRISON 2,6162,MOUNTAIN VISTA COMMUNITY SCHOOL,SCHOOL TOTAL,10,10,90,248,221,579,358,62%
0980,HARRISON 2,6244,NEW HORIZONS DAY SCHOOL,6TH,0,0,0,1,0,1,1,100%
0980,HARRISON 2,6244,NEW HORIZONS DAY SCHOOL,7TH,0,0,3,3,0,6,6,100%
0980,HARRISON 2,6244,NEW HORIZONS DAY SCHOOL,8TH,1,0,7,6,2,16,14,88%
0980,HARRISON 2,6244,NEW HORIZONS DAY SCHOOL,9TH,1,0,4,13,4,22,18,82%
0980,HARRISON 2,6244,NEW HORIZONS DAY SCHOOL,10TH,1,0,9,17,11,38,27,71%
0980,HARRISON 2,6244,NEW HORIZONS DAY SCHOOL,11TH,3,0,11,20,12,46,34,74%
0980,HARRISON 2,6244,NEW HORIZONS DAY SCHOOL,12TH,0,0,15,38,15,68,53,78%
0980,HARRISON 2,6244,NEW HORIZONS DAY SCHOOL,SCHOOL TOTAL,6,0,49,98,44,197,153,78%
0980,HARRISON 2,6460,OAK CREEK ELEMENTARY SCHOOL,PK,0,6,2,21,10,39,29,74%
0980,HARRISON 2,6460,OAK CREEK ELEMENTARY SCHOOL,KINDERGARTEN,1,2,2,33,20,58,38,66%
0980,HARRISON 2,6460,OAK CREEK ELEMENTARY SCHOOL,1ST,2,0,5,30,24,61,37,61%
0980,HARRISON 2,6460,OAK CREEK ELEMENTARY SCHOOL,2ND,1,2,4,24,16,47,31,66%
0980,HARRISON 2,6460,OAK CREEK ELEMENTARY SCHOOL,3RD,1,1,12,30,13,57,44,77%
0980,HARRISON 2,6460,OAK CREEK ELEMENTARY SCHOOL,4TH,0,0,5,24,15,44,29,66%
0980,HARRISON 2,6460,OAK CREEK ELEMENTARY SCHOOL,5TH,3,0,2,14,19,38,19,50%
0980,HARRISON 2,6460,OAK CREEK ELEMENTARY SCHOOL,SCHOOL TOTAL,8,11,32,176,117,344,227,66%
0980,HARRISON 2,6578,OTERO ELEMENTARY SCHOOL,PK,2,10,9,15,12,48,36,75%
0980,HARRISON 2,6578,OTERO ELEMENTARY SCHOOL,KINDERGARTEN,3,5,9,30,38,85,47,55%
0980,HARRISON 2,6578,OTERO ELEMENTARY SCHOOL,1ST,3,4,17,19,26,69,43,62%
0980,HARRISON 2,6578,OTERO ELEMENTARY SCHOOL,2ND,3,7,8,15,21,54,33,61%
0980,HARRISON 2,6578,OTERO ELEMENTARY SCHOOL,3RD,0,6,22,19,17,64,47,73%
0980,HARRISON 2,6578,OTERO ELEMENTARY SCHOOL,4TH,0,4,13,14,22,53,31,58%
0980,HARRISON 2,6578,OTERO ELEMENTARY SCHOOL,5TH,0,3,13,17,19,52,33,63%
0980,HARRISON 2,6578,OTERO ELEMENTARY SCHOOL,SCHOOL TOTAL,11,39,91,129,155,425,270,64%
0980,HARRISON 2,6686,PANORAMA MIDDLE SCHOOL,6TH,7,13,76,83,44,223,179,80%
0980,HARRISON 2,6686,PANORAMA MIDDLE SCHOOL,7TH,2,7,70,82,42,203,161,79%
0980,HARRISON 2,6686,PANORAMA MIDDLE SCHOOL,8TH,2,9,60,74,51,196,145,74%
0980,HARRISON 2,6686,PANORAMA MIDDLE SCHOOL,SCHOOL TOTAL,11,29,206,239,137,622,485,78%
0980,HARRISON 2,6936,PIKES PEAK ELEMENTARY SCHOOL,PK,0,1,4,29,9,43,34,79%
0980,HARRISON 2,6936,PIKES PEAK ELEMENTARY SCHOOL,KINDERGARTEN,2,2,9,43,12,68,56,82%
0980,HARRISON 2,6936,PIKES PEAK ELEMENTARY SCHOOL,1ST,3,2,13,40,18,76,58,76%
0980,HARRISON 2,6936,PIKES PEAK ELEMENTARY SCHOOL,2ND,2,2,10,44,10,68,58,85%
0980,HARRISON 2,6936,PIKES PEAK ELEMENTARY SCHOOL,3RD,2,3,17,30,10,62,52,84%
0980,HARRISON 2,6936,PIKES PEAK ELEMENTARY SCHOOL,4TH,1,1,9,36,9,56,47,84%
0980,HARRISON 2,6936,PIKES PEAK ELEMENTARY SCHOOL,5TH,0,1,18,22,13,54,41,76%
0980,HARRISON 2,6936,PIKES PEAK ELEMENTARY SCHOOL,SCHOOL TOTAL,10,12,80,244,81,427,346,81%
0980,HARRISON 2,7611,SAND CREEK ELEMENTARY SCHOOL,PK,2,0,6,12,4,24,20,83%
0980,HARRISON 2,7611,SAND CREEK ELEMENTARY SCHOOL,KINDERGARTEN,2,6,20,45,16,89,73,82%
0980,HARRISON 2,7611,SAND CREEK ELEMENTARY SCHOOL,1ST,1,3,23,43,17,87,70,80%
0980,HARRISON 2,7611,SAND CREEK ELEMENTARY SCHOOL,2ND,6,3,23,40,24,96,72,75%
0980,HARRISON 2,7611,SAND CREEK ELEMENTARY SCHOOL,3RD,3,4,23,40,19,89,70,79%
0980,HARRISON 2,7611,SAND CREEK ELEMENTARY SCHOOL,4TH,2,6,18,36,16,78,62,79%
0980,HARRISON 2,7611,SAND CREEK ELEMENTARY SCHOOL,5TH,2,2,17,34,21,76,55,72%
0980,HARRISON 2,7611,SAND CREEK ELEMENTARY SCHOOL,SCHOOL TOTAL,18,24,130,250,117,539,422,78%
0980,HARRISON 2,7882,SIERRA HIGH SCHOOL,9TH,3,17,79,82,48,229,181,79%
0980,HARRISON 2,7882,SIERRA HIGH SCHOOL,10TH,11,9,86,87,61,254,193,76%
0980,HARRISON 2,7882,SIERRA HIGH SCHOOL,11TH,6,15,86,87,62,256,194,76%
0980,HARRISON 2,7882,SIERRA HIGH SCHOOL,12TH,9,17,84,66,68,244,176,72%
0980,HARRISON 2,7882,SIERRA HIGH SCHOOL,SCHOOL TOTAL,29,58,335,322,239,983,744,76%
0980,HARRISON 2,8034,SOARING EAGLES ELEMENTARY SCHOOL,PK,0,3,6,9,12,30,18,60%
0980,HARRISON 2,8034,SOARING EAGLES ELEMENTARY SCHOOL,KINDERGARTEN,1,7,18,27,17,70,53,76%
0980,HARRISON 2,8034,SOARING EAGLES ELEMENTARY SCHOOL,1ST,0,7,13,38,32,90,58,64%
0980,HARRISON 2,8034,SOARING EAGLES ELEMENTARY SCHOOL,2ND,0,5,25,41,32,103,71,69%
0980,HARRISON 2,8034,SOARING EAGLES ELEMENTARY SCHOOL,3RD,0,5,21,34,26,86,60,70%
0980,HARRISON 2,8034,SOARING EAGLES ELEMENTARY SCHOOL,4TH,2,1,23,32,30,88,58,66%
0980,HARRISON 2,8034,SOARING EAGLES ELEMENTARY SCHOOL,5TH,1,3,16,25,31,76,45,59%
0980,HARRISON 2,8034,SOARING EAGLES ELEMENTARY SCHOOL,SCHOOL TOTAL,4,31,122,206,180,543,363,67%
0980,HARRISON 2,8337,STRATMOOR HILLS ELEMENTARY SCHOOL,PK,0,1,9,10,13,33,20,61%
0980,HARRISON 2,8337,STRATMOOR HILLS ELEMENTARY SCHOOL,KINDERGARTEN,0,2,4,18,21,45,24,53%
0980,HARRISON 2,8337,STRATMOOR HILLS ELEMENTARY SCHOOL,1ST,0,3,10,15,26,54,28,52%
0980,HARRISON 2,8337,STRATMOOR HILLS ELEMENTARY SCHOOL,2ND,0,5,11,16,14,46,32,70%
0980,HARRISON 2,8337,STRATMOOR HILLS ELEMENTARY SCHOOL,3RD,3,3,8,18,19,51,32,63%
0980,HARRISON 2,8337,STRATMOOR HILLS ELEMENTARY SCHOOL,4TH,0,3,9,8,22,42,20,48%
0980,HARRISON 2,8337,STRATMOOR HILLS ELEMENTARY SCHOOL,5TH,1,2,4,10,12,29,17,59%
0980,HARRISON 2,8337,STRATMOOR HILLS ELEMENTARY SCHOOL,SCHOOL TOTAL,4,19,55,95,127,300,173,58%
0980,HARRISON 2,8350,STRATTON MEADOWS ELEMENTARY SCHOOL,PK,0,2,3,22,9,36,27,75%
0980,HARRISON 2,8350,STRATTON MEADOWS ELEMENTARY SCHOOL,KINDERGARTEN,0,3,3,36,16,58,42,72%
0980,HARRISON 2,8350,STRATTON MEADOWS ELEMENTARY SCHOOL,1ST,2,2,9,49,22,84,62,74%
0980,HARRISON 2,8350,STRATTON MEADOWS ELEMENTARY SCHOOL,2ND,2,1,7,27,17,54,37,69%
0980,HARRISON 2,8350,STRATTON MEADOWS ELEMENTARY SCHOOL,3RD,1,0,6,22,9,38,29,76%
0980,HARRISON 2,8350,STRATTON MEADOWS ELEMENTARY SCHOOL,4TH,1,4,7,37,9,58,49,84%
0980,HARRISON 2,8350,STRATTON MEADOWS ELEMENTARY SCHOOL,5TH,2,1,8,21,9,41,32,78%
0980,HARRISON 2,8350,STRATTON MEADOWS ELEMENTARY SCHOOL,SCHOOL TOTAL,8,13,43,214,91,369,278,75%
0980,HARRISON 2,8923,TURMAN ELEMENTARY SCHOOL,PK,2,2,10,22,26,62,36,58%
0980,HARRISON 2,8923,TURMAN ELEMENTARY SCHOOL,KINDERGARTEN,1,2,16,18,21,58,37,64%
0980,HARRISON 2,8923,TURMAN ELEMENTARY SCHOOL,1ST,0,5,18,32,17,72,55,76%
0980,HARRISON 2,8923,TURMAN ELEMENTARY SCHOOL,2ND,0,4,11,24,12,51,39,76%
0980,HARRISON 2,8923,TURMAN ELEMENTARY SCHOOL,3RD,1,2,13,18,14,48,34,71%
0980,HARRISON 2,8923,TURMAN ELEMENTARY SCHOOL,4TH,1,0,14,24,6,45,39,87%
0980,HARRISON 2,8923,TURMAN ELEMENTARY SCHOOL,5TH,0,1,10,16,8,35,27,77%
0980,HARRISON 2,8923,TURMAN ELEMENTARY SCHOOL,SCHOOL TOTAL,5,16,92,154,104,371,267,72%
0980,HARRISON 2,9602,WILDFLOWER ELEMENTARY SCHOOL,PK,1,3,17,31,18,70,52,74%
0980,HARRISON 2,9602,WILDFLOWER ELEMENTARY SCHOOL,KINDERGARTEN,0,3,16,15,18,52,34,65%
0980,HARRISON 2,9602,WILDFLOWER ELEMENTARY SCHOOL,1ST,2,2,17,20,28,69,41,59%
0980,HARRISON 2,9602,WILDFLOWER ELEMENTARY SCHOOL,2ND,1,2,13,13,17,46,29,63%
0980,HARRISON 2,9602,WILDFLOWER ELEMENTARY SCHOOL,3RD,0,7,13,11,18,49,31,63%
0980,HARRISON 2,9602,WILDFLOWER ELEMENTARY SCHOOL,4TH,0,5,16,12,20,53,33,62%
0980,HARRISON 2,9602,WILDFLOWER ELEMENTARY SCHOOL,5TH,0,1,11,13,15,40,25,63%
0980,HARRISON 2,9602,WILDFLOWER ELEMENTARY SCHOOL,SCHOOL TOTAL,4,23,103,115,134,379,245,65%
0980,HARRISON 2,,DISTRICT TOTAL,,244,549,2459,4581,3476,11309,7833,69%
0990,WIDEFIELD 3,3234,FRENCH ELEMENTARY SCHOOL,HALF DAY K,0,0,0,0,1,1,0,0%
0990,WIDEFIELD 3,3234,FRENCH ELEMENTARY SCHOOL,KINDERGARTEN,0,1,7,11,73,92,19,21%
0990,WIDEFIELD 3,3234,FRENCH ELEMENTARY SCHOOL,1ST,2,8,20,27,54,111,57,51%
0990,WIDEFIELD 3,3234,FRENCH ELEMENTARY SCHOOL,2ND,1,2,20,24,51,98,47,48%
0990,WIDEFIELD 3,3234,FRENCH ELEMENTARY SCHOOL,3RD,1,4,19,28,55,107,52,49%
0990,WIDEFIELD 3,3234,FRENCH ELEMENTARY SCHOOL,4TH,1,6,16,16,52,91,39,43%
0990,WIDEFIELD 3,3234,FRENCH ELEMENTARY SCHOOL,5TH,1,4,16,28,49,98,49,50%
0990,WIDEFIELD 3,3234,FRENCH ELEMENTARY SCHOOL,6TH,1,2,17,26,47,93,46,49%
0990,WIDEFIELD 3,3234,FRENCH ELEMENTARY SCHOOL,SCHOOL TOTAL,7,27,115,160,382,691,309,45%
0990,WIDEFIELD 3,4346,TALBOTT ELEMENTARY SCHOOL,KINDERGARTEN,0,2,8,5,36,51,15,29%
0990,WIDEFIELD 3,4346,TALBOTT ELEMENTARY SCHOOL,1ST,0,3,8,15,38,64,26,41%
0990,WIDEFIELD 3,4346,TALBOTT ELEMENTARY SCHOOL,2ND,1,3,15,11,36,66,30,45%
0990,WIDEFIELD 3,4346,TALBOTT ELEMENTARY SCHOOL,3RD,2,3,9,13,30,57,27,47%
0990,WIDEFIELD 3,4346,TALBOTT ELEMENTARY SCHOOL,4TH,0,4,7,10,26,47,21,45%
0990,WIDEFIELD 3,4346,TALBOTT ELEMENTARY SCHOOL,5TH,0,2,9,16,39,66,27,41%
0990,WIDEFIELD 3,4346,TALBOTT ELEMENTARY SCHOOL,6TH,2,4,9,13,24,52,28,54%
0990,WIDEFIELD 3,4346,TALBOTT ELEMENTARY SCHOOL,SCHOOL TOTAL,5,21,65,83,229,403,174,43%
0990,WIDEFIELD 3,4394,JANITELL JUNIOR HIGH SCHOOL,7TH,5,8,27,60,138,238,100,42%
0990,WIDEFIELD 3,4394,JANITELL JUNIOR HIGH SCHOOL,8TH,3,7,43,36,159,248,89,36%
0990,WIDEFIELD 3,4394,JANITELL JUNIOR HIGH SCHOOL,SCHOOL TOTAL,8,15,70,96,297,486,189,39%
0990,WIDEFIELD 3,5033,JAMES MADISON CHARTER ACADEMY SCHOOL,KINDERGARTEN,0,0,3,5,14,22,8,36%
0990,WIDEFIELD 3,5033,JAMES MADISON CHARTER ACADEMY SCHOOL,1ST,0,1,5,6,11,23,12,52%
0990,WIDEFIELD 3,5033,JAMES MADISON CHARTER ACADEMY SCHOOL,2ND,1,1,4,3,10,19,9,47%
0990,WIDEFIELD 3,5033,JAMES MADISON CHARTER ACADEMY SCHOOL,3RD,0,0,4,5,13,22,9,41%
0990,WIDEFIELD 3,5033,JAMES MADISON CHARTER ACADEMY SCHOOL,4TH,0,0,3,3,7,13,6,46%
0990,WIDEFIELD 3,5033,JAMES MADISON CHARTER ACADEMY SCHOOL,5TH,0,0,3,2,7,12,5,42%
0990,WIDEFIELD 3,5033,JAMES MADISON CHARTER ACADEMY SCHOOL,6TH,0,0,6,2,7,15,8,53%
0990,WIDEFIELD 3,5033,JAMES MADISON CHARTER ACADEMY SCHOOL,SCHOOL TOTAL,1,2,28,26,69,126,57,45%
0990,WIDEFIELD 3,5602,MARTIN LUTHER KING JR ELEMENTARY SCHOOL,HALF DAY K,0,0,0,0,1,1,0,0%
0990,WIDEFIELD 3,5602,MARTIN LUTHER KING JR ELEMENTARY SCHOOL,KINDERGARTEN,1,1,12,7,32,53,21,40%
0990,WIDEFIELD 3,5602,MARTIN LUTHER KING JR ELEMENTARY SCHOOL,1ST,1,1,14,15,36,67,31,46%
0990,WIDEFIELD 3,5602,MARTIN LUTHER KING JR ELEMENTARY SCHOOL,2ND,2,4,9,13,37,65,28,43%
0990,WIDEFIELD 3,5602,MARTIN LUTHER KING JR ELEMENTARY SCHOOL,3RD,1,6,10,19,34,70,36,51%
0990,WIDEFIELD 3,5602,MARTIN LUTHER KING JR ELEMENTARY SCHOOL,4TH,0,2,20,11,29,62,33,53%
0990,WIDEFIELD 3,5602,MARTIN LUTHER KING JR ELEMENTARY SCHOOL,5TH,0,4,12,19,41,76,35,46%
0990,WIDEFIELD 3,5602,MARTIN LUTHER KING JR ELEMENTARY SCHOOL,6TH,0,2,14,20,39,75,36,48%
0990,WIDEFIELD 3,5602,MARTIN LUTHER KING JR ELEMENTARY SCHOOL,SCHOOL TOTAL,5,20,91,104,249,469,220,47%
0990,WIDEFIELD 3,5841,MESA RIDGE HIGH SCHOOL,9TH,4,16,53,56,193,322,129,40%
0990,WIDEFIELD 3,5841,MESA RIDGE HIGH SCHOOL,10TH,4,14,56,48,190,312,122,39%
0990,WIDEFIELD 3,5841,MESA RIDGE HIGH SCHOOL,11TH,4,15,54,54,202,329,127,39%
0990,WIDEFIELD 3,5841,MESA RIDGE HIGH SCHOOL,12TH,4,15,53,51,171,294,123,42%
0990,WIDEFIELD 3,5841,MESA RIDGE HIGH SCHOOL,SCHOOL TOTAL,16,60,216,209,756,1257,501,40%
0990,WIDEFIELD 3,6362,NORTH ELEMENTARY SCHOOL,KINDERGARTEN,0,2,1,5,30,38,8,21%
0990,WIDEFIELD 3,6362,NORTH ELEMENTARY SCHOOL,1ST,0,1,6,9,24,40,16,40%
0990,WIDEFIELD 3,6362,NORTH ELEMENTARY SCHOOL,2ND,1,1,3,12,16,33,17,52%
0990,WIDEFIELD 3,6362,NORTH ELEMENTARY SCHOOL,3RD,0,2,3,9,28,42,14,33%
0990,WIDEFIELD 3,6362,NORTH ELEMENTARY SCHOOL,4TH,2,0,3,7,29,41,12,29%
0990,WIDEFIELD 3,6362,NORTH ELEMENTARY SCHOOL,5TH,1,5,2,9,20,37,17,46%
0990,WIDEFIELD 3,6362,NORTH ELEMENTARY SCHOOL,6TH,1,1,4,9,28,43,15,35%
0990,WIDEFIELD 3,6362,NORTH ELEMENTARY SCHOOL,SCHOOL TOTAL,5,12,22,60,175,274,99,36%
0990,WIDEFIELD 3,6952,PINELLO ELEMENTARY SCHOOL,KINDERGARTEN,2,0,3,5,35,45,10,22%
0990,WIDEFIELD 3,6952,PINELLO ELEMENTARY SCHOOL,1ST,2,3,9,14,28,56,28,50%
0990,WIDEFIELD 3,6952,PINELLO ELEMENTARY SCHOOL,2ND,0,1,7,11,32,51,19,37%
0990,WIDEFIELD 3,6952,PINELLO ELEMENTARY SCHOOL,3RD,0,3,8,13,27,51,24,47%
0990,WIDEFIELD 3,6952,PINELLO ELEMENTARY SCHOOL,4TH,3,2,8,7,27,47,20,43%
0990,WIDEFIELD 3,6952,PINELLO ELEMENTARY SCHOOL,5TH,0,2,4,12,21,39,18,46%
0990,WIDEFIELD 3,6952,PINELLO ELEMENTARY SCHOOL,6TH,1,2,7,12,29,51,22,43%
0990,WIDEFIELD 3,6952,PINELLO ELEMENTARY SCHOOL,SCHOOL TOTAL,8,13,46,74,199,340,141,41%
0990,WIDEFIELD 3,8122,VENETUCCI ELEMENTARY SCHOOL,KINDERGARTEN,0,4,10,9,41,64,23,36%
0990,WIDEFIELD 3,8122,VENETUCCI ELEMENTARY SCHOOL,1ST,0,2,13,8,25,48,23,48%
0990,WIDEFIELD 3,8122,VENETUCCI ELEMENTARY SCHOOL,2ND,0,2,7,16,33,58,25,43%
0990,WIDEFIELD 3,8122,VENETUCCI ELEMENTARY SCHOOL,3RD,0,5,13,20,35,73,38,52%
0990,WIDEFIELD 3,8122,VENETUCCI ELEMENTARY SCHOOL,4TH,1,1,10,12,33,57,24,42%
0990,WIDEFIELD 3,8122,VENETUCCI ELEMENTARY SCHOOL,5TH,0,2,10,20,34,66,32,48%
0990,WIDEFIELD 3,8122,VENETUCCI ELEMENTARY SCHOOL,6TH,0,3,9,20,36,68,32,47%
0990,WIDEFIELD 3,8122,VENETUCCI ELEMENTARY SCHOOL,SCHOOL TOTAL,1,19,72,105,237,434,197,45%
0990,WIDEFIELD 3,8178,SPROUL JUNIOR HIGH SCHOOL,7TH,8,15,23,39,105,190,85,45%
0990,WIDEFIELD 3,8178,SPROUL JUNIOR HIGH SCHOOL,8TH,2,5,24,43,107,181,74,41%
0990,WIDEFIELD 3,8178,SPROUL JUNIOR HIGH SCHOOL,SCHOOL TOTAL,10,20,47,82,212,371,159,43%
0990,WIDEFIELD 3,8392,SUNRISE ELEMENTARY SCHOOL,KINDERGARTEN,1,5,14,4,90,114,24,21%
0990,WIDEFIELD 3,8392,SUNRISE ELEMENTARY SCHOOL,1ST,1,6,22,14,78,121,43,36%
0990,WIDEFIELD 3,8392,SUNRISE ELEMENTARY SCHOOL,2ND,2,10,21,20,54,107,53,50%
0990,WIDEFIELD 3,8392,SUNRISE ELEMENTARY SCHOOL,3RD,0,5,13,19,70,107,37,35%
0990,WIDEFIELD 3,8392,SUNRISE ELEMENTARY SCHOOL,4TH,3,4,25,19,63,114,51,45%
0990,WIDEFIELD 3,8392,SUNRISE ELEMENTARY SCHOOL,5TH,2,4,20,20,58,104,46,44%
0990,WIDEFIELD 3,8392,SUNRISE ELEMENTARY SCHOOL,6TH,1,4,19,18,64,106,42,40%
0990,WIDEFIELD 3,8392,SUNRISE ELEMENTARY SCHOOL,SCHOOL TOTAL,10,38,134,114,477,773,296,38%
0990,WIDEFIELD 3,9294,WATSON JUNIOR HIGH SCHOOL,7TH,1,8,28,36,126,199,73,37%
0990,WIDEFIELD 3,9294,WATSON JUNIOR HIGH SCHOOL,8TH,2,6,28,46,116,198,82,41%
0990,WIDEFIELD 3,9294,WATSON JUNIOR HIGH SCHOOL,SCHOOL TOTAL,3,14,56,82,242,397,155,39%
0990,WIDEFIELD 3,9334,WEBSTER ELEMENTARY SCHOOL,HALF DAY K,0,0,0,0,1,1,0,0%
0990,WIDEFIELD 3,9334,WEBSTER ELEMENTARY SCHOOL,KINDERGARTEN,2,8,14,21,54,99,45,45%
0990,WIDEFIELD 3,9334,WEBSTER ELEMENTARY SCHOOL,1ST,2,8,17,19,63,109,46,42%
0990,WIDEFIELD 3,9334,WEBSTER ELEMENTARY SCHOOL,2ND,0,5,17,27,38,87,49,56%
0990,WIDEFIELD 3,9334,WEBSTER ELEMENTARY SCHOOL,3RD,0,5,13,24,47,89,42,47%
0990,WIDEFIELD 3,9334,WEBSTER ELEMENTARY SCHOOL,4TH,2,7,9,23,52,93,41,44%
0990,WIDEFIELD 3,9334,WEBSTER ELEMENTARY SCHOOL,5TH,0,8,13,22,51,94,43,46%
0990,WIDEFIELD 3,9334,WEBSTER ELEMENTARY SCHOOL,6TH,4,9,17,12,46,88,42,48%
0990,WIDEFIELD 3,9334,WEBSTER ELEMENTARY SCHOOL,SCHOOL TOTAL,10,50,100,148,352,660,308,47%
0990,WIDEFIELD 3,9560,DISCOVERY HIGH SCHOOL,10TH,1,0,2,4,9,16,7,44%
0990,WIDEFIELD 3,9560,DISCOVERY HIGH SCHOOL,11TH,0,0,7,6,9,22,13,59%
0990,WIDEFIELD 3,9560,DISCOVERY HIGH SCHOOL,12TH,0,2,10,11,33,56,23,41%
0990,WIDEFIELD 3,9560,DISCOVERY HIGH SCHOOL,SCHOOL TOTAL,1,2,19,21,51,94,43,46%
0990,WIDEFIELD 3,9562,WIDEFIELD ELEMENTARY SCHOOL,KINDERGARTEN,0,2,6,6,37,51,14,27%
0990,WIDEFIELD 3,9562,WIDEFIELD ELEMENTARY SCHOOL,1ST,1,2,9,11,41,64,23,36%
0990,WIDEFIELD 3,9562,WIDEFIELD ELEMENTARY SCHOOL,2ND,2,0,9,12,38,61,23,38%
0990,WIDEFIELD 3,9562,WIDEFIELD ELEMENTARY SCHOOL,3RD,4,4,10,11,44,73,29,40%
0990,WIDEFIELD 3,9562,WIDEFIELD ELEMENTARY SCHOOL,4TH,0,2,5,7,43,57,14,25%
0990,WIDEFIELD 3,9562,WIDEFIELD ELEMENTARY SCHOOL,5TH,2,3,4,11,35,55,20,36%
0990,WIDEFIELD 3,9562,WIDEFIELD ELEMENTARY SCHOOL,6TH,0,2,6,12,45,65,20,31%
0990,WIDEFIELD 3,9562,WIDEFIELD ELEMENTARY SCHOOL,SCHOOL TOTAL,9,15,49,70,283,426,143,34%
0990,WIDEFIELD 3,9566,WIDEFIELD HIGH SCHOOL,9TH,2,17,40,82,186,327,141,43%
0990,WIDEFIELD 3,9566,WIDEFIELD HIGH SCHOOL,10TH,5,12,68,56,181,322,141,44%
0990,WIDEFIELD 3,9566,WIDEFIELD HIGH SCHOOL,11TH,2,10,55,52,190,309,119,39%
0990,WIDEFIELD 3,9566,WIDEFIELD HIGH SCHOOL,12TH,3,20,61,63,169,316,147,47%
0990,WIDEFIELD 3,9566,WIDEFIELD HIGH SCHOOL,SCHOOL TOTAL,12,59,224,253,726,1274,548,43%
0990,WIDEFIELD 3,9656,WILSON PRESCHOOL,PK,4,17,53,33,269,376,107,28%
0990,WIDEFIELD 3,9656,WILSON PRESCHOOL,SCHOOL TOTAL,4,17,53,33,269,376,107,28%
0990,WIDEFIELD 3,,DISTRICT TOTAL,,115,404,1407,1720,5205,8851,3646,41%
1000,FOUNTAIN 8,0203,LORRAINE SECONDARY SCHOOL,6TH,0,0,1,0,1,2,1,50%
1000,FOUNTAIN 8,0203,LORRAINE SECONDARY SCHOOL,7TH,0,0,0,0,4,4,0,0%
1000,FOUNTAIN 8,0203,LORRAINE SECONDARY SCHOOL,8TH,0,1,1,4,4,10,6,60%
1000,FOUNTAIN 8,0203,LORRAINE SECONDARY SCHOOL,9TH,4,1,6,12,23,46,23,50%
1000,FOUNTAIN 8,0203,LORRAINE SECONDARY SCHOOL,10TH,3,1,1,5,15,25,10,40%
1000,FOUNTAIN 8,0203,LORRAINE SECONDARY SCHOOL,11TH,1,2,2,4,14,23,9,39%
1000,FOUNTAIN 8,0203,LORRAINE SECONDARY SCHOOL,12TH,0,0,4,2,6,12,6,50%
1000,FOUNTAIN 8,0203,LORRAINE SECONDARY SCHOOL,SCHOOL TOTAL,8,5,15,27,67,122,55,45%
1000,FOUNTAIN 8,1332,CARSON MIDDLE SCHOOL,6TH,6,14,66,38,140,264,124,47%
1000,FOUNTAIN 8,1332,CARSON MIDDLE SCHOOL,7TH,3,6,68,43,102,222,120,54%
1000,FOUNTAIN 8,1332,CARSON MIDDLE SCHOOL,8TH,2,6,45,30,111,194,83,43%
1000,FOUNTAIN 8,1332,CARSON MIDDLE SCHOOL,SCHOOL TOTAL,11,26,179,111,353,680,327,48%
1000,FOUNTAIN 8,1334,ABRAMS ELEMENTARY SCHOOL,PK,1,0,4,9,15,29,14,48%
1000,FOUNTAIN 8,1334,ABRAMS ELEMENTARY SCHOOL,HALF DAY K,1,2,4,5,33,45,12,27%
1000,FOUNTAIN 8,1334,ABRAMS ELEMENTARY SCHOOL,KINDERGARTEN,3,3,9,9,47,71,24,34%
1000,FOUNTAIN 8,1334,ABRAMS ELEMENTARY SCHOOL,1ST,2,5,24,19,63,113,50,44%
1000,FOUNTAIN 8,1334,ABRAMS ELEMENTARY SCHOOL,2ND,3,4,21,24,65,117,52,44%
1000,FOUNTAIN 8,1334,ABRAMS ELEMENTARY SCHOOL,3RD,1,2,16,18,51,88,37,42%
1000,FOUNTAIN 8,1334,ABRAMS ELEMENTARY SCHOOL,4TH,2,2,14,22,69,109,40,37%
1000,FOUNTAIN 8,1334,ABRAMS ELEMENTARY SCHOOL,5TH,2,3,16,13,24,58,34,59%
1000,FOUNTAIN 8,1334,ABRAMS ELEMENTARY SCHOOL,SCHOOL TOTAL,15,21,108,119,367,630,263,42%
1000,FOUNTAIN 8,3027,EAGLESIDE ELEMENTARY SCHOOL,PK,0,3,6,14,34,57,23,40%
1000,FOUNTAIN 8,3027,EAGLESIDE ELEMENTARY SCHOOL,HALF DAY K,0,1,2,9,24,36,12,33%
1000,FOUNTAIN 8,3027,EAGLESIDE ELEMENTARY SCHOOL,KINDERGARTEN,1,2,8,2,36,49,13,27%
1000,FOUNTAIN 8,3027,EAGLESIDE ELEMENTARY SCHOOL,1ST,1,3,12,17,43,76,33,43%
1000,FOUNTAIN 8,3027,EAGLESIDE ELEMENTARY SCHOOL,2ND,1,5,19,14,51,90,39,43%
1000,FOUNTAIN 8,3027,EAGLESIDE ELEMENTARY SCHOOL,3RD,1,2,9,23,58,93,35,38%
1000,FOUNTAIN 8,3027,EAGLESIDE ELEMENTARY SCHOOL,4TH,1,3,20,19,40,83,43,52%
1000,FOUNTAIN 8,3027,EAGLESIDE ELEMENTARY SCHOOL,5TH,3,6,8,9,32,58,26,45%
1000,FOUNTAIN 8,3027,EAGLESIDE ELEMENTARY SCHOOL,SCHOOL TOTAL,8,25,84,107,318,542,224,41%
1000,FOUNTAIN 8,3102,ARAGON ELEMENTARY SCHOOL,PK,1,0,6,9,16,32,16,50%
1000,FOUNTAIN 8,3102,ARAGON ELEMENTARY SCHOOL,HALF DAY K,2,1,3,17,19,42,23,55%
1000,FOUNTAIN 8,3102,ARAGON ELEMENTARY SCHOOL,KINDERGARTEN,1,1,6,4,12,24,12,50%
1000,FOUNTAIN 8,3102,ARAGON ELEMENTARY SCHOOL,1ST,2,3,5,16,46,72,26,36%
1000,FOUNTAIN 8,3102,ARAGON ELEMENTARY SCHOOL,2ND,3,3,9,29,53,97,44,45%
1000,FOUNTAIN 8,3102,ARAGON ELEMENTARY SCHOOL,3RD,0,1,9,19,31,60,29,48%
1000,FOUNTAIN 8,3102,ARAGON ELEMENTARY SCHOOL,4TH,0,1,8,30,52,91,39,43%
1000,FOUNTAIN 8,3102,ARAGON ELEMENTARY SCHOOL,5TH,3,3,9,15,52,82,30,37%
1000,FOUNTAIN 8,3102,ARAGON ELEMENTARY SCHOOL,SCHOOL TOTAL,12,13,55,139,281,500,219,44%
1000,FOUNTAIN 8,3106,FOUNTAIN MIDDLE SCHOOL,6TH,6,8,55,75,182,326,144,44%
1000,FOUNTAIN 8,3106,FOUNTAIN MIDDLE SCHOOL,7TH,5,11,57,76,169,318,149,47%
1000,FOUNTAIN 8,3106,FOUNTAIN MIDDLE SCHOOL,8TH,9,7,49,48,148,261,113,43%
1000,FOUNTAIN 8,3106,FOUNTAIN MIDDLE SCHOOL,SCHOOL TOTAL,20,26,161,199,499,905,406,45%
1000,FOUNTAIN 8,3108,MESA ELEMENTARY SCHOOL,HALF DAY K,0,2,1,5,15,23,8,35%
1000,FOUNTAIN 8,3108,MESA ELEMENTARY SCHOOL,KINDERGARTEN,1,1,0,6,16,24,8,33%
1000,FOUNTAIN 8,3108,MESA ELEMENTARY SCHOOL,1ST,1,0,12,12,36,61,25,41%
1000,FOUNTAIN 8,3108,MESA ELEMENTARY SCHOOL,2ND,2,3,9,13,35,62,27,44%
1000,FOUNTAIN 8,3108,MESA ELEMENTARY SCHOOL,3RD,1,1,9,12,47,70,23,33%
1000,FOUNTAIN 8,3108,MESA ELEMENTARY SCHOOL,4TH,0,3,13,21,55,92,37,40%
1000,FOUNTAIN 8,3108,MESA ELEMENTARY SCHOOL,5TH,0,0,14,17,59,90,31,34%
1000,FOUNTAIN 8,3108,MESA ELEMENTARY SCHOOL,SCHOOL TOTAL,5,10,58,86,263,422,159,38%
1000,FOUNTAIN 8,3110,FOUNTAIN-FORT CARSON HIGH SCHOOL,9TH,11,19,113,88,268,499,231,46%
1000,FOUNTAIN 8,3110,FOUNTAIN-FORT CARSON HIGH SCHOOL,10TH,6,9,86,91,210,402,192,48%
1000,FOUNTAIN 8,3110,FOUNTAIN-FORT CARSON HIGH SCHOOL,11TH,7,16,91,62,204,380,176,46%
1000,FOUNTAIN 8,3110,FOUNTAIN-FORT CARSON HIGH SCHOOL,12TH,7,23,96,71,171,368,197,54%
1000,FOUNTAIN 8,3110,FOUNTAIN-FORT CARSON HIGH SCHOOL,SCHOOL TOTAL,31,67,386,312,853,1649,796,48%
1000,FOUNTAIN 8,4474,JORDAHL ELEMENTARY SCHOOL,PK,1,0,3,3,21,28,7,25%
1000,FOUNTAIN 8,4474,JORDAHL ELEMENTARY SCHOOL,HALF DAY K,1,0,1,5,16,23,7,30%
1000,FOUNTAIN 8,4474,JORDAHL ELEMENTARY SCHOOL,KINDERGARTEN,0,2,6,11,28,47,19,40%
1000,FOUNTAIN 8,4474,JORDAHL ELEMENTARY SCHOOL,1ST,2,0,12,12,41,67,26,39%
1000,FOUNTAIN 8,4474,JORDAHL ELEMENTARY SCHOOL,2ND,3,3,8,17,54,85,31,36%
1000,FOUNTAIN 8,4474,JORDAHL ELEMENTARY SCHOOL,3RD,4,3,13,10,39,69,30,43%
1000,FOUNTAIN 8,4474,JORDAHL ELEMENTARY SCHOOL,4TH,1,0,9,16,57,83,26,31%
1000,FOUNTAIN 8,4474,JORDAHL ELEMENTARY SCHOOL,5TH,2,2,7,13,56,80,24,30%
1000,FOUNTAIN 8,4474,JORDAHL ELEMENTARY SCHOOL,SCHOOL TOTAL,14,10,59,87,312,482,170,35%
1000,FOUNTAIN 8,6138,MOUNTAINSIDE ELEMENTARY SCHOOL,PK,1,2,9,6,39,57,18,32%
1000,FOUNTAIN 8,6138,MOUNTAINSIDE ELEMENTARY SCHOOL,HALF DAY K,2,3,6,7,19,37,18,49%
1000,FOUNTAIN 8,6138,MOUNTAINSIDE ELEMENTARY SCHOOL,KINDERGARTEN,1,3,15,12,38,69,31,45%
1000,FOUNTAIN 8,6138,MOUNTAINSIDE ELEMENTARY SCHOOL,1ST,1,4,14,17,71,107,36,34%
1000,FOUNTAIN 8,6138,MOUNTAINSIDE ELEMENTARY SCHOOL,2ND,4,4,20,15,63,106,43,41%
1000,FOUNTAIN 8,6138,MOUNTAINSIDE ELEMENTARY SCHOOL,3RD,1,6,21,12,47,87,40,46%
1000,FOUNTAIN 8,6138,MOUNTAINSIDE ELEMENTARY SCHOOL,4TH,1,4,23,17,42,87,45,52%
1000,FOUNTAIN 8,6138,MOUNTAINSIDE ELEMENTARY SCHOOL,5TH,2,2,14,11,31,60,29,48%
1000,FOUNTAIN 8,6138,MOUNTAINSIDE ELEMENTARY SCHOOL,SCHOOL TOTAL,13,28,122,97,350,610,260,43%
1000,FOUNTAIN 8,6338,PATRIOT ELEMENTARY SCHOOL,PK,0,3,8,11,52,74,22,30%
1000,FOUNTAIN 8,6338,PATRIOT ELEMENTARY SCHOOL,HALF DAY K,1,2,4,13,22,42,20,48%
1000,FOUNTAIN 8,6338,PATRIOT ELEMENTARY SCHOOL,KINDERGARTEN,3,4,12,11,42,72,30,42%
1000,FOUNTAIN 8,6338,PATRIOT ELEMENTARY SCHOOL,1ST,2,10,21,20,65,118,53,45%
1000,FOUNTAIN 8,6338,PATRIOT ELEMENTARY SCHOOL,2ND,2,9,22,30,74,137,63,46%
1000,FOUNTAIN 8,6338,PATRIOT ELEMENTARY SCHOOL,3RD,1,8,24,23,74,130,56,43%
1000,FOUNTAIN 8,6338,PATRIOT ELEMENTARY SCHOOL,4TH,5,3,32,28,68,136,68,50%
1000,FOUNTAIN 8,6338,PATRIOT ELEMENTARY SCHOOL,5TH,3,2,28,19,62,114,52,46%
1000,FOUNTAIN 8,6338,PATRIOT ELEMENTARY SCHOOL,SCHOOL TOTAL,17,41,151,155,459,823,364,44%
1000,FOUNTAIN 8,,DISTRICT TOTAL,,154,272,1378,1439,4122,7365,3243,44%
1010,COLORADO SPRINGS 11,0269,ACHIEVEK12,KINDERGARTEN,0,1,1,0,5,7,2,29%
1010,COLORADO SPRINGS 11,0269,ACHIEVEK12,1ST,0,0,0,1,7,8,1,13%
1010,COLORADO SPRINGS 11,0269,ACHIEVEK12,2ND,0,0,0,1,3,4,1,25%
1010,COLORADO SPRINGS 11,0269,ACHIEVEK12,3RD,0,0,2,0,3,5,2,40%
1010,COLORADO SPRINGS 11,0269,ACHIEVEK12,4TH,0,0,1,1,4,6,2,33%
1010,COLORADO SPRINGS 11,0269,ACHIEVEK12,5TH,0,0,1,1,2,4,2,50%
1010,COLORADO SPRINGS 11,0269,ACHIEVEK12,6TH,1,0,2,2,3,8,5,63%
1010,COLORADO SPRINGS 11,0269,ACHIEVEK12,7TH,0,0,1,0,3,4,1,25%
1010,COLORADO SPRINGS 11,0269,ACHIEVEK12,8TH,0,0,1,2,11,14,3,21%
1010,COLORADO SPRINGS 11,0269,ACHIEVEK12,SCHOOL TOTAL,1,1,9,8,41,60,19,32%
1010,COLORADO SPRINGS 11,0452,AUDUBON ELEMENTARY SCHOOL,PK,1,3,3,9,15,31,16,52%
1010,COLORADO SPRINGS 11,0452,AUDUBON ELEMENTARY SCHOOL,KINDERGARTEN,1,0,4,10,31,46,15,33%
1010,COLORADO SPRINGS 11,0452,AUDUBON ELEMENTARY SCHOOL,1ST,1,2,7,14,30,54,24,44%
1010,COLORADO SPRINGS 11,0452,AUDUBON ELEMENTARY SCHOOL,2ND,0,1,4,15,29,49,20,41%
1010,COLORADO SPRINGS 11,0452,AUDUBON ELEMENTARY SCHOOL,3RD,1,3,4,10,36,54,18,33%
1010,COLORADO SPRINGS 11,0452,AUDUBON ELEMENTARY SCHOOL,4TH,1,3,2,12,26,44,18,41%
1010,COLORADO SPRINGS 11,0452,AUDUBON ELEMENTARY SCHOOL,5TH,0,1,7,15,24,47,23,49%
1010,COLORADO SPRINGS 11,0452,AUDUBON ELEMENTARY SCHOOL,SCHOOL TOTAL,5,13,31,85,191,325,134,41%
1010,COLORADO SPRINGS 11,0594,BATES ELEMENTARY SCHOOL,PK,0,2,2,6,21,31,10,32%
1010,COLORADO SPRINGS 11,0594,BATES ELEMENTARY SCHOOL,KINDERGARTEN,1,0,6,6,27,40,13,33%
1010,COLORADO SPRINGS 11,0594,BATES ELEMENTARY SCHOOL,1ST,1,1,3,12,25,42,17,40%
1010,COLORADO SPRINGS 11,0594,BATES ELEMENTARY SCHOOL,2ND,0,0,4,10,22,36,14,39%
1010,COLORADO SPRINGS 11,0594,BATES ELEMENTARY SCHOOL,3RD,0,0,0,3,25,28,3,11%
1010,COLORADO SPRINGS 11,0594,BATES ELEMENTARY SCHOOL,4TH,0,0,2,9,24,35,11,31%
1010,COLORADO SPRINGS 11,0594,BATES ELEMENTARY SCHOOL,5TH,0,1,2,6,25,34,9,26%
1010,COLORADO SPRINGS 11,0594,BATES ELEMENTARY SCHOOL,SCHOOL TOTAL,2,4,19,52,169,246,77,31%
1010,COLORADO SPRINGS 11,0871,BIJOU ALTERNATIVE PROGRAM,10TH,0,0,0,1,6,7,1,14%
1010,COLORADO SPRINGS 11,0871,BIJOU ALTERNATIVE PROGRAM,11TH,0,2,1,13,22,38,16,42%
1010,COLORADO SPRINGS 11,0871,BIJOU ALTERNATIVE PROGRAM,12TH,1,0,4,13,72,90,18,20%
1010,COLORADO SPRINGS 11,0871,BIJOU ALTERNATIVE PROGRAM,SCHOOL TOTAL,1,2,5,27,100,135,35,26%
1010,COLORADO SPRINGS 11,1032,BRISTOL ELEMENTARY SCHOOL,KINDERGARTEN,0,0,4,12,15,31,16,52%
1010,COLORADO SPRINGS 11,1032,BRISTOL ELEMENTARY SCHOOL,1ST,1,0,4,12,26,43,17,40%
1010,COLORADO SPRINGS 11,1032,BRISTOL ELEMENTARY SCHOOL,2ND,2,1,3,7,26,39,13,33%
1010,COLORADO SPRINGS 11,1032,BRISTOL ELEMENTARY SCHOOL,3RD,0,0,5,16,26,47,21,45%
1010,COLORADO SPRINGS 11,1032,BRISTOL ELEMENTARY SCHOOL,4TH,1,1,3,14,26,45,19,42%
1010,COLORADO SPRINGS 11,1032,BRISTOL ELEMENTARY SCHOOL,5TH,0,0,2,10,19,31,12,39%
1010,COLORADO SPRINGS 11,1032,BRISTOL ELEMENTARY SCHOOL,SCHOOL TOTAL,4,2,21,71,138,236,98,42%
1010,COLORADO SPRINGS 11,1126,BUENA VISTA ELEMENTARY SCHOOL,PK,0,2,1,4,16,23,7,30%
1010,COLORADO SPRINGS 11,1126,BUENA VISTA ELEMENTARY SCHOOL,KINDERGARTEN,0,1,0,1,31,33,2,6%
1010,COLORADO SPRINGS 11,1126,BUENA VISTA ELEMENTARY SCHOOL,1ST,1,1,2,3,27,34,7,21%
1010,COLORADO SPRINGS 11,1126,BUENA VISTA ELEMENTARY SCHOOL,2ND,1,0,0,4,16,21,5,24%
1010,COLORADO SPRINGS 11,1126,BUENA VISTA ELEMENTARY SCHOOL,3RD,0,0,1,1,18,20,2,10%
1010,COLORADO SPRINGS 11,1126,BUENA VISTA ELEMENTARY SCHOOL,4TH,0,1,2,3,19,25,6,24%
1010,COLORADO SPRINGS 11,1126,BUENA VISTA ELEMENTARY SCHOOL,5TH,0,0,1,2,15,18,3,17%
1010,COLORADO SPRINGS 11,1126,BUENA VISTA ELEMENTARY SCHOOL,SCHOOL TOTAL,2,5,7,18,142,174,32,18%
1010,COLORADO SPRINGS 11,1340,CARVER ELEMENTARY SCHOOL,KINDERGARTEN,1,1,17,22,27,68,41,60%
1010,COLORADO SPRINGS 11,1340,CARVER ELEMENTARY SCHOOL,1ST,2,3,6,17,31,59,28,47%
1010,COLORADO SPRINGS 11,1340,CARVER ELEMENTARY SCHOOL,2ND,0,2,12,15,35,64,29,45%
1010,COLORADO SPRINGS 11,1340,CARVER ELEMENTARY SCHOOL,3RD,1,2,10,20,36,69,33,48%
1010,COLORADO SPRINGS 11,1340,CARVER ELEMENTARY SCHOOL,4TH,2,0,11,11,25,49,24,49%
1010,COLORADO SPRINGS 11,1340,CARVER ELEMENTARY SCHOOL,5TH,2,1,7,12,27,49,22,45%
1010,COLORADO SPRINGS 11,1340,CARVER ELEMENTARY SCHOOL,SCHOOL TOTAL,8,9,63,97,181,358,177,49%
1010,COLORADO SPRINGS 11,1613,CHIPETA ELEMENTARY SCHOOL,PK,0,7,0,3,19,29,10,34%
1010,COLORADO SPRINGS 11,1613,CHIPETA ELEMENTARY SCHOOL,KINDERGARTEN,1,4,5,7,57,74,17,23%
1010,COLORADO SPRINGS 11,1613,CHIPETA ELEMENTARY SCHOOL,1ST,1,6,1,4,64,76,12,16%
1010,COLORADO SPRINGS 11,1613,CHIPETA ELEMENTARY SCHOOL,2ND,0,4,4,8,58,74,16,22%
1010,COLORADO SPRINGS 11,1613,CHIPETA ELEMENTARY SCHOOL,3RD,0,11,1,7,55,74,19,26%
1010,COLORADO SPRINGS 11,1613,CHIPETA ELEMENTARY SCHOOL,4TH,0,3,1,4,61,69,8,12%
1010,COLORADO SPRINGS 11,1613,CHIPETA ELEMENTARY SCHOOL,5TH,0,6,3,5,61,75,14,19%
1010,COLORADO SPRINGS 11,1613,CHIPETA ELEMENTARY SCHOOL,SCHOOL TOTAL,2,41,15,38,375,471,96,20%
1010,COLORADO SPRINGS 11,1616,CIVA CHARTER ACADEMY,9TH,0,1,2,2,32,37,5,14%
1010,COLORADO SPRINGS 11,1616,CIVA CHARTER ACADEMY,10TH,0,3,2,6,27,38,11,29%
1010,COLORADO SPRINGS 11,1616,CIVA CHARTER ACADEMY,11TH,0,4,4,7,26,41,15,37%
1010,COLORADO SPRINGS 11,1616,CIVA CHARTER ACADEMY,12TH,1,2,3,5,15,26,11,42%
1010,COLORADO SPRINGS 11,1616,CIVA CHARTER ACADEMY,SCHOOL TOTAL,1,10,11,20,100,142,42,30%
1010,COLORADO SPRINGS 11,1625,MCAULIFFE ELEMENTARY,PK,1,0,2,5,23,31,8,26%
1010,COLORADO SPRINGS 11,1625,MCAULIFFE ELEMENTARY,KINDERGARTEN,1,8,13,17,65,104,39,38%
1010,COLORADO SPRINGS 11,1625,MCAULIFFE ELEMENTARY,1ST,2,1,18,25,79,125,46,37%
1010,COLORADO SPRINGS 11,1625,MCAULIFFE ELEMENTARY,2ND,2,3,11,16,60,92,32,35%
1010,COLORADO SPRINGS 11,1625,MCAULIFFE ELEMENTARY,3RD,1,2,15,26,49,93,44,47%
1010,COLORADO SPRINGS 11,1625,MCAULIFFE ELEMENTARY,4TH,0,4,13,16,46,79,33,42%
1010,COLORADO SPRINGS 11,1625,MCAULIFFE ELEMENTARY,5TH,2,4,9,14,42,71,29,41%
1010,COLORADO SPRINGS 11,1625,MCAULIFFE ELEMENTARY,SCHOOL TOTAL,9,22,81,119,364,595,231,39%
1010,COLORADO SPRINGS 11,1798,COLUMBIA ELEMENTARY SCHOOL,PK,3,0,3,4,20,30,10,33%
1010,COLORADO SPRINGS 11,1798,COLUMBIA ELEMENTARY SCHOOL,KINDERGARTEN,2,1,12,16,28,59,31,53%
1010,COLORADO SPRINGS 11,1798,COLUMBIA ELEMENTARY SCHOOL,1ST,1,1,7,9,32,50,18,36%
1010,COLORADO SPRINGS 11,1798,COLUMBIA ELEMENTARY SCHOOL,2ND,0,1,7,10,23,41,18,44%
1010,COLORADO SPRINGS 11,1798,COLUMBIA ELEMENTARY SCHOOL,3RD,2,1,8,12,22,45,23,51%
1010,COLORADO SPRINGS 11,1798,COLUMBIA ELEMENTARY SCHOOL,4TH,2,0,5,5,19,31,12,39%
1010,COLORADO SPRINGS 11,1798,COLUMBIA ELEMENTARY SCHOOL,5TH,0,0,11,7,22,40,18,45%
1010,COLORADO SPRINGS 11,1798,COLUMBIA ELEMENTARY SCHOOL,SCHOOL TOTAL,10,4,53,63,166,296,130,44%
1010,COLORADO SPRINGS 11,1870,CORONADO HIGH SCHOOL,9TH,7,11,17,68,285,388,103,27%
1010,COLORADO SPRINGS 11,1870,CORONADO HIGH SCHOOL,10TH,4,8,20,56,256,344,88,26%
1010,COLORADO SPRINGS 11,1870,CORONADO HIGH SCHOOL,11TH,5,6,27,50,244,332,88,27%
1010,COLORADO SPRINGS 11,1870,CORONADO HIGH SCHOOL,12TH,8,13,26,63,249,359,110,31%
1010,COLORADO SPRINGS 11,1870,CORONADO HIGH SCHOOL,SCHOOL TOTAL,24,38,90,237,1034,1423,389,27%
1010,COLORADO SPRINGS 11,1885,COMMUNITY PREP CHARTER SCHOOL,9TH,0,0,2,5,7,14,7,50%
1010,COLORADO SPRINGS 11,1885,COMMUNITY PREP CHARTER SCHOOL,10TH,1,0,9,13,11,34,23,68%
1010,COLORADO SPRINGS 11,1885,COMMUNITY PREP CHARTER SCHOOL,11TH,1,0,2,19,34,56,22,39%
1010,COLORADO SPRINGS 11,1885,COMMUNITY PREP CHARTER SCHOOL,12TH,0,0,13,20,42,75,33,44%
1010,COLORADO SPRINGS 11,1885,COMMUNITY PREP CHARTER SCHOOL,SCHOOL TOTAL,2,0,26,57,94,179,85,47%
1010,COLORADO SPRINGS 11,2202,DOHERTY HIGH SCHOOL,9TH,10,18,39,91,366,524,158,30%
1010,COLORADO SPRINGS 11,2202,DOHERTY HIGH SCHOOL,10TH,6,20,43,70,375,514,139,27%
1010,COLORADO SPRINGS 11,2202,DOHERTY HIGH SCHOOL,11TH,3,18,43,54,430,548,118,22%
1010,COLORADO SPRINGS 11,2202,DOHERTY HIGH SCHOOL,12TH,7,16,53,93,420,589,169,29%
1010,COLORADO SPRINGS 11,2202,DOHERTY HIGH SCHOOL,SCHOOL TOTAL,26,72,178,308,1591,2175,584,27%
1010,COLORADO SPRINGS 11,2510,EDISON ELEMENTARY SCHOOL,PK,2,0,0,26,28,56,28,50%
1010,COLORADO SPRINGS 11,2510,EDISON ELEMENTARY SCHOOL,KINDERGARTEN,1,1,2,17,18,39,21,54%
1010,COLORADO SPRINGS 11,2510,EDISON ELEMENTARY SCHOOL,1ST,4,1,5,7,20,37,17,46%
1010,COLORADO SPRINGS 11,2510,EDISON ELEMENTARY SCHOOL,2ND,1,0,7,14,12,34,22,65%
1010,COLORADO SPRINGS 11,2510,EDISON ELEMENTARY SCHOOL,3RD,4,0,2,13,16,35,19,54%
1010,COLORADO SPRINGS 11,2510,EDISON ELEMENTARY SCHOOL,4TH,0,0,2,10,13,25,12,48%
1010,COLORADO SPRINGS 11,2510,EDISON ELEMENTARY SCHOOL,5TH,2,1,1,14,22,40,18,45%
1010,COLORADO SPRINGS 11,2510,EDISON ELEMENTARY SCHOOL,SCHOOL TOTAL,14,3,19,101,129,266,137,52%
1010,COLORADO SPRINGS 11,2528,NIKOLA TESLA EDUCATION OPPORTUNITY CENTER,6TH,0,0,0,2,2,4,2,50%
1010,COLORADO SPRINGS 11,2528,NIKOLA TESLA EDUCATION OPPORTUNITY CENTER,7TH,2,0,1,4,5,12,7,58%
1010,COLORADO SPRINGS 11,2528,NIKOLA TESLA EDUCATION OPPORTUNITY CENTER,8TH,0,0,4,7,7,18,11,61%
1010,COLORADO SPRINGS 11,2528,NIKOLA TESLA EDUCATION OPPORTUNITY CENTER,9TH,2,1,1,5,12,21,9,43%
1010,COLORADO SPRINGS 11,2528,NIKOLA TESLA EDUCATION OPPORTUNITY CENTER,10TH,0,1,3,15,9,28,19,68%
1010,COLORADO SPRINGS 11,2528,NIKOLA TESLA EDUCATION OPPORTUNITY CENTER,11TH,2,0,6,19,30,57,27,47%
1010,COLORADO SPRINGS 11,2528,NIKOLA TESLA EDUCATION OPPORTUNITY CENTER,12TH,3,1,10,27,47,88,41,47%
1010,COLORADO SPRINGS 11,2528,NIKOLA TESLA EDUCATION OPPORTUNITY CENTER,SCHOOL TOTAL,9,3,25,79,112,228,116,51%
1010,COLORADO SPRINGS 11,3175,FREEDOM ELEMENTARY SCHOOL,PK,0,1,3,6,19,29,10,34%
1010,COLORADO SPRINGS 11,3175,FREEDOM ELEMENTARY SCHOOL,KINDERGARTEN,0,5,7,13,84,109,25,23%
1010,COLORADO SPRINGS 11,3175,FREEDOM ELEMENTARY SCHOOL,1ST,1,4,3,9,79,96,17,18%
1010,COLORADO SPRINGS 11,3175,FREEDOM ELEMENTARY SCHOOL,2ND,0,7,14,10,86,117,31,26%
1010,COLORADO SPRINGS 11,3175,FREEDOM ELEMENTARY SCHOOL,3RD,1,10,9,12,77,109,32,29%
1010,COLORADO SPRINGS 11,3175,FREEDOM ELEMENTARY SCHOOL,4TH,3,2,7,10,59,81,22,27%
1010,COLORADO SPRINGS 11,3175,FREEDOM ELEMENTARY SCHOOL,5TH,0,9,7,17,71,104,33,32%
1010,COLORADO SPRINGS 11,3175,FREEDOM ELEMENTARY SCHOOL,SCHOOL TOTAL,5,38,50,77,475,645,170,26%
1010,COLORADO SPRINGS 11,3218,FREMONT ELEMENTARY SCHOOL,KINDERGARTEN,1,2,8,16,40,67,27,40%
1010,COLORADO SPRINGS 11,3218,FREMONT ELEMENTARY SCHOOL,1ST,1,2,6,13,36,58,22,38%
1010,COLORADO SPRINGS 11,3218,FREMONT ELEMENTARY SCHOOL,2ND,1,2,11,10,48,72,24,33%
1010,COLORADO SPRINGS 11,3218,FREMONT ELEMENTARY SCHOOL,3RD,4,2,11,10,53,80,27,34%
1010,COLORADO SPRINGS 11,3218,FREMONT ELEMENTARY SCHOOL,4TH,0,3,9,11,32,55,23,42%
1010,COLORADO SPRINGS 11,3218,FREMONT ELEMENTARY SCHOOL,5TH,2,1,8,7,54,72,18,25%
1010,COLORADO SPRINGS 11,3218,FREMONT ELEMENTARY SCHOOL,SCHOOL TOTAL,9,12,53,67,263,404,141,35%
1010,COLORADO SPRINGS 11,3360,GALILEO SCHOOL OF MATH AND SCIENCE,6TH,12,6,31,57,113,219,106,48%
1010,COLORADO SPRINGS 11,3360,GALILEO SCHOOL OF MATH AND SCIENCE,7TH,7,8,32,74,137,258,121,47%
1010,COLORADO SPRINGS 11,3360,GALILEO SCHOOL OF MATH AND SCIENCE,SCHOOL TOTAL,19,14,63,131,250,477,227,48%
1010,COLORADO SPRINGS 11,3470,GLOBE CHARTER SCHOOL,KINDERGARTEN,2,1,4,7,25,39,14,36%
1010,COLORADO SPRINGS 11,3470,GLOBE CHARTER SCHOOL,1ST,0,2,2,7,23,34,11,32%
1010,COLORADO SPRINGS 11,3470,GLOBE CHARTER SCHOOL,2ND,0,0,1,4,16,21,5,24%
1010,COLORADO SPRINGS 11,3470,GLOBE CHARTER SCHOOL,3RD,0,0,4,4,18,26,8,31%
1010,COLORADO SPRINGS 11,3470,GLOBE CHARTER SCHOOL,4TH,0,0,6,5,14,25,11,44%
1010,COLORADO SPRINGS 11,3470,GLOBE CHARTER SCHOOL,5TH,0,0,4,2,15,21,6,29%
1010,COLORADO SPRINGS 11,3470,GLOBE CHARTER SCHOOL,6TH,0,0,2,1,3,6,3,50%
1010,COLORADO SPRINGS 11,3470,GLOBE CHARTER SCHOOL,SCHOOL TOTAL,2,3,23,30,114,172,58,34%
1010,COLORADO SPRINGS 11,3592,GRANT ELEMENTARY SCHOOL,KINDERGARTEN,2,0,8,19,62,91,29,32%
1010,COLORADO SPRINGS 11,3592,GRANT ELEMENTARY SCHOOL,1ST,0,2,7,21,56,86,30,35%
1010,COLORADO SPRINGS 11,3592,GRANT ELEMENTARY SCHOOL,2ND,3,3,10,19,49,84,35,42%
1010,COLORADO SPRINGS 11,3592,GRANT ELEMENTARY SCHOOL,3RD,2,0,6,16,43,67,24,36%
1010,COLORADO SPRINGS 11,3592,GRANT ELEMENTARY SCHOOL,4TH,1,1,12,12,35,61,26,43%
1010,COLORADO SPRINGS 11,3592,GRANT ELEMENTARY SCHOOL,5TH,2,1,14,21,49,87,38,44%
1010,COLORADO SPRINGS 11,3592,GRANT ELEMENTARY SCHOOL,SCHOOL TOTAL,10,7,57,108,294,476,182,38%
1010,COLORADO SPRINGS 11,3890,HUNT ELEMENTARY SCHOOL,PK,0,0,3,16,10,29,19,66%
1010,COLORADO SPRINGS 11,3890,HUNT ELEMENTARY SCHOOL,KINDERGARTEN,2,0,15,28,19,64,45,70%
1010,COLORADO SPRINGS 11,3890,HUNT ELEMENTARY SCHOOL,1ST,1,0,19,30,11,61,50,82%
1010,COLORADO SPRINGS 11,3890,HUNT ELEMENTARY SCHOOL,2ND,1,0,14,41,18,74,56,76%
1010,COLORADO SPRINGS 11,3890,HUNT ELEMENTARY SCHOOL,3RD,1,1,9,30,22,63,41,65%
1010,COLORADO SPRINGS 11,3890,HUNT ELEMENTARY SCHOOL,4TH,1,1,15,30,23,70,47,67%
1010,COLORADO SPRINGS 11,3890,HUNT ELEMENTARY SCHOOL,5TH,1,1,13,34,18,67,49,73%
1010,COLORADO SPRINGS 11,3890,HUNT ELEMENTARY SCHOOL,SCHOOL TOTAL,7,3,88,209,121,428,307,72%
1010,COLORADO SPRINGS 11,3920,HENRY ELEMENTARY SCHOOL,PK,0,2,2,4,20,28,8,29%
1010,COLORADO SPRINGS 11,3920,HENRY ELEMENTARY SCHOOL,KINDERGARTEN,4,1,5,11,40,61,21,34%
1010,COLORADO SPRINGS 11,3920,HENRY ELEMENTARY SCHOOL,1ST,1,3,6,13,35,58,23,40%
1010,COLORADO SPRINGS 11,3920,HENRY ELEMENTARY SCHOOL,2ND,0,1,8,12,43,64,21,33%
1010,COLORADO SPRINGS 11,3920,HENRY ELEMENTARY SCHOOL,3RD,1,1,9,17,34,62,28,45%
1010,COLORADO SPRINGS 11,3920,HENRY ELEMENTARY SCHOOL,4TH,0,2,2,14,42,60,18,30%
1010,COLORADO SPRINGS 11,3920,HENRY ELEMENTARY SCHOOL,5TH,2,1,5,15,31,54,23,43%
1010,COLORADO SPRINGS 11,3920,HENRY ELEMENTARY SCHOOL,SCHOOL TOTAL,8,11,37,86,245,387,142,37%
1010,COLORADO SPRINGS 11,4070,HOLMES MIDDLE SCHOOL,6TH,1,13,14,41,160,229,69,30%
1010,COLORADO SPRINGS 11,4070,HOLMES MIDDLE SCHOOL,7TH,4,5,11,41,169,230,61,27%
1010,COLORADO SPRINGS 11,4070,HOLMES MIDDLE SCHOOL,8TH,4,12,15,36,198,265,67,25%
1010,COLORADO SPRINGS 11,4070,HOLMES MIDDLE SCHOOL,SCHOOL TOTAL,9,30,40,118,527,724,197,27%
1010,COLORADO SPRINGS 11,4090,MANN MIDDLE SCHOOL,6TH,2,6,19,43,114,184,70,38%
1010,COLORADO SPRINGS 11,4090,MANN MIDDLE SCHOOL,7TH,6,2,21,40,134,203,69,34%
1010,COLORADO SPRINGS 11,4090,MANN MIDDLE SCHOOL,8TH,7,10,26,56,154,253,99,39%
1010,COLORADO SPRINGS 11,4090,MANN MIDDLE SCHOOL,SCHOOL TOTAL,15,18,66,139,402,640,238,37%
1010,COLORADO SPRINGS 11,4138,HOWBERT ELEMENTARY SCHOOL,PK,0,1,1,2,26,30,4,13%
1010,COLORADO SPRINGS 11,4138,HOWBERT ELEMENTARY SCHOOL,KINDERGARTEN,0,3,4,6,42,55,13,24%
1010,COLORADO SPRINGS 11,4138,HOWBERT ELEMENTARY SCHOOL,1ST,0,2,1,5,41,49,8,16%
1010,COLORADO SPRINGS 11,4138,HOWBERT ELEMENTARY SCHOOL,2ND,1,0,0,8,39,48,9,19%
1010,COLORADO SPRINGS 11,4138,HOWBERT ELEMENTARY SCHOOL,3RD,0,1,4,7,32,44,12,27%
1010,COLORADO SPRINGS 11,4138,HOWBERT ELEMENTARY SCHOOL,4TH,0,0,2,3,43,48,5,10%
1010,COLORADO SPRINGS 11,4138,HOWBERT ELEMENTARY SCHOOL,5TH,0,2,3,8,39,52,13,25%
1010,COLORADO SPRINGS 11,4138,HOWBERT ELEMENTARY SCHOOL,SCHOOL TOTAL,1,9,15,39,262,326,64,20%
1010,COLORADO SPRINGS 11,4358,JACKSON ELEMENTARY SCHOOL,PK,0,1,0,3,26,30,4,13%
1010,COLORADO SPRINGS 11,4358,JACKSON ELEMENTARY SCHOOL,KINDERGARTEN,1,2,7,4,29,43,14,33%
1010,COLORADO SPRINGS 11,4358,JACKSON ELEMENTARY SCHOOL,1ST,2,0,6,8,31,47,16,34%
1010,COLORADO SPRINGS 11,4358,JACKSON ELEMENTARY SCHOOL,2ND,1,1,6,21,28,57,29,51%
1010,COLORADO SPRINGS 11,4358,JACKSON ELEMENTARY SCHOOL,3RD,1,0,4,12,29,46,17,37%
1010,COLORADO SPRINGS 11,4358,JACKSON ELEMENTARY SCHOOL,4TH,1,0,4,11,28,44,16,36%
1010,COLORADO SPRINGS 11,4358,JACKSON ELEMENTARY SCHOOL,5TH,1,0,8,22,29,60,31,52%
1010,COLORADO SPRINGS 11,4358,JACKSON ELEMENTARY SCHOOL,SCHOOL TOTAL,7,4,35,81,200,327,127,39%
1010,COLORADO SPRINGS 11,4424,JENKINS MIDDLE SCHOOL,6TH,3,20,24,35,246,328,82,25%
1010,COLORADO SPRINGS 11,4424,JENKINS MIDDLE SCHOOL,7TH,0,14,21,39,220,294,74,25%
1010,COLORADO SPRINGS 11,4424,JENKINS MIDDLE SCHOOL,8TH,4,10,25,40,210,289,79,27%
1010,COLORADO SPRINGS 11,4424,JENKINS MIDDLE SCHOOL,SCHOOL TOTAL,7,44,70,114,676,911,235,26%
1010,COLORADO SPRINGS 11,4530,KELLER ELEMENTARY SCHOOL,PK,0,0,2,6,22,30,8,27%
1010,COLORADO SPRINGS 11,4530,KELLER ELEMENTARY SCHOOL,KINDERGARTEN,1,1,9,22,56,89,33,37%
1010,COLORADO SPRINGS 11,4530,KELLER ELEMENTARY SCHOOL,1ST,1,1,6,25,53,86,33,38%
1010,COLORADO SPRINGS 11,4530,KELLER ELEMENTARY SCHOOL,2ND,1,1,7,22,65,96,31,32%
1010,COLORADO SPRINGS 11,4530,KELLER ELEMENTARY SCHOOL,3RD,2,0,5,15,47,69,22,32%
1010,COLORADO SPRINGS 11,4530,KELLER ELEMENTARY SCHOOL,4TH,1,3,9,25,62,100,38,38%
1010,COLORADO SPRINGS 11,4530,KELLER ELEMENTARY SCHOOL,5TH,0,0,13,21,45,79,34,43%
1010,COLORADO SPRINGS 11,4530,KELLER ELEMENTARY SCHOOL,SCHOOL TOTAL,6,6,51,136,350,549,199,36%
1010,COLORADO SPRINGS 11,5146,LIFE SKILLS CENTER OF COLORADO SPRINGS,9TH,0,0,0,2,0,2,2,100%
1010,COLORADO SPRINGS 11,5146,LIFE SKILLS CENTER OF COLORADO SPRINGS,10TH,0,0,6,8,9,23,14,61%
1010,COLORADO SPRINGS 11,5146,LIFE SKILLS CENTER OF COLORADO SPRINGS,11TH,2,1,14,25,25,67,42,63%
1010,COLORADO SPRINGS 11,5146,LIFE SKILLS CENTER OF COLORADO SPRINGS,12TH,7,10,60,85,88,250,162,65%
1010,COLORADO SPRINGS 11,5146,LIFE SKILLS CENTER OF COLORADO SPRINGS,SCHOOL TOTAL,9,11,80,120,122,342,220,64%
1010,COLORADO SPRINGS 11,5162,LINCOLN ELEMENTARY SCHOOL,KINDERGARTEN,0,2,3,15,20,40,20,50%
1010,COLORADO SPRINGS 11,5162,LINCOLN ELEMENTARY SCHOOL,1ST,1,0,4,15,13,33,20,61%
1010,COLORADO SPRINGS 11,5162,LINCOLN ELEMENTARY SCHOOL,2ND,1,1,1,15,12,30,18,60%
1010,COLORADO SPRINGS 11,5162,LINCOLN ELEMENTARY SCHOOL,3RD,0,3,5,10,13,31,18,58%
1010,COLORADO SPRINGS 11,5162,LINCOLN ELEMENTARY SCHOOL,4TH,2,2,5,10,21,40,19,48%
1010,COLORADO SPRINGS 11,5162,LINCOLN ELEMENTARY SCHOOL,5TH,1,0,3,18,21,43,22,51%
1010,COLORADO SPRINGS 11,5162,LINCOLN ELEMENTARY SCHOOL,SCHOOL TOTAL,5,8,21,83,100,217,117,54%
1010,COLORADO SPRINGS 11,5404,MADISON ELEMENTARY SCHOOL,PK,1,3,1,5,19,29,10,34%
1010,COLORADO SPRINGS 11,5404,MADISON ELEMENTARY SCHOOL,KINDERGARTEN,1,2,8,12,30,53,23,43%
1010,COLORADO SPRINGS 11,5404,MADISON ELEMENTARY SCHOOL,1ST,0,2,5,20,37,64,27,42%
1010,COLORADO SPRINGS 11,5404,MADISON ELEMENTARY SCHOOL,2ND,5,3,6,16,31,61,30,49%
1010,COLORADO SPRINGS 11,5404,MADISON ELEMENTARY SCHOOL,3RD,0,1,10,10,35,56,21,38%
1010,COLORADO SPRINGS 11,5404,MADISON ELEMENTARY SCHOOL,4TH,1,0,11,6,31,49,18,37%
1010,COLORADO SPRINGS 11,5404,MADISON ELEMENTARY SCHOOL,5TH,1,0,10,7,37,55,18,33%
1010,COLORADO SPRINGS 11,5404,MADISON ELEMENTARY SCHOOL,SCHOOL TOTAL,9,11,51,76,220,367,147,40%
1010,COLORADO SPRINGS 11,5576,TWAIN ELEMENTARY SCHOOL,PK,0,0,4,8,19,31,12,39%
1010,COLORADO SPRINGS 11,5576,TWAIN ELEMENTARY SCHOOL,KINDERGARTEN,2,0,8,24,37,71,34,48%
1010,COLORADO SPRINGS 11,5576,TWAIN ELEMENTARY SCHOOL,1ST,2,0,14,21,47,84,37,44%
1010,COLORADO SPRINGS 11,5576,TWAIN ELEMENTARY SCHOOL,2ND,3,1,11,22,44,81,37,46%
1010,COLORADO SPRINGS 11,5576,TWAIN ELEMENTARY SCHOOL,3RD,3,1,14,15,43,76,33,43%
1010,COLORADO SPRINGS 11,5576,TWAIN ELEMENTARY SCHOOL,4TH,1,2,7,21,47,78,31,40%
1010,COLORADO SPRINGS 11,5576,TWAIN ELEMENTARY SCHOOL,5TH,0,2,16,19,36,73,37,51%
1010,COLORADO SPRINGS 11,5576,TWAIN ELEMENTARY SCHOOL,SCHOOL TOTAL,11,6,74,130,273,494,221,45%
1010,COLORADO SPRINGS 11,5604,KING ELEMENTARY SCHOOL,PK,2,1,3,11,13,30,17,57%
1010,COLORADO SPRINGS 11,5604,KING ELEMENTARY SCHOOL,KINDERGARTEN,1,6,8,9,41,65,24,37%
1010,COLORADO SPRINGS 11,5604,KING ELEMENTARY SCHOOL,1ST,0,1,11,8,46,66,20,30%
1010,COLORADO SPRINGS 11,5604,KING ELEMENTARY SCHOOL,2ND,1,3,7,5,46,62,16,26%
1010,COLORADO SPRINGS 11,5604,KING ELEMENTARY SCHOOL,3RD,1,2,7,10,35,55,20,36%
1010,COLORADO SPRINGS 11,5604,KING ELEMENTARY SCHOOL,4TH,1,2,9,5,63,80,17,21%
1010,COLORADO SPRINGS 11,5604,KING ELEMENTARY SCHOOL,5TH,1,1,6,10,45,63,18,29%
1010,COLORADO SPRINGS 11,5604,KING ELEMENTARY SCHOOL,SCHOOL TOTAL,7,16,51,58,289,421,132,31%
1010,COLORADO SPRINGS 11,5610,MARTINEZ ELEMENTARY SCHOOL,PK,1,2,3,9,16,31,15,48%
1010,COLORADO SPRINGS 11,5610,MARTINEZ ELEMENTARY SCHOOL,KINDERGARTEN,4,10,14,14,69,111,42,38%
1010,COLORADO SPRINGS 11,5610,MARTINEZ ELEMENTARY SCHOOL,1ST,2,6,7,18,72,105,33,31%
1010,COLORADO SPRINGS 11,5610,MARTINEZ ELEMENTARY SCHOOL,2ND,2,9,10,19,61,101,40,40%
1010,COLORADO SPRINGS 11,5610,MARTINEZ ELEMENTARY SCHOOL,3RD,1,4,6,13,68,92,24,26%
1010,COLORADO SPRINGS 11,5610,MARTINEZ ELEMENTARY SCHOOL,4TH,1,3,9,11,88,112,24,21%
1010,COLORADO SPRINGS 11,5610,MARTINEZ ELEMENTARY SCHOOL,5TH,1,5,8,17,71,102,31,30%
1010,COLORADO SPRINGS 11,5610,MARTINEZ ELEMENTARY SCHOOL,SCHOOL TOTAL,12,39,57,101,445,654,209,32%
1010,COLORADO SPRINGS 11,5878,MIDLAND ELEMENTARY SCHOOL,KINDERGARTEN,0,0,4,9,23,36,13,36%
1010,COLORADO SPRINGS 11,5878,MIDLAND ELEMENTARY SCHOOL,1ST,1,0,3,7,22,33,11,33%
1010,COLORADO SPRINGS 11,5878,MIDLAND ELEMENTARY SCHOOL,2ND,2,0,1,8,20,31,11,35%
1010,COLORADO SPRINGS 11,5878,MIDLAND ELEMENTARY SCHOOL,3RD,0,2,0,8,13,23,10,43%
1010,COLORADO SPRINGS 11,5878,MIDLAND ELEMENTARY SCHOOL,4TH,0,3,2,10,9,24,15,63%
1010,COLORADO SPRINGS 11,5878,MIDLAND ELEMENTARY SCHOOL,5TH,1,1,1,12,22,37,15,41%
1010,COLORADO SPRINGS 11,5878,MIDLAND ELEMENTARY SCHOOL,SCHOOL TOTAL,4,6,11,54,109,184,75,41%
1010,COLORADO SPRINGS 11,5948,MITCHELL HIGH SCHOOL,9TH,7,5,33,106,108,259,151,58%
1010,COLORADO SPRINGS 11,5948,MITCHELL HIGH SCHOOL,10TH,2,10,32,88,131,263,132,50%
1010,COLORADO SPRINGS 11,5948,MITCHELL HIGH SCHOOL,11TH,11,7,47,87,93,245,152,62%
1010,COLORADO SPRINGS 11,5948,MITCHELL HIGH SCHOOL,12TH,2,11,46,94,195,348,153,44%
1010,COLORADO SPRINGS 11,5948,MITCHELL HIGH SCHOOL,SCHOOL TOTAL,22,33,158,375,527,1115,588,53%
1010,COLORADO SPRINGS 11,5988,MONROE ELEMENTARY SCHOOL,PK,0,1,4,16,6,27,21,78%
1010,COLORADO SPRINGS 11,5988,MONROE ELEMENTARY SCHOOL,KINDERGARTEN,0,1,16,51,18,86,68,79%
1010,COLORADO SPRINGS 11,5988,MONROE ELEMENTARY SCHOOL,1ST,2,2,5,53,10,72,62,86%
1010,COLORADO SPRINGS 11,5988,MONROE ELEMENTARY SCHOOL,2ND,1,1,8,41,11,62,51,82%
1010,COLORADO SPRINGS 11,5988,MONROE ELEMENTARY SCHOOL,3RD,2,0,7,44,7,60,53,88%
1010,COLORADO SPRINGS 11,5988,MONROE ELEMENTARY SCHOOL,4TH,2,2,8,39,11,62,51,82%
1010,COLORADO SPRINGS 11,5988,MONROE ELEMENTARY SCHOOL,5TH,2,2,6,30,13,53,40,75%
1010,COLORADO SPRINGS 11,5988,MONROE ELEMENTARY SCHOOL,SCHOOL TOTAL,9,9,54,274,76,422,346,82%
1010,COLORADO SPRINGS 11,6306,NORTH MIDDLE SCHOOL,6TH,4,2,20,50,146,222,76,34%
1010,COLORADO SPRINGS 11,6306,NORTH MIDDLE SCHOOL,7TH,4,9,20,51,118,202,84,42%
1010,COLORADO SPRINGS 11,6306,NORTH MIDDLE SCHOOL,8TH,9,7,35,56,167,274,107,39%
1010,COLORADO SPRINGS 11,6306,NORTH MIDDLE SCHOOL,SCHOOL TOTAL,17,18,75,157,431,698,267,38%
1010,COLORADO SPRINGS 11,6680,PALMER HIGH SCHOOL,9TH,7,15,47,113,331,513,182,35%
1010,COLORADO SPRINGS 11,6680,PALMER HIGH SCHOOL,10TH,6,14,59,99,351,529,178,34%
1010,COLORADO SPRINGS 11,6680,PALMER HIGH SCHOOL,11TH,16,16,38,77,340,487,147,30%
1010,COLORADO SPRINGS 11,6680,PALMER HIGH SCHOOL,12TH,8,16,52,81,383,540,157,29%
1010,COLORADO SPRINGS 11,6680,PALMER HIGH SCHOOL,SCHOOL TOTAL,37,61,196,370,1405,2069,664,32%
1010,COLORADO SPRINGS 11,6856,PENROSE ELEMENTARY SCHOOL,PK,0,0,4,9,15,28,13,46%
1010,COLORADO SPRINGS 11,6856,PENROSE ELEMENTARY SCHOOL,KINDERGARTEN,0,5,12,18,43,78,35,45%
1010,COLORADO SPRINGS 11,6856,PENROSE ELEMENTARY SCHOOL,1ST,1,1,5,14,44,65,21,32%
1010,COLORADO SPRINGS 11,6856,PENROSE ELEMENTARY SCHOOL,2ND,2,2,10,11,47,72,25,35%
1010,COLORADO SPRINGS 11,6856,PENROSE ELEMENTARY SCHOOL,3RD,0,1,7,13,33,54,21,39%
1010,COLORADO SPRINGS 11,6856,PENROSE ELEMENTARY SCHOOL,4TH,1,1,3,12,46,63,17,27%
1010,COLORADO SPRINGS 11,6856,PENROSE ELEMENTARY SCHOOL,5TH,1,2,9,14,35,61,26,43%
1010,COLORADO SPRINGS 11,6856,PENROSE ELEMENTARY SCHOOL,SCHOOL TOTAL,5,12,50,91,263,421,158,38%
1010,COLORADO SPRINGS 11,7228,QUEEN PALMER ELEMENTARY SCHOOL,KINDERGARTEN,1,1,11,14,20,47,27,57%
1010,COLORADO SPRINGS 11,7228,QUEEN PALMER ELEMENTARY SCHOOL,1ST,1,0,11,14,16,42,26,62%
1010,COLORADO SPRINGS 11,7228,QUEEN PALMER ELEMENTARY SCHOOL,2ND,0,1,9,9,16,35,19,54%
1010,COLORADO SPRINGS 11,7228,QUEEN PALMER ELEMENTARY SCHOOL,3RD,0,0,5,14,14,33,19,58%
1010,COLORADO SPRINGS 11,7228,QUEEN PALMER ELEMENTARY SCHOOL,4TH,0,1,8,13,13,35,22,63%
1010,COLORADO SPRINGS 11,7228,QUEEN PALMER ELEMENTARY SCHOOL,5TH,0,0,6,13,18,37,19,51%
1010,COLORADO SPRINGS 11,7228,QUEEN PALMER ELEMENTARY SCHOOL,SCHOOL TOTAL,2,3,50,77,97,229,132,58%
1010,COLORADO SPRINGS 11,7482,ROOSEVELT EDISON CHARTER SCHOOL,KINDERGARTEN,2,1,9,69,31,112,81,72%
1010,COLORADO SPRINGS 11,7482,ROOSEVELT EDISON CHARTER SCHOOL,1ST,1,2,15,76,27,121,94,78%
1010,COLORADO SPRINGS 11,7482,ROOSEVELT EDISON CHARTER SCHOOL,2ND,3,4,15,89,27,138,111,80%
1010,COLORADO SPRINGS 11,7482,ROOSEVELT EDISON CHARTER SCHOOL,3RD,1,2,13,80,27,123,96,78%
1010,COLORADO SPRINGS 11,7482,ROOSEVELT EDISON CHARTER SCHOOL,4TH,3,2,16,75,23,119,96,81%
1010,COLORADO SPRINGS 11,7482,ROOSEVELT EDISON CHARTER SCHOOL,5TH,0,1,9,51,29,90,61,68%
1010,COLORADO SPRINGS 11,7482,ROOSEVELT EDISON CHARTER SCHOOL,SCHOOL TOTAL,10,12,77,440,164,703,539,77%
1010,COLORADO SPRINGS 11,7513,RUDY ELEMENTARY SCHOOL,PK,0,1,2,5,22,30,8,27%
1010,COLORADO SPRINGS 11,7513,RUDY ELEMENTARY SCHOOL,KINDERGARTEN,1,1,8,11,43,64,21,33%
1010,COLORADO SPRINGS 11,7513,RUDY ELEMENTARY SCHOOL,1ST,1,0,5,5,61,72,11,15%
1010,COLORADO SPRINGS 11,7513,RUDY ELEMENTARY SCHOOL,2ND,1,2,15,7,49,74,25,34%
1010,COLORADO SPRINGS 11,7513,RUDY ELEMENTARY SCHOOL,3RD,2,2,9,4,42,59,17,29%
1010,COLORADO SPRINGS 11,7513,RUDY ELEMENTARY SCHOOL,4TH,4,1,11,15,31,62,31,50%
1010,COLORADO SPRINGS 11,7513,RUDY ELEMENTARY SCHOOL,5TH,1,3,2,4,41,51,10,20%
1010,COLORADO SPRINGS 11,7513,RUDY ELEMENTARY SCHOOL,SCHOOL TOTAL,10,10,52,51,289,412,123,30%
1010,COLORADO SPRINGS 11,7523,RUSSELL MIDDLE SCHOOL,6TH,5,7,31,51,154,248,94,38%
1010,COLORADO SPRINGS 11,7523,RUSSELL MIDDLE SCHOOL,7TH,8,12,33,55,178,286,108,38%
1010,COLORADO SPRINGS 11,7523,RUSSELL MIDDLE SCHOOL,8TH,7,9,31,57,190,294,104,35%
1010,COLORADO SPRINGS 11,7523,RUSSELL MIDDLE SCHOOL,SCHOOL TOTAL,20,28,95,163,522,828,306,37%
1010,COLORADO SPRINGS 11,7556,SABIN MIDDLE SCHOOL,6TH,5,7,50,53,169,284,115,40%
1010,COLORADO SPRINGS 11,7556,SABIN MIDDLE SCHOOL,7TH,2,6,34,58,188,288,100,35%
1010,COLORADO SPRINGS 11,7556,SABIN MIDDLE SCHOOL,8TH,8,12,52,76,225,373,148,40%
1010,COLORADO SPRINGS 11,7556,SABIN MIDDLE SCHOOL,SCHOOL TOTAL,15,25,136,187,582,945,363,38%
1010,COLORADO SPRINGS 11,7705,SCOTT ELEMENTARY SCHOOL,PK,0,1,2,5,20,28,8,29%
1010,COLORADO SPRINGS 11,7705,SCOTT ELEMENTARY SCHOOL,KINDERGARTEN,1,5,10,18,78,112,34,30%
1010,COLORADO SPRINGS 11,7705,SCOTT ELEMENTARY SCHOOL,1ST,1,3,16,20,78,118,40,34%
1010,COLORADO SPRINGS 11,7705,SCOTT ELEMENTARY SCHOOL,2ND,0,6,2,17,81,106,25,24%
1010,COLORADO SPRINGS 11,7705,SCOTT ELEMENTARY SCHOOL,3RD,0,6,15,17,75,113,38,34%
1010,COLORADO SPRINGS 11,7705,SCOTT ELEMENTARY SCHOOL,4TH,1,2,13,8,78,102,24,24%
1010,COLORADO SPRINGS 11,7705,SCOTT ELEMENTARY SCHOOL,5TH,1,5,5,9,75,95,20,21%
1010,COLORADO SPRINGS 11,7705,SCOTT ELEMENTARY SCHOOL,SCHOOL TOTAL,4,28,63,94,485,674,189,28%
1010,COLORADO SPRINGS 11,8246,STEELE ELEMENTARY SCHOOL,KINDERGARTEN,0,1,2,5,23,31,8,26%
1010,COLORADO SPRINGS 11,8246,STEELE ELEMENTARY SCHOOL,1ST,0,1,0,0,49,50,1,2%
1010,COLORADO SPRINGS 11,8246,STEELE ELEMENTARY SCHOOL,2ND,1,2,0,2,42,47,5,11%
1010,COLORADO SPRINGS 11,8246,STEELE ELEMENTARY SCHOOL,3RD,0,0,0,1,43,44,1,2%
1010,COLORADO SPRINGS 11,8246,STEELE ELEMENTARY SCHOOL,4TH,1,1,0,0,48,50,2,4%
1010,COLORADO SPRINGS 11,8246,STEELE ELEMENTARY SCHOOL,5TH,0,5,0,2,38,45,7,16%
1010,COLORADO SPRINGS 11,8246,STEELE ELEMENTARY SCHOOL,SCHOOL TOTAL,2,10,2,10,243,267,24,9%
1010,COLORADO SPRINGS 11,8346,STRATTON ELEMENTARY SCHOOL,PK,0,1,5,1,21,28,7,25%
1010,COLORADO SPRINGS 11,8346,STRATTON ELEMENTARY SCHOOL,KINDERGARTEN,3,1,1,7,32,44,12,27%
1010,COLORADO SPRINGS 11,8346,STRATTON ELEMENTARY SCHOOL,1ST,1,1,2,4,47,55,8,15%
1010,COLORADO SPRINGS 11,8346,STRATTON ELEMENTARY SCHOOL,2ND,1,0,0,6,34,41,7,17%
1010,COLORADO SPRINGS 11,8346,STRATTON ELEMENTARY SCHOOL,3RD,0,0,2,7,39,48,9,19%
1010,COLORADO SPRINGS 11,8346,STRATTON ELEMENTARY SCHOOL,4TH,0,2,3,8,50,63,13,21%
1010,COLORADO SPRINGS 11,8346,STRATTON ELEMENTARY SCHOOL,5TH,1,1,5,10,58,75,17,23%
1010,COLORADO SPRINGS 11,8346,STRATTON ELEMENTARY SCHOOL,SCHOOL TOTAL,6,6,18,43,281,354,73,21%
1010,COLORADO SPRINGS 11,8359,SPACE TECHNOLOGY AND ARTS ACADEMY (STAR ACADEMY),KINDERGARTEN,0,3,21,25,31,80,49,61%
1010,COLORADO SPRINGS 11,8359,SPACE TECHNOLOGY AND ARTS ACADEMY (STAR ACADEMY),1ST,1,0,19,19,36,75,39,52%
1010,COLORADO SPRINGS 11,8359,SPACE TECHNOLOGY AND ARTS ACADEMY (STAR ACADEMY),2ND,0,3,17,15,27,62,35,56%
1010,COLORADO SPRINGS 11,8359,SPACE TECHNOLOGY AND ARTS ACADEMY (STAR ACADEMY),3RD,2,1,12,19,21,55,34,62%
1010,COLORADO SPRINGS 11,8359,SPACE TECHNOLOGY AND ARTS ACADEMY (STAR ACADEMY),4TH,1,0,4,15,5,25,20,80%
1010,COLORADO SPRINGS 11,8359,SPACE TECHNOLOGY AND ARTS ACADEMY (STAR ACADEMY),5TH,1,0,4,4,15,24,9,38%
1010,COLORADO SPRINGS 11,8359,SPACE TECHNOLOGY AND ARTS ACADEMY (STAR ACADEMY),6TH,0,0,8,5,7,20,13,65%
1010,COLORADO SPRINGS 11,8359,SPACE TECHNOLOGY AND ARTS ACADEMY (STAR ACADEMY),7TH,0,1,3,4,4,12,8,67%
1010,COLORADO SPRINGS 11,8359,SPACE TECHNOLOGY AND ARTS ACADEMY (STAR ACADEMY),SCHOOL TOTAL,5,8,88,106,146,353,207,59%
1010,COLORADO SPRINGS 11,8457,JACK SWIGERT AEROSPACE ACADEMY,6TH,3,2,31,98,74,208,134,64%
1010,COLORADO SPRINGS 11,8457,JACK SWIGERT AEROSPACE ACADEMY,7TH,1,3,25,111,34,174,140,80%
1010,COLORADO SPRINGS 11,8457,JACK SWIGERT AEROSPACE ACADEMY,8TH,2,2,22,89,46,161,115,71%
1010,COLORADO SPRINGS 11,8457,JACK SWIGERT AEROSPACE ACADEMY,SCHOOL TOTAL,6,7,78,298,154,543,389,72%
1010,COLORADO SPRINGS 11,8466,TAYLOR ELEMENTARY SCHOOL,KINDERGARTEN,0,3,1,4,40,48,8,17%
1010,COLORADO SPRINGS 11,8466,TAYLOR ELEMENTARY SCHOOL,1ST,0,2,2,9,42,55,13,24%
1010,COLORADO SPRINGS 11,8466,TAYLOR ELEMENTARY SCHOOL,2ND,0,1,1,12,39,53,14,26%
1010,COLORADO SPRINGS 11,8466,TAYLOR ELEMENTARY SCHOOL,3RD,1,0,2,6,40,49,9,18%
1010,COLORADO SPRINGS 11,8466,TAYLOR ELEMENTARY SCHOOL,4TH,0,0,4,7,40,51,11,22%
1010,COLORADO SPRINGS 11,8466,TAYLOR ELEMENTARY SCHOOL,5TH,2,0,2,8,36,48,12,25%
1010,COLORADO SPRINGS 11,8466,TAYLOR ELEMENTARY SCHOOL,SCHOOL TOTAL,3,6,12,46,237,304,67,22%
1010,COLORADO SPRINGS 11,8902,TRAILBLAZER ELEMENTARY SCHOOL,KINDERGARTEN,0,3,1,6,64,74,10,14%
1010,COLORADO SPRINGS 11,8902,TRAILBLAZER ELEMENTARY SCHOOL,1ST,0,4,7,5,45,61,16,26%
1010,COLORADO SPRINGS 11,8902,TRAILBLAZER ELEMENTARY SCHOOL,2ND,1,3,5,8,38,55,17,31%
1010,COLORADO SPRINGS 11,8902,TRAILBLAZER ELEMENTARY SCHOOL,3RD,0,1,5,7,49,62,13,21%
1010,COLORADO SPRINGS 11,8902,TRAILBLAZER ELEMENTARY SCHOOL,4TH,1,4,4,11,51,71,20,28%
1010,COLORADO SPRINGS 11,8902,TRAILBLAZER ELEMENTARY SCHOOL,5TH,1,1,3,7,47,59,12,20%
1010,COLORADO SPRINGS 11,8902,TRAILBLAZER ELEMENTARY SCHOOL,SCHOOL TOTAL,3,16,25,44,294,382,88,23%
1010,COLORADO SPRINGS 11,9298,WASSON HIGH SCHOOL,9TH,2,15,52,73,131,273,142,52%
1010,COLORADO SPRINGS 11,9298,WASSON HIGH SCHOOL,10TH,3,8,55,91,128,285,157,55%
1010,COLORADO SPRINGS 11,9298,WASSON HIGH SCHOOL,11TH,2,8,34,70,141,255,114,45%
1010,COLORADO SPRINGS 11,9298,WASSON HIGH SCHOOL,12TH,3,14,59,81,169,326,157,48%
1010,COLORADO SPRINGS 11,9298,WASSON HIGH SCHOOL,SCHOOL TOTAL,10,45,200,315,569,1139,570,50%
1010,COLORADO SPRINGS 11,9404,WEST INTERGENERATIONAL CENTER,6TH,4,1,7,22,57,91,34,37%
1010,COLORADO SPRINGS 11,9404,WEST INTERGENERATIONAL CENTER,7TH,0,3,7,26,55,91,36,40%
1010,COLORADO SPRINGS 11,9404,WEST INTERGENERATIONAL CENTER,8TH,1,3,8,26,67,105,38,36%
1010,COLORADO SPRINGS 11,9404,WEST INTERGENERATIONAL CENTER,SCHOOL TOTAL,5,7,22,74,179,287,108,38%
1010,COLORADO SPRINGS 11,9445,WEST ELEMENTARY SCHOOL,PK,1,0,2,5,22,30,8,27%
1010,COLORADO SPRINGS 11,9445,WEST ELEMENTARY SCHOOL,KINDERGARTEN,1,2,3,12,33,51,18,35%
1010,COLORADO SPRINGS 11,9445,WEST ELEMENTARY SCHOOL,1ST,0,0,1,9,33,43,10,23%
1010,COLORADO SPRINGS 11,9445,WEST ELEMENTARY SCHOOL,2ND,2,1,5,11,28,47,19,40%
1010,COLORADO SPRINGS 11,9445,WEST ELEMENTARY SCHOOL,3RD,1,1,1,16,28,47,19,40%
1010,COLORADO SPRINGS 11,9445,WEST ELEMENTARY SCHOOL,4TH,2,1,6,22,32,63,31,49%
1010,COLORADO SPRINGS 11,9445,WEST ELEMENTARY SCHOOL,5TH,1,1,4,13,41,60,19,32%
1010,COLORADO SPRINGS 11,9445,WEST ELEMENTARY SCHOOL,SCHOOL TOTAL,8,6,22,88,217,341,124,36%
1010,COLORADO SPRINGS 11,9618,ROGERS ELEMENTARY SCHOOL,KINDERGARTEN,0,1,3,16,24,44,20,45%
1010,COLORADO SPRINGS 11,9618,ROGERS ELEMENTARY SCHOOL,1ST,1,1,6,12,23,43,20,47%
1010,COLORADO SPRINGS 11,9618,ROGERS ELEMENTARY SCHOOL,2ND,0,2,4,16,14,36,22,61%
1010,COLORADO SPRINGS 11,9618,ROGERS ELEMENTARY SCHOOL,3RD,3,3,6,24,28,64,36,56%
1010,COLORADO SPRINGS 11,9618,ROGERS ELEMENTARY SCHOOL,4TH,3,4,5,10,18,40,22,55%
1010,COLORADO SPRINGS 11,9618,ROGERS ELEMENTARY SCHOOL,5TH,0,1,6,23,20,50,30,60%
1010,COLORADO SPRINGS 11,9618,ROGERS ELEMENTARY SCHOOL,SCHOOL TOTAL,7,12,30,101,127,277,150,54%
1010,COLORADO SPRINGS 11,9660,WILSON ELEMENTARY SCHOOL,KINDERGARTEN,1,1,12,41,27,82,55,67%
1010,COLORADO SPRINGS 11,9660,WILSON ELEMENTARY SCHOOL,1ST,1,4,15,36,23,79,56,71%
1010,COLORADO SPRINGS 11,9660,WILSON ELEMENTARY SCHOOL,2ND,0,4,14,32,21,71,50,70%
1010,COLORADO SPRINGS 11,9660,WILSON ELEMENTARY SCHOOL,3RD,0,6,20,24,15,65,50,77%
1010,COLORADO SPRINGS 11,9660,WILSON ELEMENTARY SCHOOL,4TH,2,1,13,27,18,61,43,70%
1010,COLORADO SPRINGS 11,9660,WILSON ELEMENTARY SCHOOL,5TH,2,2,11,29,22,66,44,67%
1010,COLORADO SPRINGS 11,9660,WILSON ELEMENTARY SCHOOL,SCHOOL TOTAL,6,18,85,189,126,424,298,70%
1010,COLORADO SPRINGS 11,,DISTRICT TOTAL,,494,905,3234,6930,18078,29641,11563,39%
1020,CHEYENNE MOUNTAIN 12,1582,CHEYENNE MOUNTAIN CHARTER ACADEMY,HALF DAY K,2,3,5,17,49,76,27,36%
1020,CHEYENNE MOUNTAIN 12,1582,CHEYENNE MOUNTAIN CHARTER ACADEMY,KINDERGARTEN,0,5,6,6,23,40,17,43%
1020,CHEYENNE MOUNTAIN 12,1582,CHEYENNE MOUNTAIN CHARTER ACADEMY,1ST,1,5,10,15,75,106,31,29%
1020,CHEYENNE MOUNTAIN 12,1582,CHEYENNE MOUNTAIN CHARTER ACADEMY,2ND,0,7,5,22,74,108,34,31%
1020,CHEYENNE MOUNTAIN 12,1582,CHEYENNE MOUNTAIN CHARTER ACADEMY,3RD,0,12,8,17,71,108,37,34%
1020,CHEYENNE MOUNTAIN 12,1582,CHEYENNE MOUNTAIN CHARTER ACADEMY,4TH,2,8,10,19,70,109,39,36%
1020,CHEYENNE MOUNTAIN 12,1582,CHEYENNE MOUNTAIN CHARTER ACADEMY,5TH,0,9,13,24,54,100,46,46%
1020,CHEYENNE MOUNTAIN 12,1582,CHEYENNE MOUNTAIN CHARTER ACADEMY,6TH,1,6,8,15,70,100,30,30%
1020,CHEYENNE MOUNTAIN 12,1582,CHEYENNE MOUNTAIN CHARTER ACADEMY,SCHOOL TOTAL,6,55,65,135,486,747,261,35%
1020,CHEYENNE MOUNTAIN 12,1586,CHEYENNE MOUNTAIN ELEMENTARY SCHOOL,HALF DAY K,0,1,0,1,13,15,2,13%
1020,CHEYENNE MOUNTAIN 12,1586,CHEYENNE MOUNTAIN ELEMENTARY SCHOOL,KINDERGARTEN,0,2,0,2,21,25,4,16%
1020,CHEYENNE MOUNTAIN 12,1586,CHEYENNE MOUNTAIN ELEMENTARY SCHOOL,1ST,0,2,0,4,38,44,6,14%
1020,CHEYENNE MOUNTAIN 12,1586,CHEYENNE MOUNTAIN ELEMENTARY SCHOOL,2ND,0,1,0,2,43,46,3,7%
1020,CHEYENNE MOUNTAIN 12,1586,CHEYENNE MOUNTAIN ELEMENTARY SCHOOL,3RD,0,4,1,1,39,45,6,13%
1020,CHEYENNE MOUNTAIN 12,1586,CHEYENNE MOUNTAIN ELEMENTARY SCHOOL,4TH,0,4,1,3,37,45,8,18%
1020,CHEYENNE MOUNTAIN 12,1586,CHEYENNE MOUNTAIN ELEMENTARY SCHOOL,5TH,0,1,1,3,48,53,5,9%
1020,CHEYENNE MOUNTAIN 12,1586,CHEYENNE MOUNTAIN ELEMENTARY SCHOOL,6TH,0,0,2,5,47,54,7,13%
1020,CHEYENNE MOUNTAIN 12,1586,CHEYENNE MOUNTAIN ELEMENTARY SCHOOL,SCHOOL TOTAL,0,15,5,21,286,327,41,13%
1020,CHEYENNE MOUNTAIN 12,1588,CHEYENNE MOUNTAIN JUNIOR HIGH SCHOOL,7TH,3,12,7,38,251,311,60,19%
1020,CHEYENNE MOUNTAIN 12,1588,CHEYENNE MOUNTAIN JUNIOR HIGH SCHOOL,8TH,4,17,3,33,244,301,57,19%
1020,CHEYENNE MOUNTAIN 12,1588,CHEYENNE MOUNTAIN JUNIOR HIGH SCHOOL,SCHOOL TOTAL,7,29,10,71,495,612,117,19%
1020,CHEYENNE MOUNTAIN 12,1590,CHEYENNE MOUNTAIN HIGH SCHOOL,9TH,1,14,20,38,260,333,73,22%
1020,CHEYENNE MOUNTAIN 12,1590,CHEYENNE MOUNTAIN HIGH SCHOOL,10TH,6,13,9,36,265,329,64,19%
1020,CHEYENNE MOUNTAIN 12,1590,CHEYENNE MOUNTAIN HIGH SCHOOL,11TH,4,19,9,40,280,352,72,20%
1020,CHEYENNE MOUNTAIN 12,1590,CHEYENNE MOUNTAIN HIGH SCHOOL,12TH,4,26,8,27,278,343,65,19%
1020,CHEYENNE MOUNTAIN 12,1590,CHEYENNE MOUNTAIN HIGH SCHOOL,SCHOOL TOTAL,15,72,46,141,1083,1357,274,20%
1020,CHEYENNE MOUNTAIN 12,1592,BROADMOOR ELEMENTARY SCHOOL,HALF DAY K,0,1,0,1,13,15,2,13%
1020,CHEYENNE MOUNTAIN 12,1592,BROADMOOR ELEMENTARY SCHOOL,KINDERGARTEN,1,1,0,4,25,31,6,19%
1020,CHEYENNE MOUNTAIN 12,1592,BROADMOOR ELEMENTARY SCHOOL,1ST,2,0,1,5,30,38,8,21%
1020,CHEYENNE MOUNTAIN 12,1592,BROADMOOR ELEMENTARY SCHOOL,2ND,0,2,1,5,37,45,8,18%
1020,CHEYENNE MOUNTAIN 12,1592,BROADMOOR ELEMENTARY SCHOOL,3RD,3,1,1,8,34,47,13,28%
1020,CHEYENNE MOUNTAIN 12,1592,BROADMOOR ELEMENTARY SCHOOL,4TH,1,2,0,5,40,48,8,17%
1020,CHEYENNE MOUNTAIN 12,1592,BROADMOOR ELEMENTARY SCHOOL,5TH,0,0,2,3,45,50,5,10%
1020,CHEYENNE MOUNTAIN 12,1592,BROADMOOR ELEMENTARY SCHOOL,6TH,1,2,2,4,43,52,9,17%
1020,CHEYENNE MOUNTAIN 12,1592,BROADMOOR ELEMENTARY SCHOOL,SCHOOL TOTAL,8,9,7,35,267,326,59,18%
1020,CHEYENNE MOUNTAIN 12,1596,CANON ELEMENTARY SCHOOL,PK,1,4,0,8,57,70,13,19%
1020,CHEYENNE MOUNTAIN 12,1596,CANON ELEMENTARY SCHOOL,SCHOOL TOTAL,1,4,0,8,57,70,13,19%
1020,CHEYENNE MOUNTAIN 12,1604,SKYWAY PARK ELEMENTARY SCHOOL,HALF DAY K,0,0,2,6,12,20,8,40%
1020,CHEYENNE MOUNTAIN 12,1604,SKYWAY PARK ELEMENTARY SCHOOL,KINDERGARTEN,0,1,0,4,18,23,5,22%
1020,CHEYENNE MOUNTAIN 12,1604,SKYWAY PARK ELEMENTARY SCHOOL,1ST,1,0,3,6,30,40,10,25%
1020,CHEYENNE MOUNTAIN 12,1604,SKYWAY PARK ELEMENTARY SCHOOL,2ND,0,0,2,5,35,42,7,17%
1020,CHEYENNE MOUNTAIN 12,1604,SKYWAY PARK ELEMENTARY SCHOOL,3RD,0,1,0,2,36,39,3,8%
1020,CHEYENNE MOUNTAIN 12,1604,SKYWAY PARK ELEMENTARY SCHOOL,4TH,0,1,0,6,42,49,7,14%
1020,CHEYENNE MOUNTAIN 12,1604,SKYWAY PARK ELEMENTARY SCHOOL,5TH,1,1,1,7,39,49,10,20%
1020,CHEYENNE MOUNTAIN 12,1604,SKYWAY PARK ELEMENTARY SCHOOL,6TH,0,0,5,8,42,55,13,24%
1020,CHEYENNE MOUNTAIN 12,1604,SKYWAY PARK ELEMENTARY SCHOOL,SCHOOL TOTAL,2,4,13,44,254,317,63,20%
1020,CHEYENNE MOUNTAIN 12,3482,GOLD CAMP ELEMENTARY SCHOOL,HALF DAY K,0,2,0,1,18,21,3,14%
1020,CHEYENNE MOUNTAIN 12,3482,GOLD CAMP ELEMENTARY SCHOOL,KINDERGARTEN,0,2,0,3,34,39,5,13%
1020,CHEYENNE MOUNTAIN 12,3482,GOLD CAMP ELEMENTARY SCHOOL,1ST,0,4,3,5,45,57,12,21%
1020,CHEYENNE MOUNTAIN 12,3482,GOLD CAMP ELEMENTARY SCHOOL,2ND,1,4,0,6,52,63,11,17%
1020,CHEYENNE MOUNTAIN 12,3482,GOLD CAMP ELEMENTARY SCHOOL,3RD,2,4,1,2,57,66,9,14%
1020,CHEYENNE MOUNTAIN 12,3482,GOLD CAMP ELEMENTARY SCHOOL,4TH,2,2,0,7,66,77,11,14%
1020,CHEYENNE MOUNTAIN 12,3482,GOLD CAMP ELEMENTARY SCHOOL,5TH,1,3,1,5,62,72,10,14%
1020,CHEYENNE MOUNTAIN 12,3482,GOLD CAMP ELEMENTARY SCHOOL,6TH,3,3,2,8,63,79,16,20%
1020,CHEYENNE MOUNTAIN 12,3482,GOLD CAMP ELEMENTARY SCHOOL,SCHOOL TOTAL,9,24,7,37,397,474,77,16%
1020,CHEYENNE MOUNTAIN 12,6953,PINON VALLEY ELEMENTARY SCHOOL,HALF DAY K,0,1,0,1,9,11,2,18%
1020,CHEYENNE MOUNTAIN 12,6953,PINON VALLEY ELEMENTARY SCHOOL,KINDERGARTEN,0,1,0,3,25,29,4,14%
1020,CHEYENNE MOUNTAIN 12,6953,PINON VALLEY ELEMENTARY SCHOOL,1ST,0,4,1,4,35,44,9,20%
1020,CHEYENNE MOUNTAIN 12,6953,PINON VALLEY ELEMENTARY SCHOOL,2ND,1,3,2,4,34,44,10,23%
1020,CHEYENNE MOUNTAIN 12,6953,PINON VALLEY ELEMENTARY SCHOOL,3RD,1,5,0,7,35,48,13,27%
1020,CHEYENNE MOUNTAIN 12,6953,PINON VALLEY ELEMENTARY SCHOOL,4TH,1,4,1,9,37,52,15,29%
1020,CHEYENNE MOUNTAIN 12,6953,PINON VALLEY ELEMENTARY SCHOOL,5TH,0,10,2,9,28,49,21,43%
1020,CHEYENNE MOUNTAIN 12,6953,PINON VALLEY ELEMENTARY SCHOOL,6TH,0,8,2,7,54,71,17,24%
1020,CHEYENNE MOUNTAIN 12,6953,PINON VALLEY ELEMENTARY SCHOOL,SCHOOL TOTAL,3,36,8,44,257,348,91,26%
1020,CHEYENNE MOUNTAIN 12,,DISTRICT TOTAL,,51,248,161,536,3582,4578,996,22%
1030,MANITOU SPRINGS 14,5460,MANITOU SPRINGS ELEMENTARY SCHOOL,PK,1,1,0,3,23,28,5,18%
1030,MANITOU SPRINGS 14,5460,MANITOU SPRINGS ELEMENTARY SCHOOL,KINDERGARTEN,2,1,1,3,52,59,7,12%
1030,MANITOU SPRINGS 14,5460,MANITOU SPRINGS ELEMENTARY SCHOOL,1ST,0,1,0,2,58,61,3,5%
1030,MANITOU SPRINGS 14,5460,MANITOU SPRINGS ELEMENTARY SCHOOL,2ND,0,2,2,7,63,74,11,15%
1030,MANITOU SPRINGS 14,5460,MANITOU SPRINGS ELEMENTARY SCHOOL,3RD,0,3,2,5,59,69,10,14%
1030,MANITOU SPRINGS 14,5460,MANITOU SPRINGS ELEMENTARY SCHOOL,4TH,0,0,2,4,64,70,6,9%
1030,MANITOU SPRINGS 14,5460,MANITOU SPRINGS ELEMENTARY SCHOOL,5TH,1,2,0,8,66,77,11,14%
1030,MANITOU SPRINGS 14,5460,MANITOU SPRINGS ELEMENTARY SCHOOL,SCHOOL TOTAL,4,10,7,32,385,438,53,12%
1030,MANITOU SPRINGS 14,5464,MANITOU SPRINGS MIDDLE SCHOOL,6TH,0,0,1,6,105,112,7,6%
1030,MANITOU SPRINGS 14,5464,MANITOU SPRINGS MIDDLE SCHOOL,7TH,4,1,2,6,104,117,13,11%
1030,MANITOU SPRINGS 14,5464,MANITOU SPRINGS MIDDLE SCHOOL,8TH,5,1,1,12,101,120,19,16%
1030,MANITOU SPRINGS 14,5464,MANITOU SPRINGS MIDDLE SCHOOL,SCHOOL TOTAL,9,2,4,24,310,349,39,11%
1030,MANITOU SPRINGS 14,5468,MANITOU SPRINGS HIGH SCHOOL,9TH,2,3,2,6,99,112,13,12%
1030,MANITOU SPRINGS 14,5468,MANITOU SPRINGS HIGH SCHOOL,10TH,3,2,5,7,111,128,17,13%
1030,MANITOU SPRINGS 14,5468,MANITOU SPRINGS HIGH SCHOOL,11TH,3,2,1,8,115,129,14,11%
1030,MANITOU SPRINGS 14,5468,MANITOU SPRINGS HIGH SCHOOL,12TH,4,1,2,7,102,116,14,12%
1030,MANITOU SPRINGS 14,5468,MANITOU SPRINGS HIGH SCHOOL,SCHOOL TOTAL,12,8,10,28,427,485,58,12%
1030,MANITOU SPRINGS 14,9010,UTE PASS ELEMENTARY SCHOOL,PK,0,0,0,0,11,11,0,0%
1030,MANITOU SPRINGS 14,9010,UTE PASS ELEMENTARY SCHOOL,KINDERGARTEN,0,0,0,1,21,22,1,5%
1030,MANITOU SPRINGS 14,9010,UTE PASS ELEMENTARY SCHOOL,1ST,0,0,0,0,25,25,0,0%
1030,MANITOU SPRINGS 14,9010,UTE PASS ELEMENTARY SCHOOL,2ND,0,0,0,0,19,19,0,0%
1030,MANITOU SPRINGS 14,9010,UTE PASS ELEMENTARY SCHOOL,3RD,0,0,0,0,17,17,0,0%
1030,MANITOU SPRINGS 14,9010,UTE PASS ELEMENTARY SCHOOL,4TH,0,0,0,1,15,16,1,6%
1030,MANITOU SPRINGS 14,9010,UTE PASS ELEMENTARY SCHOOL,5TH,0,0,1,1,21,23,2,9%
1030,MANITOU SPRINGS 14,9010,UTE PASS ELEMENTARY SCHOOL,SCHOOL TOTAL,0,0,1,3,129,133,4,3%
1030,MANITOU SPRINGS 14,,DISTRICT TOTAL,,25,20,22,87,1251,1405,154,11%
1040,ACADEMY 20,0017,ACADEMY ENDEAVOUR ELEMENTARY SCHOOL,HALF DAY K,0,2,1,1,27,31,4,13%
1040,ACADEMY 20,0017,ACADEMY ENDEAVOUR ELEMENTARY SCHOOL,KINDERGARTEN,0,3,5,7,50,65,15,23%
1040,ACADEMY 20,0017,ACADEMY ENDEAVOUR ELEMENTARY SCHOOL,1ST,1,1,6,8,60,76,16,21%
1040,ACADEMY 20,0017,ACADEMY ENDEAVOUR ELEMENTARY SCHOOL,2ND,0,6,5,6,57,74,17,23%
1040,ACADEMY 20,0017,ACADEMY ENDEAVOUR ELEMENTARY SCHOOL,3RD,3,6,6,13,60,88,28,32%
1040,ACADEMY 20,0017,ACADEMY ENDEAVOUR ELEMENTARY SCHOOL,4TH,0,12,9,9,61,91,30,33%
1040,ACADEMY 20,0017,ACADEMY ENDEAVOUR ELEMENTARY SCHOOL,5TH,1,6,6,8,67,88,21,24%
1040,ACADEMY 20,0017,ACADEMY ENDEAVOUR ELEMENTARY SCHOOL,SCHOOL TOTAL,5,36,38,52,382,513,131,26%
1040,ACADEMY 20,0019,ACADEMY INTERNATIONAL ELEMENTARY SCHOOL,PK,1,12,2,18,99,132,33,25%
1040,ACADEMY 20,0019,ACADEMY INTERNATIONAL ELEMENTARY SCHOOL,HALF DAY K,0,4,0,0,29,33,4,12%
1040,ACADEMY 20,0019,ACADEMY INTERNATIONAL ELEMENTARY SCHOOL,KINDERGARTEN,0,14,4,11,39,68,29,43%
1040,ACADEMY 20,0019,ACADEMY INTERNATIONAL ELEMENTARY SCHOOL,1ST,0,12,11,8,65,96,31,32%
1040,ACADEMY 20,0019,ACADEMY INTERNATIONAL ELEMENTARY SCHOOL,2ND,0,13,8,7,73,101,28,28%
1040,ACADEMY 20,0019,ACADEMY INTERNATIONAL ELEMENTARY SCHOOL,3RD,0,11,3,9,86,109,23,21%
1040,ACADEMY 20,0019,ACADEMY INTERNATIONAL ELEMENTARY SCHOOL,4TH,0,13,10,11,65,99,34,34%
1040,ACADEMY 20,0019,ACADEMY INTERNATIONAL ELEMENTARY SCHOOL,5TH,1,14,1,11,69,96,27,28%
1040,ACADEMY 20,0019,ACADEMY INTERNATIONAL ELEMENTARY SCHOOL,SCHOOL TOTAL,2,93,39,75,525,734,209,28%
1040,ACADEMY 20,0074,CHALLENGER MIDDLE SCHOOL,6TH,0,8,3,14,176,201,25,12%
1040,ACADEMY 20,0074,CHALLENGER MIDDLE SCHOOL,7TH,0,12,5,19,166,202,36,18%
1040,ACADEMY 20,0074,CHALLENGER MIDDLE SCHOOL,8TH,0,10,6,15,201,232,31,13%
1040,ACADEMY 20,0074,CHALLENGER MIDDLE SCHOOL,SCHOOL TOTAL,0,30,14,48,543,635,92,14%
1040,ACADEMY 20,0076,AIR ACADEMY HIGH SCHOOL,9TH,0,12,10,29,264,315,51,16%
1040,ACADEMY 20,0076,AIR ACADEMY HIGH SCHOOL,10TH,3,19,8,17,259,306,47,15%
1040,ACADEMY 20,0076,AIR ACADEMY HIGH SCHOOL,11TH,5,20,12,23,292,352,60,17%
1040,ACADEMY 20,0076,AIR ACADEMY HIGH SCHOOL,12TH,2,15,14,19,286,336,50,15%
1040,ACADEMY 20,0076,AIR ACADEMY HIGH SCHOOL,SCHOOL TOTAL,10,66,44,88,1101,1309,208,16%
1040,ACADEMY 20,0110,ACADEMY ONLINE HIGH SCHOOL,9TH,0,1,0,0,5,6,1,17%
1040,ACADEMY 20,0110,ACADEMY ONLINE HIGH SCHOOL,10TH,0,1,0,1,8,10,2,20%
1040,ACADEMY 20,0110,ACADEMY ONLINE HIGH SCHOOL,11TH,0,1,0,2,9,12,3,25%
1040,ACADEMY 20,0110,ACADEMY ONLINE HIGH SCHOOL,12TH,0,0,1,0,8,9,1,11%
1040,ACADEMY 20,0110,ACADEMY ONLINE HIGH SCHOOL,SCHOOL TOTAL,0,3,1,3,30,37,7,19%
1040,ACADEMY 20,0209,ASPEN VALLEY HIGH SCHOOL,9TH,0,1,0,0,3,4,1,25%
1040,ACADEMY 20,0209,ASPEN VALLEY HIGH SCHOOL,10TH,0,1,1,4,13,19,6,32%
1040,ACADEMY 20,0209,ASPEN VALLEY HIGH SCHOOL,11TH,1,2,3,3,35,44,9,20%
1040,ACADEMY 20,0209,ASPEN VALLEY HIGH SCHOOL,12TH,0,0,0,2,25,27,2,7%
1040,ACADEMY 20,0209,ASPEN VALLEY HIGH SCHOOL,SCHOOL TOTAL,1,4,4,9,76,94,18,19%
1040,ACADEMY 20,0249,ANTELOPE TRAILS ELEMENTARY SCHOOL,PK,0,1,0,2,25,28,3,11%
1040,ACADEMY 20,0249,ANTELOPE TRAILS ELEMENTARY SCHOOL,HALF DAY K,0,2,1,3,44,50,6,12%
1040,ACADEMY 20,0249,ANTELOPE TRAILS ELEMENTARY SCHOOL,KINDERGARTEN,0,1,2,8,39,50,11,22%
1040,ACADEMY 20,0249,ANTELOPE TRAILS ELEMENTARY SCHOOL,1ST,0,0,3,5,78,86,8,9%
1040,ACADEMY 20,0249,ANTELOPE TRAILS ELEMENTARY SCHOOL,2ND,2,3,2,5,79,91,12,13%
1040,ACADEMY 20,0249,ANTELOPE TRAILS ELEMENTARY SCHOOL,3RD,0,3,1,6,76,86,10,12%
1040,ACADEMY 20,0249,ANTELOPE TRAILS ELEMENTARY SCHOOL,4TH,1,3,2,5,77,88,11,13%
1040,ACADEMY 20,0249,ANTELOPE TRAILS ELEMENTARY SCHOOL,5TH,2,2,3,5,90,102,12,12%
1040,ACADEMY 20,0249,ANTELOPE TRAILS ELEMENTARY SCHOOL,SCHOOL TOTAL,5,15,14,39,508,581,73,13%
1040,ACADEMY 20,1615,CHINOOK TRAIL ELEMENTARY SCHOOL,HALF DAY K,0,12,0,4,40,56,16,29%
1040,ACADEMY 20,1615,CHINOOK TRAIL ELEMENTARY SCHOOL,1ST,1,13,0,4,37,55,18,33%
1040,ACADEMY 20,1615,CHINOOK TRAIL ELEMENTARY SCHOOL,2ND,1,8,2,2,54,67,13,19%
1040,ACADEMY 20,1615,CHINOOK TRAIL ELEMENTARY SCHOOL,3RD,0,9,1,6,41,57,16,28%
1040,ACADEMY 20,1615,CHINOOK TRAIL ELEMENTARY SCHOOL,4TH,0,2,0,5,42,49,7,14%
1040,ACADEMY 20,1615,CHINOOK TRAIL ELEMENTARY SCHOOL,5TH,0,2,1,8,32,43,11,26%
1040,ACADEMY 20,1615,CHINOOK TRAIL ELEMENTARY SCHOOL,6TH,0,1,1,0,19,21,2,10%
1040,ACADEMY 20,1615,CHINOOK TRAIL ELEMENTARY SCHOOL,7TH,0,1,0,2,5,8,3,38%
1040,ACADEMY 20,1615,CHINOOK TRAIL ELEMENTARY SCHOOL,8TH,0,0,0,0,7,7,0,0%
1040,ACADEMY 20,1615,CHINOOK TRAIL ELEMENTARY SCHOOL,SCHOOL TOTAL,2,48,5,31,277,363,86,24%
1040,ACADEMY 20,1627,THE CLASSICAL ACADEMY CHARTER,HALF DAY K,4,18,6,19,283,330,47,14%
1040,ACADEMY 20,1627,THE CLASSICAL ACADEMY CHARTER,1ST,0,18,4,20,249,291,42,14%
1040,ACADEMY 20,1627,THE CLASSICAL ACADEMY CHARTER,2ND,1,14,6,21,232,274,42,15%
1040,ACADEMY 20,1627,THE CLASSICAL ACADEMY CHARTER,3RD,2,8,6,13,249,278,29,10%
1040,ACADEMY 20,1627,THE CLASSICAL ACADEMY CHARTER,4TH,1,13,7,29,220,270,50,19%
1040,ACADEMY 20,1627,THE CLASSICAL ACADEMY CHARTER,5TH,0,13,8,14,220,255,35,14%
1040,ACADEMY 20,1627,THE CLASSICAL ACADEMY CHARTER,6TH,0,6,7,17,209,239,30,13%
1040,ACADEMY 20,1627,THE CLASSICAL ACADEMY CHARTER,SCHOOL TOTAL,8,90,44,133,1662,1937,275,14%
1040,ACADEMY 20,1629,THE CLASSICAL ACADEMY MIDDLE SCHOOL,7TH,0,6,6,5,197,214,17,8%
1040,ACADEMY 20,1629,THE CLASSICAL ACADEMY MIDDLE SCHOOL,8TH,1,5,7,13,181,207,26,13%
1040,ACADEMY 20,1629,THE CLASSICAL ACADEMY MIDDLE SCHOOL,SCHOOL TOTAL,1,11,13,18,378,421,43,10%
1040,ACADEMY 20,1630,THE CLASSICAL ACADEMY HIGH SCHOOL,9TH,0,5,2,16,160,183,23,13%
1040,ACADEMY 20,1630,THE CLASSICAL ACADEMY HIGH SCHOOL,10TH,1,3,5,7,148,164,16,10%
1040,ACADEMY 20,1630,THE CLASSICAL ACADEMY HIGH SCHOOL,11TH,0,1,3,9,111,124,13,10%
1040,ACADEMY 20,1630,THE CLASSICAL ACADEMY HIGH SCHOOL,12TH,0,3,5,5,118,131,13,10%
1040,ACADEMY 20,1630,THE CLASSICAL ACADEMY HIGH SCHOOL,SCHOOL TOTAL,1,12,15,37,537,602,65,11%
1040,ACADEMY 20,2195,DISCOVERY CANYON CAMPUS SCHOOL,PK,0,3,1,3,22,29,7,24%
1040,ACADEMY 20,2195,DISCOVERY CANYON CAMPUS SCHOOL,HALF DAY K,0,5,0,3,34,42,8,19%
1040,ACADEMY 20,2195,DISCOVERY CANYON CAMPUS SCHOOL,KINDERGARTEN,0,3,1,2,20,26,6,23%
1040,ACADEMY 20,2195,DISCOVERY CANYON CAMPUS SCHOOL,1ST,0,4,3,1,63,71,8,11%
1040,ACADEMY 20,2195,DISCOVERY CANYON CAMPUS SCHOOL,2ND,2,4,4,3,65,78,13,17%
1040,ACADEMY 20,2195,DISCOVERY CANYON CAMPUS SCHOOL,3RD,0,6,2,3,73,84,11,13%
1040,ACADEMY 20,2195,DISCOVERY CANYON CAMPUS SCHOOL,4TH,1,5,1,4,74,85,11,13%
1040,ACADEMY 20,2195,DISCOVERY CANYON CAMPUS SCHOOL,5TH,2,3,1,4,81,91,10,11%
1040,ACADEMY 20,2195,DISCOVERY CANYON CAMPUS SCHOOL,6TH,1,13,7,17,178,216,38,18%
1040,ACADEMY 20,2195,DISCOVERY CANYON CAMPUS SCHOOL,7TH,4,19,12,16,228,279,51,18%
1040,ACADEMY 20,2195,DISCOVERY CANYON CAMPUS SCHOOL,8TH,3,12,8,15,203,241,38,16%
1040,ACADEMY 20,2195,DISCOVERY CANYON CAMPUS SCHOOL,9TH,1,10,3,23,179,216,37,17%
1040,ACADEMY 20,2195,DISCOVERY CANYON CAMPUS SCHOOL,10TH,0,8,3,15,176,202,26,13%
1040,ACADEMY 20,2195,DISCOVERY CANYON CAMPUS SCHOOL,11TH,2,6,3,12,121,144,23,16%
1040,ACADEMY 20,2195,DISCOVERY CANYON CAMPUS SCHOOL,SCHOOL TOTAL,16,101,49,121,1517,1804,287,16%
1040,ACADEMY 20,2248,DOUGLASS VALLEY ELEMENTARY SCHOOL,HALF DAY K,2,1,7,3,32,45,13,29%
1040,ACADEMY 20,2248,DOUGLASS VALLEY ELEMENTARY SCHOOL,KINDERGARTEN,0,1,5,6,13,25,12,48%
1040,ACADEMY 20,2248,DOUGLASS VALLEY ELEMENTARY SCHOOL,1ST,0,4,6,13,42,65,23,35%
1040,ACADEMY 20,2248,DOUGLASS VALLEY ELEMENTARY SCHOOL,2ND,1,3,6,13,34,57,23,40%
1040,ACADEMY 20,2248,DOUGLASS VALLEY ELEMENTARY SCHOOL,3RD,2,2,5,7,39,55,16,29%
1040,ACADEMY 20,2248,DOUGLASS VALLEY ELEMENTARY SCHOOL,4TH,1,3,8,9,48,69,21,30%
1040,ACADEMY 20,2248,DOUGLASS VALLEY ELEMENTARY SCHOOL,5TH,0,2,9,10,34,55,21,38%
1040,ACADEMY 20,2248,DOUGLASS VALLEY ELEMENTARY SCHOOL,SCHOOL TOTAL,6,16,46,61,242,371,129,35%
1040,ACADEMY 20,2358,EAGLEVIEW MIDDLE SCHOOL,6TH,4,8,17,32,247,308,61,20%
1040,ACADEMY 20,2358,EAGLEVIEW MIDDLE SCHOOL,7TH,1,28,13,30,256,328,72,22%
1040,ACADEMY 20,2358,EAGLEVIEW MIDDLE SCHOOL,8TH,3,12,10,31,272,328,56,17%
1040,ACADEMY 20,2358,EAGLEVIEW MIDDLE SCHOOL,SCHOOL TOTAL,8,48,40,93,775,964,189,20%
1040,ACADEMY 20,2524,EDITH WOLFORD ELEMENTARY SCHOOL,PK,1,2,1,3,21,28,7,25%
1040,ACADEMY 20,2524,EDITH WOLFORD ELEMENTARY SCHOOL,HALF DAY K,0,2,0,1,14,17,3,18%
1040,ACADEMY 20,2524,EDITH WOLFORD ELEMENTARY SCHOOL,KINDERGARTEN,0,1,0,0,17,18,1,6%
1040,ACADEMY 20,2524,EDITH WOLFORD ELEMENTARY SCHOOL,1ST,0,1,1,3,38,43,5,12%
1040,ACADEMY 20,2524,EDITH WOLFORD ELEMENTARY SCHOOL,2ND,0,1,2,4,43,50,7,14%
1040,ACADEMY 20,2524,EDITH WOLFORD ELEMENTARY SCHOOL,3RD,0,2,1,5,41,49,8,16%
1040,ACADEMY 20,2524,EDITH WOLFORD ELEMENTARY SCHOOL,4TH,2,2,2,8,88,102,14,14%
1040,ACADEMY 20,2524,EDITH WOLFORD ELEMENTARY SCHOOL,5TH,1,1,1,4,55,62,7,11%
1040,ACADEMY 20,2524,EDITH WOLFORD ELEMENTARY SCHOOL,SCHOOL TOTAL,4,12,8,28,317,369,52,14%
1040,ACADEMY 20,2800,EXPLORER ELEMENTARY SCHOOL,PK,1,4,3,3,45,56,11,20%
1040,ACADEMY 20,2800,EXPLORER ELEMENTARY SCHOOL,HALF DAY K,0,3,3,4,28,38,10,26%
1040,ACADEMY 20,2800,EXPLORER ELEMENTARY SCHOOL,KINDERGARTEN,0,1,0,4,20,25,5,20%
1040,ACADEMY 20,2800,EXPLORER ELEMENTARY SCHOOL,1ST,0,0,3,7,56,66,10,15%
1040,ACADEMY 20,2800,EXPLORER ELEMENTARY SCHOOL,2ND,0,2,3,8,62,75,13,17%
1040,ACADEMY 20,2800,EXPLORER ELEMENTARY SCHOOL,3RD,1,2,3,7,71,84,13,15%
1040,ACADEMY 20,2800,EXPLORER ELEMENTARY SCHOOL,4TH,0,2,4,6,75,87,12,14%
1040,ACADEMY 20,2800,EXPLORER ELEMENTARY SCHOOL,5TH,0,3,3,7,71,84,13,15%
1040,ACADEMY 20,2800,EXPLORER ELEMENTARY SCHOOL,SCHOOL TOTAL,2,17,22,46,428,515,87,17%
1040,ACADEMY 20,3104,FOOTHILLS ELEMENTARY SCHOOL,HALF DAY K,1,2,1,0,14,18,4,22%
1040,ACADEMY 20,3104,FOOTHILLS ELEMENTARY SCHOOL,KINDERGARTEN,0,1,1,5,27,34,7,21%
1040,ACADEMY 20,3104,FOOTHILLS ELEMENTARY SCHOOL,1ST,0,1,1,7,55,64,9,14%
1040,ACADEMY 20,3104,FOOTHILLS ELEMENTARY SCHOOL,2ND,1,5,1,3,57,67,10,15%
1040,ACADEMY 20,3104,FOOTHILLS ELEMENTARY SCHOOL,3RD,1,2,2,9,55,69,14,20%
1040,ACADEMY 20,3104,FOOTHILLS ELEMENTARY SCHOOL,4TH,3,1,2,3,63,72,9,13%
1040,ACADEMY 20,3104,FOOTHILLS ELEMENTARY SCHOOL,5TH,1,6,3,2,64,76,12,16%
1040,ACADEMY 20,3104,FOOTHILLS ELEMENTARY SCHOOL,SCHOOL TOTAL,7,18,11,29,335,400,65,16%
1040,ACADEMY 20,3238,FRONTIER ELEMENTARY SCHOOL,PK,0,1,3,2,20,26,6,23%
1040,ACADEMY 20,3238,FRONTIER ELEMENTARY SCHOOL,HALF DAY K,0,5,5,5,26,41,15,37%
1040,ACADEMY 20,3238,FRONTIER ELEMENTARY SCHOOL,KINDERGARTEN,0,0,2,1,22,25,3,12%
1040,ACADEMY 20,3238,FRONTIER ELEMENTARY SCHOOL,1ST,0,2,11,8,45,66,21,32%
1040,ACADEMY 20,3238,FRONTIER ELEMENTARY SCHOOL,2ND,1,2,5,8,55,71,16,23%
1040,ACADEMY 20,3238,FRONTIER ELEMENTARY SCHOOL,3RD,0,2,5,12,61,80,19,24%
1040,ACADEMY 20,3238,FRONTIER ELEMENTARY SCHOOL,4TH,0,3,7,8,46,64,18,28%
1040,ACADEMY 20,3238,FRONTIER ELEMENTARY SCHOOL,5TH,1,0,5,8,40,54,14,26%
1040,ACADEMY 20,3238,FRONTIER ELEMENTARY SCHOOL,SCHOOL TOTAL,2,15,43,52,315,427,112,26%
1040,ACADEMY 20,3985,HIGH PLAINS ELEMENTARY SCHOOL,HALF DAY K,0,0,1,2,15,18,3,17%
1040,ACADEMY 20,3985,HIGH PLAINS ELEMENTARY SCHOOL,KINDERGARTEN,0,6,8,9,18,41,23,56%
1040,ACADEMY 20,3985,HIGH PLAINS ELEMENTARY SCHOOL,1ST,1,1,4,12,31,49,18,37%
1040,ACADEMY 20,3985,HIGH PLAINS ELEMENTARY SCHOOL,2ND,2,3,4,13,44,66,22,33%
1040,ACADEMY 20,3985,HIGH PLAINS ELEMENTARY SCHOOL,3RD,0,4,3,5,39,51,12,24%
1040,ACADEMY 20,3985,HIGH PLAINS ELEMENTARY SCHOOL,4TH,2,4,7,10,45,68,23,34%
1040,ACADEMY 20,3985,HIGH PLAINS ELEMENTARY SCHOOL,5TH,1,9,3,9,46,68,22,32%
1040,ACADEMY 20,3985,HIGH PLAINS ELEMENTARY SCHOOL,SCHOOL TOTAL,6,27,30,60,238,361,123,34%
1040,ACADEMY 20,5126,LIBERTY HIGH SCHOOL,9TH,2,15,15,43,323,398,75,19%
1040,ACADEMY 20,5126,LIBERTY HIGH SCHOOL,10TH,4,12,20,45,302,383,81,21%
1040,ACADEMY 20,5126,LIBERTY HIGH SCHOOL,11TH,5,18,16,38,316,393,77,20%
1040,ACADEMY 20,5126,LIBERTY HIGH SCHOOL,12TH,2,16,19,38,303,378,75,20%
1040,ACADEMY 20,5126,LIBERTY HIGH SCHOOL,SCHOOL TOTAL,13,61,70,164,1244,1552,308,20%
1040,ACADEMY 20,6140,MOUNTAIN RIDGE MIDDLE SCHOOL,6TH,2,27,23,31,283,366,83,23%
1040,ACADEMY 20,6140,MOUNTAIN RIDGE MIDDLE SCHOOL,7TH,3,40,14,47,269,373,104,28%
1040,ACADEMY 20,6140,MOUNTAIN RIDGE MIDDLE SCHOOL,8TH,4,18,24,24,285,355,70,20%
1040,ACADEMY 20,6140,MOUNTAIN RIDGE MIDDLE SCHOOL,SCHOOL TOTAL,9,85,61,102,837,1094,257,23%
1040,ACADEMY 20,6158,MOUNTAIN VIEW ELEMENTARY SCHOOL,HALF DAY K,0,1,1,1,34,37,3,8%
1040,ACADEMY 20,6158,MOUNTAIN VIEW ELEMENTARY SCHOOL,KINDERGARTEN,0,6,1,3,40,50,10,20%
1040,ACADEMY 20,6158,MOUNTAIN VIEW ELEMENTARY SCHOOL,1ST,1,7,1,3,76,88,12,14%
1040,ACADEMY 20,6158,MOUNTAIN VIEW ELEMENTARY SCHOOL,2ND,0,12,3,6,88,109,21,19%
1040,ACADEMY 20,6158,MOUNTAIN VIEW ELEMENTARY SCHOOL,3RD,0,7,0,5,71,83,12,14%
1040,ACADEMY 20,6158,MOUNTAIN VIEW ELEMENTARY SCHOOL,4TH,0,6,4,4,98,112,14,13%
1040,ACADEMY 20,6158,MOUNTAIN VIEW ELEMENTARY SCHOOL,5TH,0,8,1,9,98,116,18,16%
1040,ACADEMY 20,6158,MOUNTAIN VIEW ELEMENTARY SCHOOL,SCHOOL TOTAL,1,47,11,31,505,595,90,15%
1040,ACADEMY 20,6937,PINE CREEK HIGH SCHOOL,9TH,3,14,12,27,281,337,56,17%
1040,ACADEMY 20,6937,PINE CREEK HIGH SCHOOL,10TH,3,13,14,34,314,378,64,17%
1040,ACADEMY 20,6937,PINE CREEK HIGH SCHOOL,11TH,3,22,14,30,301,370,69,19%
1040,ACADEMY 20,6937,PINE CREEK HIGH SCHOOL,12TH,7,23,10,27,357,424,67,16%
1040,ACADEMY 20,6937,PINE CREEK HIGH SCHOOL,SCHOOL TOTAL,16,72,50,118,1253,1509,256,17%
1040,ACADEMY 20,6960,PIONEER ELEMENTARY SCHOOL,HALF DAY K,0,6,2,12,27,47,20,43%
1040,ACADEMY 20,6960,PIONEER ELEMENTARY SCHOOL,KINDERGARTEN,1,0,2,2,20,25,5,20%
1040,ACADEMY 20,6960,PIONEER ELEMENTARY SCHOOL,1ST,1,6,7,14,48,76,28,37%
1040,ACADEMY 20,6960,PIONEER ELEMENTARY SCHOOL,2ND,1,2,4,11,51,69,18,26%
1040,ACADEMY 20,6960,PIONEER ELEMENTARY SCHOOL,3RD,2,7,2,11,66,88,22,25%
1040,ACADEMY 20,6960,PIONEER ELEMENTARY SCHOOL,4TH,0,1,2,15,58,76,18,24%
1040,ACADEMY 20,6960,PIONEER ELEMENTARY SCHOOL,5TH,2,9,5,14,64,94,30,32%
1040,ACADEMY 20,6960,PIONEER ELEMENTARY SCHOOL,SCHOOL TOTAL,7,31,24,79,334,475,141,30%
1040,ACADEMY 20,7159,PRAIRIE HILLS ELEMENTARY SCHOOL,HALF DAY K,1,3,1,3,43,51,8,16%
1040,ACADEMY 20,7159,PRAIRIE HILLS ELEMENTARY SCHOOL,KINDERGARTEN,1,2,2,7,33,45,12,27%
1040,ACADEMY 20,7159,PRAIRIE HILLS ELEMENTARY SCHOOL,1ST,0,3,4,12,77,96,19,20%
1040,ACADEMY 20,7159,PRAIRIE HILLS ELEMENTARY SCHOOL,2ND,0,2,3,6,69,80,11,14%
1040,ACADEMY 20,7159,PRAIRIE HILLS ELEMENTARY SCHOOL,3RD,0,5,3,9,86,103,17,17%
1040,ACADEMY 20,7159,PRAIRIE HILLS ELEMENTARY SCHOOL,4TH,0,5,7,8,77,97,20,21%
1040,ACADEMY 20,7159,PRAIRIE HILLS ELEMENTARY SCHOOL,5TH,0,9,6,11,85,111,26,23%
1040,ACADEMY 20,7159,PRAIRIE HILLS ELEMENTARY SCHOOL,SCHOOL TOTAL,2,29,26,56,470,583,113,19%
1040,ACADEMY 20,7240,RAMPART HIGH SCHOOL,9TH,4,24,32,48,305,413,108,26%
1040,ACADEMY 20,7240,RAMPART HIGH SCHOOL,10TH,3,32,25,33,316,409,93,23%
1040,ACADEMY 20,7240,RAMPART HIGH SCHOOL,11TH,4,28,23,35,319,409,90,22%
1040,ACADEMY 20,7240,RAMPART HIGH SCHOOL,12TH,5,35,21,42,318,421,103,24%
1040,ACADEMY 20,7240,RAMPART HIGH SCHOOL,SCHOOL TOTAL,16,119,101,158,1258,1652,394,24%
1040,ACADEMY 20,7247,RANCH CREEK ELEMENTARY,PK,0,3,1,2,26,32,6,19%
1040,ACADEMY 20,7247,RANCH CREEK ELEMENTARY,HALF DAY K,0,3,1,5,33,42,9,21%
1040,ACADEMY 20,7247,RANCH CREEK ELEMENTARY,KINDERGARTEN,0,0,0,1,23,24,1,4%
1040,ACADEMY 20,7247,RANCH CREEK ELEMENTARY,1ST,0,1,5,7,55,68,13,19%
1040,ACADEMY 20,7247,RANCH CREEK ELEMENTARY,2ND,0,4,5,7,38,54,16,30%
1040,ACADEMY 20,7247,RANCH CREEK ELEMENTARY,3RD,0,2,2,6,48,58,10,17%
1040,ACADEMY 20,7247,RANCH CREEK ELEMENTARY,4TH,0,5,3,3,46,57,11,19%
1040,ACADEMY 20,7247,RANCH CREEK ELEMENTARY,5TH,0,3,2,3,35,43,8,19%
1040,ACADEMY 20,7247,RANCH CREEK ELEMENTARY,SCHOOL TOTAL,0,21,19,34,304,378,74,20%
1040,ACADEMY 20,7460,ROCKRIMMON ELEMENTARY SCHOOL,HALF DAY K,0,1,3,1,18,23,5,22%
1040,ACADEMY 20,7460,ROCKRIMMON ELEMENTARY SCHOOL,KINDERGARTEN,0,4,0,1,20,25,5,20%
1040,ACADEMY 20,7460,ROCKRIMMON ELEMENTARY SCHOOL,1ST,0,3,4,2,49,58,9,16%
1040,ACADEMY 20,7460,ROCKRIMMON ELEMENTARY SCHOOL,2ND,2,2,1,6,38,49,11,22%
1040,ACADEMY 20,7460,ROCKRIMMON ELEMENTARY SCHOOL,3RD,0,1,2,5,67,75,8,11%
1040,ACADEMY 20,7460,ROCKRIMMON ELEMENTARY SCHOOL,4TH,1,6,3,9,38,57,19,33%
1040,ACADEMY 20,7460,ROCKRIMMON ELEMENTARY SCHOOL,5TH,0,3,4,10,61,78,17,22%
1040,ACADEMY 20,7460,ROCKRIMMON ELEMENTARY SCHOOL,SCHOOL TOTAL,3,20,17,34,291,365,74,20%
1040,ACADEMY 20,8779,TCA COLLEGE PATHWAYS,7TH,0,0,1,2,20,23,3,13%
1040,ACADEMY 20,8779,TCA COLLEGE PATHWAYS,8TH,1,0,0,2,23,26,3,12%
1040,ACADEMY 20,8779,TCA COLLEGE PATHWAYS,9TH,0,1,0,2,26,29,3,10%
1040,ACADEMY 20,8779,TCA COLLEGE PATHWAYS,10TH,1,0,0,2,28,31,3,10%
1040,ACADEMY 20,8779,TCA COLLEGE PATHWAYS,11TH,1,0,0,1,14,16,2,13%
1040,ACADEMY 20,8779,TCA COLLEGE PATHWAYS,12TH,0,0,0,0,18,18,0,0%
1040,ACADEMY 20,8779,TCA COLLEGE PATHWAYS,SCHOOL TOTAL,3,1,1,9,129,143,14,10%
1040,ACADEMY 20,8813,THE DA VINCI ACADEMY SCHOOL,HALF DAY K,0,1,0,2,20,23,3,13%
1040,ACADEMY 20,8813,THE DA VINCI ACADEMY SCHOOL,KINDERGARTEN,0,0,5,3,17,25,8,32%
1040,ACADEMY 20,8813,THE DA VINCI ACADEMY SCHOOL,1ST,0,7,3,3,47,60,13,22%
1040,ACADEMY 20,8813,THE DA VINCI ACADEMY SCHOOL,2ND,1,6,2,2,48,59,11,19%
1040,ACADEMY 20,8813,THE DA VINCI ACADEMY SCHOOL,3RD,1,10,4,6,55,76,21,28%
1040,ACADEMY 20,8813,THE DA VINCI ACADEMY SCHOOL,4TH,1,8,6,10,55,80,25,31%
1040,ACADEMY 20,8813,THE DA VINCI ACADEMY SCHOOL,5TH,1,4,9,8,78,100,22,22%
1040,ACADEMY 20,8813,THE DA VINCI ACADEMY SCHOOL,SCHOOL TOTAL,4,36,29,34,320,423,103,24%
1040,ACADEMY 20,8851,TIMBERVIEW MIDDLE SCHOOL,6TH,2,14,17,30,271,334,63,19%
1040,ACADEMY 20,8851,TIMBERVIEW MIDDLE SCHOOL,7TH,0,26,24,32,285,367,82,22%
1040,ACADEMY 20,8851,TIMBERVIEW MIDDLE SCHOOL,8TH,2,12,16,31,282,343,61,18%
1040,ACADEMY 20,8851,TIMBERVIEW MIDDLE SCHOOL,SCHOOL TOTAL,4,52,57,93,838,1044,206,20%
1040,ACADEMY 20,9714,WOODMEN-ROBERTS ELEMENTARY SCHOOL,PK,0,0,2,3,29,34,5,15%
1040,ACADEMY 20,9714,WOODMEN-ROBERTS ELEMENTARY SCHOOL,HALF DAY K,0,1,0,1,5,7,2,29%
1040,ACADEMY 20,9714,WOODMEN-ROBERTS ELEMENTARY SCHOOL,KINDERGARTEN,0,0,0,2,33,35,2,6%
1040,ACADEMY 20,9714,WOODMEN-ROBERTS ELEMENTARY SCHOOL,1ST,0,5,1,3,56,65,9,14%
1040,ACADEMY 20,9714,WOODMEN-ROBERTS ELEMENTARY SCHOOL,2ND,1,2,1,1,46,51,5,10%
1040,ACADEMY 20,9714,WOODMEN-ROBERTS ELEMENTARY SCHOOL,3RD,0,2,2,2,48,54,6,11%
1040,ACADEMY 20,9714,WOODMEN-ROBERTS ELEMENTARY SCHOOL,4TH,0,2,1,3,51,57,6,11%
1040,ACADEMY 20,9714,WOODMEN-ROBERTS ELEMENTARY SCHOOL,5TH,0,3,3,6,55,67,12,18%
1040,ACADEMY 20,9714,WOODMEN-ROBERTS ELEMENTARY SCHOOL,SCHOOL TOTAL,1,15,10,21,323,370,47,13%
1040,ACADEMY 20,,DISTRICT TOTAL,,165,1251,956,1956,18292,22620,4328,19%
1050,ELLICOTT 22,2638,ELLICOTT ELEMENTARY SCHOOL,PK,0,0,2,16,54,72,18,25%
1050,ELLICOTT 22,2638,ELLICOTT ELEMENTARY SCHOOL,KINDERGARTEN,1,1,1,13,46,62,16,26%
1050,ELLICOTT 22,2638,ELLICOTT ELEMENTARY SCHOOL,1ST,1,0,2,12,48,63,15,24%
1050,ELLICOTT 22,2638,ELLICOTT ELEMENTARY SCHOOL,2ND,0,1,0,11,41,53,12,23%
1050,ELLICOTT 22,2638,ELLICOTT ELEMENTARY SCHOOL,3RD,0,0,1,12,49,62,13,21%
1050,ELLICOTT 22,2638,ELLICOTT ELEMENTARY SCHOOL,4TH,0,0,1,20,54,75,21,28%
1050,ELLICOTT 22,2638,ELLICOTT ELEMENTARY SCHOOL,5TH,0,1,1,17,36,55,19,35%
1050,ELLICOTT 22,2638,ELLICOTT ELEMENTARY SCHOOL,SCHOOL TOTAL,2,3,8,101,328,442,114,26%
1050,ELLICOTT 22,2640,ELLICOTT MIDDLE SCHOOL,6TH,0,0,0,14,44,58,14,24%
1050,ELLICOTT 22,2640,ELLICOTT MIDDLE SCHOOL,7TH,1,0,1,11,59,72,13,18%
1050,ELLICOTT 22,2640,ELLICOTT MIDDLE SCHOOL,8TH,2,0,1,11,48,62,14,23%
1050,ELLICOTT 22,2640,ELLICOTT MIDDLE SCHOOL,SCHOOL TOTAL,3,0,2,36,151,192,41,21%
1050,ELLICOTT 22,2642,ELLICOTT SENIOR HIGH SCHOOL,9TH,1,0,2,15,55,73,18,25%
1050,ELLICOTT 22,2642,ELLICOTT SENIOR HIGH SCHOOL,10TH,0,0,3,15,52,70,18,26%
1050,ELLICOTT 22,2642,ELLICOTT SENIOR HIGH SCHOOL,11TH,1,0,5,4,56,66,10,15%
1050,ELLICOTT 22,2642,ELLICOTT SENIOR HIGH SCHOOL,12TH,2,0,1,4,46,53,7,13%
1050,ELLICOTT 22,2642,ELLICOTT SENIOR HIGH SCHOOL,SCHOOL TOTAL,4,0,11,38,209,262,53,20%
1050,ELLICOTT 22,,DISTRICT TOTAL,,9,3,21,175,688,896,208,23%
1060,PEYTON 23 JT,6898,PEYTON ELEMENTARY SCHOOL,PK,0,1,2,0,20,23,3,13%
1060,PEYTON 23 JT,6898,PEYTON ELEMENTARY SCHOOL,KINDERGARTEN,1,0,0,2,35,38,3,8%
1060,PEYTON 23 JT,6898,PEYTON ELEMENTARY SCHOOL,1ST,1,1,0,1,36,39,3,8%
1060,PEYTON 23 JT,6898,PEYTON ELEMENTARY SCHOOL,2ND,0,1,1,5,41,48,7,15%
1060,PEYTON 23 JT,6898,PEYTON ELEMENTARY SCHOOL,3RD,1,0,1,3,47,52,5,10%
1060,PEYTON 23 JT,6898,PEYTON ELEMENTARY SCHOOL,4TH,2,1,1,7,47,58,11,19%
1060,PEYTON 23 JT,6898,PEYTON ELEMENTARY SCHOOL,5TH,1,0,2,1,46,50,4,8%
1060,PEYTON 23 JT,6898,PEYTON ELEMENTARY SCHOOL,6TH,3,1,1,5,48,58,10,17%
1060,PEYTON 23 JT,6898,PEYTON ELEMENTARY SCHOOL,SCHOOL TOTAL,9,5,8,24,320,366,46,13%
1060,PEYTON 23 JT,6902,PEYTON JUNIOR/SENIOR HIGH SCHOOL,7TH,2,0,1,5,44,52,8,15%
1060,PEYTON 23 JT,6902,PEYTON JUNIOR/SENIOR HIGH SCHOOL,8TH,4,0,1,5,51,61,10,16%
1060,PEYTON 23 JT,6902,PEYTON JUNIOR/SENIOR HIGH SCHOOL,9TH,1,0,0,1,54,56,2,4%
1060,PEYTON 23 JT,6902,PEYTON JUNIOR/SENIOR HIGH SCHOOL,10TH,0,0,0,4,50,54,4,7%
1060,PEYTON 23 JT,6902,PEYTON JUNIOR/SENIOR HIGH SCHOOL,11TH,0,0,1,3,59,63,4,6%
1060,PEYTON 23 JT,6902,PEYTON JUNIOR/SENIOR HIGH SCHOOL,12TH,0,1,0,5,36,42,6,14%
1060,PEYTON 23 JT,6902,PEYTON JUNIOR/SENIOR HIGH SCHOOL,SCHOOL TOTAL,7,1,3,23,294,328,34,10%
1060,PEYTON 23 JT,,DISTRICT TOTAL,,16,6,11,47,614,694,80,12%
1070,HANOVER 28,3754,HANOVER ELEMENTARY SCHOOL,PK,0,0,1,2,10,13,3,23%
1070,HANOVER 28,3754,HANOVER ELEMENTARY SCHOOL,KINDERGARTEN,1,0,1,0,8,10,2,20%
1070,HANOVER 28,3754,HANOVER ELEMENTARY SCHOOL,1ST,1,0,1,1,5,8,3,38%
1070,HANOVER 28,3754,HANOVER ELEMENTARY SCHOOL,2ND,0,0,0,3,7,10,3,30%
1070,HANOVER 28,3754,HANOVER ELEMENTARY SCHOOL,3RD,1,0,0,2,9,12,3,25%
1070,HANOVER 28,3754,HANOVER ELEMENTARY SCHOOL,4TH,1,0,0,6,11,18,7,39%
1070,HANOVER 28,3754,HANOVER ELEMENTARY SCHOOL,5TH,0,0,0,1,13,14,1,7%
1070,HANOVER 28,3754,HANOVER ELEMENTARY SCHOOL,SCHOOL TOTAL,4,0,3,15,63,85,22,26%
1070,HANOVER 28,3758,HANOVER JUNIOR-SENIOR HIGH SCHOOL,6TH,0,0,0,2,19,21,2,10%
1070,HANOVER 28,3758,HANOVER JUNIOR-SENIOR HIGH SCHOOL,7TH,1,0,1,3,16,21,5,24%
1070,HANOVER 28,3758,HANOVER JUNIOR-SENIOR HIGH SCHOOL,8TH,0,0,1,2,19,22,3,14%
1070,HANOVER 28,3758,HANOVER JUNIOR-SENIOR HIGH SCHOOL,9TH,0,0,1,2,17,20,3,15%
1070,HANOVER 28,3758,HANOVER JUNIOR-SENIOR HIGH SCHOOL,10TH,1,0,1,2,12,16,4,25%
1070,HANOVER 28,3758,HANOVER JUNIOR-SENIOR HIGH SCHOOL,11TH,0,1,1,5,11,18,7,39%
1070,HANOVER 28,3758,HANOVER JUNIOR-SENIOR HIGH SCHOOL,12TH,0,0,0,6,20,26,6,23%
1070,HANOVER 28,3758,HANOVER JUNIOR-SENIOR HIGH SCHOOL,SCHOOL TOTAL,2,1,5,22,114,144,30,21%
1070,HANOVER 28,6701,PRAIRIE HEIGHTS ELEMENTARY SCHOOL,KINDERGARTEN,0,0,0,2,6,8,2,25%
1070,HANOVER 28,6701,PRAIRIE HEIGHTS ELEMENTARY SCHOOL,1ST,0,0,0,4,4,8,4,50%
1070,HANOVER 28,6701,PRAIRIE HEIGHTS ELEMENTARY SCHOOL,2ND,0,0,1,3,8,12,4,33%
1070,HANOVER 28,6701,PRAIRIE HEIGHTS ELEMENTARY SCHOOL,3RD,0,0,0,4,5,9,4,44%
1070,HANOVER 28,6701,PRAIRIE HEIGHTS ELEMENTARY SCHOOL,SCHOOL TOTAL,0,0,1,13,23,37,14,38%
1070,HANOVER 28,,DISTRICT TOTAL,,6,1,9,50,200,266,66,25%
1080,LEWIS-PALMER 38,1972,CREEKSIDE MIDDLE SCHOOL,6TH,5,5,2,9,127,148,21,14%
1080,LEWIS-PALMER 38,1972,CREEKSIDE MIDDLE SCHOOL,7TH,1,6,2,6,167,182,15,8%
1080,LEWIS-PALMER 38,1972,CREEKSIDE MIDDLE SCHOOL,8TH,4,9,8,10,182,213,31,15%
1080,LEWIS-PALMER 38,1972,CREEKSIDE MIDDLE SCHOOL,SCHOOL TOTAL,10,20,12,25,476,543,67,12%
1080,LEWIS-PALMER 38,3539,GRACE BEST ELEMENTARY SCHOOL,PK,0,0,4,5,31,40,9,23%
1080,LEWIS-PALMER 38,3539,GRACE BEST ELEMENTARY SCHOOL,HALF DAY K,0,0,1,1,29,31,2,6%
1080,LEWIS-PALMER 38,3539,GRACE BEST ELEMENTARY SCHOOL,KINDERGARTEN,0,1,1,2,27,31,4,13%
1080,LEWIS-PALMER 38,3539,GRACE BEST ELEMENTARY SCHOOL,1ST,0,3,0,5,72,80,8,10%
1080,LEWIS-PALMER 38,3539,GRACE BEST ELEMENTARY SCHOOL,2ND,1,5,5,6,59,76,17,22%
1080,LEWIS-PALMER 38,3539,GRACE BEST ELEMENTARY SCHOOL,3RD,0,5,4,10,72,91,19,21%
1080,LEWIS-PALMER 38,3539,GRACE BEST ELEMENTARY SCHOOL,4TH,2,6,2,6,68,84,16,19%
1080,LEWIS-PALMER 38,3539,GRACE BEST ELEMENTARY SCHOOL,5TH,0,3,5,9,64,81,17,21%
1080,LEWIS-PALMER 38,3539,GRACE BEST ELEMENTARY SCHOOL,SCHOOL TOTAL,3,23,22,44,422,514,92,18%
1080,LEWIS-PALMER 38,4686,RAY E KILMER ELEMENTARY SCHOOL,PK,0,4,0,0,23,27,4,15%
1080,LEWIS-PALMER 38,4686,RAY E KILMER ELEMENTARY SCHOOL,HALF DAY K,0,1,0,1,25,27,2,7%
1080,LEWIS-PALMER 38,4686,RAY E KILMER ELEMENTARY SCHOOL,KINDERGARTEN,0,0,0,0,14,14,0,0%
1080,LEWIS-PALMER 38,4686,RAY E KILMER ELEMENTARY SCHOOL,1ST,0,0,0,0,46,46,0,0%
1080,LEWIS-PALMER 38,4686,RAY E KILMER ELEMENTARY SCHOOL,2ND,1,3,0,1,42,47,5,11%
1080,LEWIS-PALMER 38,4686,RAY E KILMER ELEMENTARY SCHOOL,3RD,0,2,1,1,48,52,4,8%
1080,LEWIS-PALMER 38,4686,RAY E KILMER ELEMENTARY SCHOOL,4TH,1,1,0,5,45,52,7,13%
1080,LEWIS-PALMER 38,4686,RAY E KILMER ELEMENTARY SCHOOL,5TH,1,0,0,2,63,66,3,5%
1080,LEWIS-PALMER 38,4686,RAY E KILMER ELEMENTARY SCHOOL,SCHOOL TOTAL,3,11,1,10,306,331,25,8%
1080,LEWIS-PALMER 38,5093,MONUMENT CHARTER ACADEMY,PK,0,0,0,1,56,57,1,2%
1080,LEWIS-PALMER 38,5093,MONUMENT CHARTER ACADEMY,HALF DAY K,0,1,1,0,61,63,2,3%
1080,LEWIS-PALMER 38,5093,MONUMENT CHARTER ACADEMY,KINDERGARTEN,0,3,3,2,29,37,8,22%
1080,LEWIS-PALMER 38,5093,MONUMENT CHARTER ACADEMY,1ST,0,1,1,3,81,86,5,6%
1080,LEWIS-PALMER 38,5093,MONUMENT CHARTER ACADEMY,2ND,1,3,2,3,72,81,9,11%
1080,LEWIS-PALMER 38,5093,MONUMENT CHARTER ACADEMY,3RD,0,4,2,4,84,94,10,11%
1080,LEWIS-PALMER 38,5093,MONUMENT CHARTER ACADEMY,4TH,0,1,1,6,82,90,8,9%
1080,LEWIS-PALMER 38,5093,MONUMENT CHARTER ACADEMY,5TH,1,4,3,2,72,82,10,12%
1080,LEWIS-PALMER 38,5093,MONUMENT CHARTER ACADEMY,6TH,0,1,3,5,53,62,9,15%
1080,LEWIS-PALMER 38,5093,MONUMENT CHARTER ACADEMY,7TH,2,2,1,1,52,58,6,10%
1080,LEWIS-PALMER 38,5093,MONUMENT CHARTER ACADEMY,8TH,0,2,1,0,38,41,3,7%
1080,LEWIS-PALMER 38,5093,MONUMENT CHARTER ACADEMY,SCHOOL TOTAL,4,22,18,27,680,751,71,9%
1080,LEWIS-PALMER 38,5096,LEWIS-PALMER ELEMENTARY SCHOOL,PK,0,1,0,3,31,35,4,11%
1080,LEWIS-PALMER 38,5096,LEWIS-PALMER ELEMENTARY SCHOOL,HALF DAY K,0,0,0,2,23,25,2,8%
1080,LEWIS-PALMER 38,5096,LEWIS-PALMER ELEMENTARY SCHOOL,KINDERGARTEN,0,1,0,3,20,24,4,17%
1080,LEWIS-PALMER 38,5096,LEWIS-PALMER ELEMENTARY SCHOOL,1ST,1,7,0,2,34,44,10,23%
1080,LEWIS-PALMER 38,5096,LEWIS-PALMER ELEMENTARY SCHOOL,2ND,0,4,1,6,47,58,11,19%
1080,LEWIS-PALMER 38,5096,LEWIS-PALMER ELEMENTARY SCHOOL,3RD,0,6,1,3,66,76,10,13%
1080,LEWIS-PALMER 38,5096,LEWIS-PALMER ELEMENTARY SCHOOL,4TH,2,2,0,5,65,74,9,12%
1080,LEWIS-PALMER 38,5096,LEWIS-PALMER ELEMENTARY SCHOOL,5TH,1,8,1,8,75,93,18,19%
1080,LEWIS-PALMER 38,5096,LEWIS-PALMER ELEMENTARY SCHOOL,SCHOOL TOTAL,4,29,3,32,361,429,68,16%
1080,LEWIS-PALMER 38,5098,LEWIS-PALMER MIDDLE SCHOOL,6TH,1,4,6,17,209,237,28,12%
1080,LEWIS-PALMER 38,5098,LEWIS-PALMER MIDDLE SCHOOL,7TH,3,8,0,17,215,243,28,12%
1080,LEWIS-PALMER 38,5098,LEWIS-PALMER MIDDLE SCHOOL,8TH,1,8,3,15,251,278,27,10%
1080,LEWIS-PALMER 38,5098,LEWIS-PALMER MIDDLE SCHOOL,SCHOOL TOTAL,5,20,9,49,675,758,83,11%
1080,LEWIS-PALMER 38,5100,LEWIS-PALMER HIGH SCHOOL,9TH,1,8,1,10,183,203,20,10%
1080,LEWIS-PALMER 38,5100,LEWIS-PALMER HIGH SCHOOL,10TH,1,11,3,12,175,202,27,13%
1080,LEWIS-PALMER 38,5100,LEWIS-PALMER HIGH SCHOOL,11TH,0,10,3,14,214,241,27,11%
1080,LEWIS-PALMER 38,5100,LEWIS-PALMER HIGH SCHOOL,12TH,6,14,5,30,460,515,55,11%
1080,LEWIS-PALMER 38,5100,LEWIS-PALMER HIGH SCHOOL,SCHOOL TOTAL,8,43,12,66,1032,1161,129,11%
1080,LEWIS-PALMER 38,6678,PALMER RIDGE HIGH SCHOOL,9TH,6,12,4,28,250,300,50,17%
1080,LEWIS-PALMER 38,6678,PALMER RIDGE HIGH SCHOOL,10TH,4,10,4,21,242,281,39,14%
1080,LEWIS-PALMER 38,6678,PALMER RIDGE HIGH SCHOOL,11TH,4,9,3,16,211,243,32,13%
1080,LEWIS-PALMER 38,6678,PALMER RIDGE HIGH SCHOOL,SCHOOL TOTAL,14,31,11,65,703,824,121,15%
1080,LEWIS-PALMER 38,6682,PALMER LAKE ELEMENTARY SCHOOL,PK,1,0,1,4,27,33,6,18%
1080,LEWIS-PALMER 38,6682,PALMER LAKE ELEMENTARY SCHOOL,HALF DAY K,0,1,1,1,16,19,3,16%
1080,LEWIS-PALMER 38,6682,PALMER LAKE ELEMENTARY SCHOOL,KINDERGARTEN,0,0,1,0,18,19,1,5%
1080,LEWIS-PALMER 38,6682,PALMER LAKE ELEMENTARY SCHOOL,1ST,1,1,0,7,26,35,9,26%
1080,LEWIS-PALMER 38,6682,PALMER LAKE ELEMENTARY SCHOOL,2ND,2,4,0,8,53,67,14,21%
1080,LEWIS-PALMER 38,6682,PALMER LAKE ELEMENTARY SCHOOL,3RD,2,2,0,3,41,48,7,15%
1080,LEWIS-PALMER 38,6682,PALMER LAKE ELEMENTARY SCHOOL,4TH,4,2,1,8,43,58,15,26%
1080,LEWIS-PALMER 38,6682,PALMER LAKE ELEMENTARY SCHOOL,5TH,0,0,0,8,44,52,8,15%
1080,LEWIS-PALMER 38,6682,PALMER LAKE ELEMENTARY SCHOOL,SCHOOL TOTAL,10,10,4,39,268,331,63,19%
1080,LEWIS-PALMER 38,7165,PRAIRIE WINDS ELEMENTARY SCHOOL,PK,0,0,0,0,7,7,0,0%
1080,LEWIS-PALMER 38,7165,PRAIRIE WINDS ELEMENTARY SCHOOL,HALF DAY K,0,0,1,0,16,17,1,6%
1080,LEWIS-PALMER 38,7165,PRAIRIE WINDS ELEMENTARY SCHOOL,KINDERGARTEN,0,2,0,0,20,22,2,9%
1080,LEWIS-PALMER 38,7165,PRAIRIE WINDS ELEMENTARY SCHOOL,1ST,0,0,0,1,45,46,1,2%
1080,LEWIS-PALMER 38,7165,PRAIRIE WINDS ELEMENTARY SCHOOL,2ND,0,2,1,2,41,46,5,11%
1080,LEWIS-PALMER 38,7165,PRAIRIE WINDS ELEMENTARY SCHOOL,3RD,1,0,0,2,42,45,3,7%
1080,LEWIS-PALMER 38,7165,PRAIRIE WINDS ELEMENTARY SCHOOL,4TH,0,1,0,1,54,56,2,4%
1080,LEWIS-PALMER 38,7165,PRAIRIE WINDS ELEMENTARY SCHOOL,5TH,0,2,2,0,65,69,4,6%
1080,LEWIS-PALMER 38,7165,PRAIRIE WINDS ELEMENTARY SCHOOL,SCHOOL TOTAL,1,7,4,6,290,308,18,6%
1080,LEWIS-PALMER 38,,DISTRICT TOTAL,,62,216,96,363,5213,5950,737,12%
1110,FALCON 49,0555,BANNING LEWIS RANCH ACADEMY,KINDERGARTEN,0,8,9,10,61,88,27,31%
1110,FALCON 49,0555,BANNING LEWIS RANCH ACADEMY,1ST,3,8,9,13,67,100,33,33%
1110,FALCON 49,0555,BANNING LEWIS RANCH ACADEMY,2ND,2,10,11,7,56,86,30,35%
1110,FALCON 49,0555,BANNING LEWIS RANCH ACADEMY,3RD,2,7,6,9,61,85,24,28%
1110,FALCON 49,0555,BANNING LEWIS RANCH ACADEMY,4TH,1,8,6,7,56,78,22,28%
1110,FALCON 49,0555,BANNING LEWIS RANCH ACADEMY,5TH,2,6,6,6,47,67,20,30%
1110,FALCON 49,0555,BANNING LEWIS RANCH ACADEMY,6TH,2,4,8,8,58,80,22,28%
1110,FALCON 49,0555,BANNING LEWIS RANCH ACADEMY,7TH,2,2,3,9,39,55,16,29%
1110,FALCON 49,0555,BANNING LEWIS RANCH ACADEMY,8TH,0,1,5,6,46,58,12,21%
1110,FALCON 49,0555,BANNING LEWIS RANCH ACADEMY,SCHOOL TOTAL,14,54,63,75,491,697,206,30%
1110,FALCON 49,1618,EVANS INTERNATIONAL ELEMENTARY SCHOOL,PK,1,0,0,6,8,15,7,47%
1110,FALCON 49,1618,EVANS INTERNATIONAL ELEMENTARY SCHOOL,HALF DAY K,0,1,6,12,39,58,19,33%
1110,FALCON 49,1618,EVANS INTERNATIONAL ELEMENTARY SCHOOL,KINDERGARTEN,0,2,5,12,47,66,19,29%
1110,FALCON 49,1618,EVANS INTERNATIONAL ELEMENTARY SCHOOL,1ST,2,3,10,24,55,94,39,41%
1110,FALCON 49,1618,EVANS INTERNATIONAL ELEMENTARY SCHOOL,2ND,2,8,9,23,65,107,42,39%
1110,FALCON 49,1618,EVANS INTERNATIONAL ELEMENTARY SCHOOL,3RD,1,6,17,25,65,114,49,43%
1110,FALCON 49,1618,EVANS INTERNATIONAL ELEMENTARY SCHOOL,4TH,1,5,14,24,71,115,44,38%
1110,FALCON 49,1618,EVANS INTERNATIONAL ELEMENTARY SCHOOL,5TH,4,4,11,22,56,97,41,42%
1110,FALCON 49,1618,EVANS INTERNATIONAL ELEMENTARY SCHOOL,SCHOOL TOTAL,11,29,72,148,406,666,260,39%
1110,FALCON 49,2902,FALCON ELEMENTARY SCHOOL,PK,0,0,3,1,8,12,4,33%
1110,FALCON 49,2902,FALCON ELEMENTARY SCHOOL,HALF DAY K,0,5,1,7,19,32,13,41%
1110,FALCON 49,2902,FALCON ELEMENTARY SCHOOL,KINDERGARTEN,0,0,2,6,14,22,8,36%
1110,FALCON 49,2902,FALCON ELEMENTARY SCHOOL,1ST,1,0,2,7,38,48,10,21%
1110,FALCON 49,2902,FALCON ELEMENTARY SCHOOL,2ND,1,3,3,9,38,54,16,30%
1110,FALCON 49,2902,FALCON ELEMENTARY SCHOOL,3RD,0,1,0,9,39,49,10,20%
1110,FALCON 49,2902,FALCON ELEMENTARY SCHOOL,4TH,4,2,4,10,36,56,20,36%
1110,FALCON 49,2902,FALCON ELEMENTARY SCHOOL,5TH,0,0,1,4,48,53,5,9%
1110,FALCON 49,2902,FALCON ELEMENTARY SCHOOL,SCHOOL TOTAL,6,11,16,53,240,326,86,26%
1110,FALCON 49,2906,FALCON MIDDLE SCHOOL,6TH,4,12,17,45,247,325,78,24%
1110,FALCON 49,2906,FALCON MIDDLE SCHOOL,7TH,3,8,15,39,228,293,65,22%
1110,FALCON 49,2906,FALCON MIDDLE SCHOOL,8TH,7,9,20,42,207,285,78,27%
1110,FALCON 49,2906,FALCON MIDDLE SCHOOL,SCHOOL TOTAL,14,29,52,126,682,903,221,24%
1110,FALCON 49,2908,FALCON HIGH SCHOOL,9TH,4,12,19,50,294,379,85,22%
1110,FALCON 49,2908,FALCON HIGH SCHOOL,10TH,7,14,21,38,248,328,80,24%
1110,FALCON 49,2908,FALCON HIGH SCHOOL,11TH,6,8,20,24,244,302,58,19%
1110,FALCON 49,2908,FALCON HIGH SCHOOL,12TH,3,3,22,30,220,278,58,21%
1110,FALCON 49,2908,FALCON HIGH SCHOOL,SCHOOL TOTAL,20,37,82,142,1006,1287,281,22%
1110,FALCON 49,4102,HORIZON MIDDLE SCHOOL,6TH,2,12,31,46,136,227,91,40%
1110,FALCON 49,4102,HORIZON MIDDLE SCHOOL,7TH,3,8,35,41,123,210,87,41%
1110,FALCON 49,4102,HORIZON MIDDLE SCHOOL,8TH,3,14,31,47,140,235,95,40%
1110,FALCON 49,4102,HORIZON MIDDLE SCHOOL,SCHOOL TOTAL,8,34,97,134,399,672,273,41%
1110,FALCON 49,4251,THE IMAGINE CLASSICAL ACADEMY AT INDIGO RANCH,HALF DAY K,0,1,1,13,61,76,15,20%
1110,FALCON 49,4251,THE IMAGINE CLASSICAL ACADEMY AT INDIGO RANCH,KINDERGARTEN,0,5,1,1,30,37,7,19%
1110,FALCON 49,4251,THE IMAGINE CLASSICAL ACADEMY AT INDIGO RANCH,1ST,1,5,11,8,86,111,25,23%
1110,FALCON 49,4251,THE IMAGINE CLASSICAL ACADEMY AT INDIGO RANCH,2ND,0,5,3,5,79,92,13,14%
1110,FALCON 49,4251,THE IMAGINE CLASSICAL ACADEMY AT INDIGO RANCH,3RD,0,1,7,8,64,80,16,20%
1110,FALCON 49,4251,THE IMAGINE CLASSICAL ACADEMY AT INDIGO RANCH,4TH,1,3,6,7,51,68,17,25%
1110,FALCON 49,4251,THE IMAGINE CLASSICAL ACADEMY AT INDIGO RANCH,5TH,0,1,2,8,40,51,11,22%
1110,FALCON 49,4251,THE IMAGINE CLASSICAL ACADEMY AT INDIGO RANCH,6TH,0,2,7,5,27,41,14,34%
1110,FALCON 49,4251,THE IMAGINE CLASSICAL ACADEMY AT INDIGO RANCH,7TH,0,0,5,6,25,36,11,31%
1110,FALCON 49,4251,THE IMAGINE CLASSICAL ACADEMY AT INDIGO RANCH,SCHOOL TOTAL,2,23,43,61,463,592,129,22%
1110,FALCON 49,5779,MERIDIAN RANCH ELEMENTARY SCHOOL,PK,0,1,1,4,13,19,6,32%
1110,FALCON 49,5779,MERIDIAN RANCH ELEMENTARY SCHOOL,HALF DAY K,0,3,0,5,45,53,8,15%
1110,FALCON 49,5779,MERIDIAN RANCH ELEMENTARY SCHOOL,KINDERGARTEN,0,0,2,4,39,45,6,13%
1110,FALCON 49,5779,MERIDIAN RANCH ELEMENTARY SCHOOL,1ST,0,5,3,7,70,85,15,18%
1110,FALCON 49,5779,MERIDIAN RANCH ELEMENTARY SCHOOL,2ND,2,5,3,7,62,79,17,22%
1110,FALCON 49,5779,MERIDIAN RANCH ELEMENTARY SCHOOL,3RD,0,7,5,12,83,107,24,22%
1110,FALCON 49,5779,MERIDIAN RANCH ELEMENTARY SCHOOL,4TH,0,3,5,14,72,94,22,23%
1110,FALCON 49,5779,MERIDIAN RANCH ELEMENTARY SCHOOL,5TH,1,4,7,12,89,113,24,21%
1110,FALCON 49,5779,MERIDIAN RANCH ELEMENTARY SCHOOL,SCHOOL TOTAL,3,28,26,65,473,595,122,21%
1110,FALCON 49,6483,ODYSSEY ELEMENTARY SCHOOL,PK,0,3,1,2,13,19,6,32%
1110,FALCON 49,6483,ODYSSEY ELEMENTARY SCHOOL,HALF DAY K,0,4,3,4,39,50,11,22%
1110,FALCON 49,6483,ODYSSEY ELEMENTARY SCHOOL,KINDERGARTEN,1,2,3,9,27,42,15,36%
1110,FALCON 49,6483,ODYSSEY ELEMENTARY SCHOOL,1ST,0,7,13,13,56,89,33,37%
1110,FALCON 49,6483,ODYSSEY ELEMENTARY SCHOOL,2ND,2,7,18,17,63,107,44,41%
1110,FALCON 49,6483,ODYSSEY ELEMENTARY SCHOOL,3RD,0,2,7,11,52,72,20,28%
1110,FALCON 49,6483,ODYSSEY ELEMENTARY SCHOOL,4TH,1,3,9,13,53,79,26,33%
1110,FALCON 49,6483,ODYSSEY ELEMENTARY SCHOOL,5TH,2,7,15,15,51,90,39,43%
1110,FALCON 49,6483,ODYSSEY ELEMENTARY SCHOOL,SCHOOL TOTAL,6,35,69,84,354,548,194,35%
1110,FALCON 49,6810,PATRIOT LEARNING CENTER,6TH,0,0,0,2,10,12,2,17%
1110,FALCON 49,6810,PATRIOT LEARNING CENTER,7TH,0,1,0,3,9,13,4,31%
1110,FALCON 49,6810,PATRIOT LEARNING CENTER,8TH,2,0,3,3,18,26,8,31%
1110,FALCON 49,6810,PATRIOT LEARNING CENTER,9TH,0,0,0,1,0,1,1,100%
1110,FALCON 49,6810,PATRIOT LEARNING CENTER,10TH,0,2,2,4,14,22,8,36%
1110,FALCON 49,6810,PATRIOT LEARNING CENTER,11TH,0,1,2,4,25,32,7,22%
1110,FALCON 49,6810,PATRIOT LEARNING CENTER,12TH,1,1,7,19,66,94,28,30%
1110,FALCON 49,6810,PATRIOT LEARNING CENTER,SCHOOL TOTAL,3,5,14,36,142,200,58,29%
1110,FALCON 49,6935,PIKES PEAK SCHOOL EXPEDITIONARY LEARNING,HALF DAY K,0,0,0,1,15,16,1,6%
1110,FALCON 49,6935,PIKES PEAK SCHOOL EXPEDITIONARY LEARNING,KINDERGARTEN,0,1,0,1,32,34,2,6%
1110,FALCON 49,6935,PIKES PEAK SCHOOL EXPEDITIONARY LEARNING,1ST,1,0,1,3,45,50,5,10%
1110,FALCON 49,6935,PIKES PEAK SCHOOL EXPEDITIONARY LEARNING,2ND,0,4,2,4,48,58,10,17%
1110,FALCON 49,6935,PIKES PEAK SCHOOL EXPEDITIONARY LEARNING,3RD,0,1,1,1,24,27,3,11%
1110,FALCON 49,6935,PIKES PEAK SCHOOL EXPEDITIONARY LEARNING,4TH,1,0,0,4,30,35,5,14%
1110,FALCON 49,6935,PIKES PEAK SCHOOL EXPEDITIONARY LEARNING,5TH,0,3,2,2,36,43,7,16%
1110,FALCON 49,6935,PIKES PEAK SCHOOL EXPEDITIONARY LEARNING,6TH,0,1,0,4,22,27,5,19%
1110,FALCON 49,6935,PIKES PEAK SCHOOL EXPEDITIONARY LEARNING,7TH,0,2,1,1,25,29,4,14%
1110,FALCON 49,6935,PIKES PEAK SCHOOL EXPEDITIONARY LEARNING,8TH,0,0,0,1,25,26,1,4%
1110,FALCON 49,6935,PIKES PEAK SCHOOL EXPEDITIONARY LEARNING,SCHOOL TOTAL,2,12,7,22,302,345,43,12%
1110,FALCON 49,7317,REMINGTON ELEMENTARY SCHOOL,PK,1,2,3,7,30,43,13,30%
1110,FALCON 49,7317,REMINGTON ELEMENTARY SCHOOL,HALF DAY K,1,3,2,9,23,38,15,39%
1110,FALCON 49,7317,REMINGTON ELEMENTARY SCHOOL,KINDERGARTEN,0,4,7,6,39,56,17,30%
1110,FALCON 49,7317,REMINGTON ELEMENTARY SCHOOL,1ST,0,6,13,21,52,92,40,43%
1110,FALCON 49,7317,REMINGTON ELEMENTARY SCHOOL,2ND,0,6,10,17,60,93,33,35%
1110,FALCON 49,7317,REMINGTON ELEMENTARY SCHOOL,3RD,0,4,11,26,41,82,41,50%
1110,FALCON 49,7317,REMINGTON ELEMENTARY SCHOOL,4TH,1,5,8,19,56,89,33,37%
1110,FALCON 49,7317,REMINGTON ELEMENTARY SCHOOL,5TH,1,2,14,18,58,93,35,38%
1110,FALCON 49,7317,REMINGTON ELEMENTARY SCHOOL,SCHOOL TOTAL,4,32,68,123,359,586,227,39%
1110,FALCON 49,7339,RIDGEVIEW ELEMENTARY SCHOOL,PK,0,4,0,18,42,64,22,34%
1110,FALCON 49,7339,RIDGEVIEW ELEMENTARY SCHOOL,HALF DAY K,1,5,5,19,38,68,30,44%
1110,FALCON 49,7339,RIDGEVIEW ELEMENTARY SCHOOL,KINDERGARTEN,0,1,1,4,35,41,6,15%
1110,FALCON 49,7339,RIDGEVIEW ELEMENTARY SCHOOL,1ST,1,7,10,23,66,107,41,38%
1110,FALCON 49,7339,RIDGEVIEW ELEMENTARY SCHOOL,2ND,2,6,7,15,66,96,30,31%
1110,FALCON 49,7339,RIDGEVIEW ELEMENTARY SCHOOL,3RD,1,5,5,17,86,114,28,25%
1110,FALCON 49,7339,RIDGEVIEW ELEMENTARY SCHOOL,4TH,0,4,11,22,74,111,37,33%
1110,FALCON 49,7339,RIDGEVIEW ELEMENTARY SCHOOL,5TH,2,6,11,23,75,117,42,36%
1110,FALCON 49,7339,RIDGEVIEW ELEMENTARY SCHOOL,SCHOOL TOTAL,7,38,50,141,482,718,236,33%
1110,FALCON 49,7463,ROCKY MOUNTAIN CLASSICAL ACADEMY,HALF DAY K,0,2,1,4,50,57,7,12%
1110,FALCON 49,7463,ROCKY MOUNTAIN CLASSICAL ACADEMY,KINDERGARTEN,0,3,1,3,42,49,7,14%
1110,FALCON 49,7463,ROCKY MOUNTAIN CLASSICAL ACADEMY,1ST,0,4,5,10,88,107,19,18%
1110,FALCON 49,7463,ROCKY MOUNTAIN CLASSICAL ACADEMY,2ND,0,4,3,8,67,82,15,18%
1110,FALCON 49,7463,ROCKY MOUNTAIN CLASSICAL ACADEMY,3RD,0,5,13,8,78,104,26,25%
1110,FALCON 49,7463,ROCKY MOUNTAIN CLASSICAL ACADEMY,4TH,0,5,8,10,57,80,23,29%
1110,FALCON 49,7463,ROCKY MOUNTAIN CLASSICAL ACADEMY,5TH,0,6,8,12,63,89,26,29%
1110,FALCON 49,7463,ROCKY MOUNTAIN CLASSICAL ACADEMY,6TH,0,3,4,14,58,79,21,27%
1110,FALCON 49,7463,ROCKY MOUNTAIN CLASSICAL ACADEMY,7TH,0,1,6,9,44,60,16,27%
1110,FALCON 49,7463,ROCKY MOUNTAIN CLASSICAL ACADEMY,8TH,0,1,2,9,41,53,12,23%
1110,FALCON 49,7463,ROCKY MOUNTAIN CLASSICAL ACADEMY,9TH,0,0,4,5,37,46,9,20%
1110,FALCON 49,7463,ROCKY MOUNTAIN CLASSICAL ACADEMY,10TH,0,0,1,3,14,18,4,22%
1110,FALCON 49,7463,ROCKY MOUNTAIN CLASSICAL ACADEMY,SCHOOL TOTAL,0,34,56,95,639,824,185,22%
1110,FALCON 49,7613,SAND CREEK HIGH SCHOOL,9TH,4,22,39,67,173,305,132,43%
1110,FALCON 49,7613,SAND CREEK HIGH SCHOOL,10TH,3,19,36,60,148,266,118,44%
1110,FALCON 49,7613,SAND CREEK HIGH SCHOOL,11TH,3,22,36,55,149,265,116,44%
1110,FALCON 49,7613,SAND CREEK HIGH SCHOOL,12TH,8,43,55,81,273,460,187,41%
1110,FALCON 49,7613,SAND CREEK HIGH SCHOOL,SCHOOL TOTAL,18,106,166,263,743,1296,553,43%
1110,FALCON 49,7960,SKYVIEW MIDDLE SCHOOL,6TH,3,22,43,81,251,400,149,37%
1110,FALCON 49,7960,SKYVIEW MIDDLE SCHOOL,7TH,3,35,54,68,215,375,160,43%
1110,FALCON 49,7960,SKYVIEW MIDDLE SCHOOL,8TH,4,34,45,78,242,403,161,40%
1110,FALCON 49,7960,SKYVIEW MIDDLE SCHOOL,SCHOOL TOTAL,10,91,142,227,708,1178,470,40%
1110,FALCON 49,8010,SPRINGS RANCH ELEMENTARY SCHOOL,PK,0,1,3,5,14,23,9,39%
1110,FALCON 49,8010,SPRINGS RANCH ELEMENTARY SCHOOL,HALF DAY K,1,3,3,17,42,66,24,36%
1110,FALCON 49,8010,SPRINGS RANCH ELEMENTARY SCHOOL,KINDERGARTEN,0,2,6,7,30,45,15,33%
1110,FALCON 49,8010,SPRINGS RANCH ELEMENTARY SCHOOL,1ST,1,10,2,21,69,103,34,33%
1110,FALCON 49,8010,SPRINGS RANCH ELEMENTARY SCHOOL,2ND,1,11,9,16,67,104,37,36%
1110,FALCON 49,8010,SPRINGS RANCH ELEMENTARY SCHOOL,3RD,2,6,13,20,71,112,41,37%
1110,FALCON 49,8010,SPRINGS RANCH ELEMENTARY SCHOOL,4TH,2,2,11,20,67,102,35,34%
1110,FALCON 49,8010,SPRINGS RANCH ELEMENTARY SCHOOL,5TH,0,13,10,13,72,108,36,33%
1110,FALCON 49,8010,SPRINGS RANCH ELEMENTARY SCHOOL,SCHOOL TOTAL,7,48,57,119,432,663,231,35%
1110,FALCON 49,8266,STETSON ELEMENTARY SCHOOL,PK,0,2,4,1,13,20,7,35%
1110,FALCON 49,8266,STETSON ELEMENTARY SCHOOL,HALF DAY K,1,5,3,10,40,59,19,32%
1110,FALCON 49,8266,STETSON ELEMENTARY SCHOOL,KINDERGARTEN,0,3,7,8,27,45,18,40%
1110,FALCON 49,8266,STETSON ELEMENTARY SCHOOL,1ST,1,10,16,12,63,102,39,38%
1110,FALCON 49,8266,STETSON ELEMENTARY SCHOOL,2ND,0,3,12,20,54,89,35,39%
1110,FALCON 49,8266,STETSON ELEMENTARY SCHOOL,3RD,0,9,12,19,88,128,40,31%
1110,FALCON 49,8266,STETSON ELEMENTARY SCHOOL,4TH,1,11,10,17,65,104,39,38%
1110,FALCON 49,8266,STETSON ELEMENTARY SCHOOL,5TH,1,13,12,15,92,133,41,31%
1110,FALCON 49,8266,STETSON ELEMENTARY SCHOOL,SCHOOL TOTAL,4,56,76,102,442,680,238,35%
1110,FALCON 49,8791,VISTA RIDGE HIGH SCHOOL,9TH,3,20,35,53,190,301,111,37%
1110,FALCON 49,8791,VISTA RIDGE HIGH SCHOOL,10TH,2,21,45,39,208,315,107,34%
1110,FALCON 49,8791,VISTA RIDGE HIGH SCHOOL,11TH,1,10,41,50,159,261,102,39%
1110,FALCON 49,8791,VISTA RIDGE HIGH SCHOOL,12TH,0,0,1,3,15,19,4,21%
1110,FALCON 49,8791,VISTA RIDGE HIGH SCHOOL,SCHOOL TOTAL,6,51,122,145,572,896,324,36%
1110,FALCON 49,9706,WOODMEN HILLS ELEMENTARY SCHOOL,PK,1,1,1,3,29,35,6,17%
1110,FALCON 49,9706,WOODMEN HILLS ELEMENTARY SCHOOL,HALF DAY K,1,4,1,5,51,62,11,18%
1110,FALCON 49,9706,WOODMEN HILLS ELEMENTARY SCHOOL,KINDERGARTEN,0,0,3,5,43,51,8,16%
1110,FALCON 49,9706,WOODMEN HILLS ELEMENTARY SCHOOL,1ST,2,7,4,8,95,116,21,18%
1110,FALCON 49,9706,WOODMEN HILLS ELEMENTARY SCHOOL,2ND,1,4,7,15,81,108,27,25%
1110,FALCON 49,9706,WOODMEN HILLS ELEMENTARY SCHOOL,3RD,0,4,3,12,93,112,19,17%
1110,FALCON 49,9706,WOODMEN HILLS ELEMENTARY SCHOOL,4TH,0,4,9,14,108,135,27,20%
1110,FALCON 49,9706,WOODMEN HILLS ELEMENTARY SCHOOL,5TH,0,4,3,11,89,107,18,17%
1110,FALCON 49,9706,WOODMEN HILLS ELEMENTARY SCHOOL,SCHOOL TOTAL,5,28,31,73,589,726,137,19%
1110,FALCON 49,,DISTRICT TOTAL,,150,781,1309,2234,9924,14398,4474,31%
1120,EDISON 54 JT,2504,EDISON ACADEMY,KINDERGARTEN,0,0,0,1,0,1,1,100%
1120,EDISON 54 JT,2504,EDISON ACADEMY,1ST,0,0,0,0,4,4,0,0%
1120,EDISON 54 JT,2504,EDISON ACADEMY,2ND,0,0,0,0,2,2,0,0%
1120,EDISON 54 JT,2504,EDISON ACADEMY,3RD,0,0,0,2,8,10,2,20%
1120,EDISON 54 JT,2504,EDISON ACADEMY,4TH,0,1,0,0,7,8,1,13%
1120,EDISON 54 JT,2504,EDISON ACADEMY,5TH,0,0,1,1,5,7,2,29%
1120,EDISON 54 JT,2504,EDISON ACADEMY,6TH,0,2,0,1,6,9,3,33%
1120,EDISON 54 JT,2504,EDISON ACADEMY,7TH,0,1,0,1,5,7,2,29%
1120,EDISON 54 JT,2504,EDISON ACADEMY,8TH,0,1,0,0,9,10,1,10%
1120,EDISON 54 JT,2504,EDISON ACADEMY,9TH,0,0,1,2,23,26,3,12%
1120,EDISON 54 JT,2504,EDISON ACADEMY,10TH,0,0,0,1,25,26,1,4%
1120,EDISON 54 JT,2504,EDISON ACADEMY,11TH,0,0,0,3,27,30,3,10%
1120,EDISON 54 JT,2504,EDISON ACADEMY,12TH,0,1,1,4,36,42,6,14%
1120,EDISON 54 JT,2504,EDISON ACADEMY,SCHOOL TOTAL,0,6,3,16,157,182,25,14%
1120,EDISON 54 JT,2514,EDISON ELEMENTARY SCHOOL,PK,0,0,0,0,9,9,0,0%
1120,EDISON 54 JT,2514,EDISON ELEMENTARY SCHOOL,KINDERGARTEN,0,0,0,0,6,6,0,0%
1120,EDISON 54 JT,2514,EDISON ELEMENTARY SCHOOL,1ST,0,0,0,0,9,9,0,0%
1120,EDISON 54 JT,2514,EDISON ELEMENTARY SCHOOL,2ND,0,0,0,1,11,12,1,8%
1120,EDISON 54 JT,2514,EDISON ELEMENTARY SCHOOL,3RD,0,0,0,0,12,12,0,0%
1120,EDISON 54 JT,2514,EDISON ELEMENTARY SCHOOL,4TH,0,0,0,0,9,9,0,0%
1120,EDISON 54 JT,2514,EDISON ELEMENTARY SCHOOL,5TH,0,0,0,0,9,9,0,0%
1120,EDISON 54 JT,2514,EDISON ELEMENTARY SCHOOL,SCHOOL TOTAL,0,0,0,1,65,66,1,2%
1120,EDISON 54 JT,2526,EDISON JUNIOR-SENIOR HIGH SCHOOL,6TH,0,0,0,2,8,10,2,20%
1120,EDISON 54 JT,2526,EDISON JUNIOR-SENIOR HIGH SCHOOL,7TH,0,0,0,0,7,7,0,0%
1120,EDISON 54 JT,2526,EDISON JUNIOR-SENIOR HIGH SCHOOL,8TH,0,0,0,1,7,8,1,13%
1120,EDISON 54 JT,2526,EDISON JUNIOR-SENIOR HIGH SCHOOL,9TH,0,0,0,0,7,7,0,0%
1120,EDISON 54 JT,2526,EDISON JUNIOR-SENIOR HIGH SCHOOL,10TH,0,0,0,1,9,10,1,10%
1120,EDISON 54 JT,2526,EDISON JUNIOR-SENIOR HIGH SCHOOL,11TH,0,0,1,0,5,6,1,17%
1120,EDISON 54 JT,2526,EDISON JUNIOR-SENIOR HIGH SCHOOL,12TH,0,0,0,0,9,9,0,0%
1120,EDISON 54 JT,2526,EDISON JUNIOR-SENIOR HIGH SCHOOL,SCHOOL TOTAL,0,0,1,4,52,57,5,9%
1120,EDISON 54 JT,,DISTRICT TOTAL,,0,6,4,21,274,305,31,10%
1130,MIAMI/YODER 60 JT,5850,MIAMI/YODER ELEMENTARY SCHOOL,PK,4,0,0,0,16,20,4,20%
1130,MIAMI/YODER 60 JT,5850,MIAMI/YODER ELEMENTARY SCHOOL,KINDERGARTEN,1,0,1,2,12,16,4,25%
1130,MIAMI/YODER 60 JT,5850,MIAMI/YODER ELEMENTARY SCHOOL,1ST,1,1,0,0,15,17,2,12%
1130,MIAMI/YODER 60 JT,5850,MIAMI/YODER ELEMENTARY SCHOOL,2ND,0,0,0,2,13,15,2,13%
1130,MIAMI/YODER 60 JT,5850,MIAMI/YODER ELEMENTARY SCHOOL,3RD,2,1,1,4,18,26,8,31%
1130,MIAMI/YODER 60 JT,5850,MIAMI/YODER ELEMENTARY SCHOOL,4TH,2,0,1,7,19,29,10,34%
1130,MIAMI/YODER 60 JT,5850,MIAMI/YODER ELEMENTARY SCHOOL,5TH,0,1,1,2,23,27,4,15%
1130,MIAMI/YODER 60 JT,5850,MIAMI/YODER ELEMENTARY SCHOOL,SCHOOL TOTAL,10,3,4,17,116,150,34,23%
1130,MIAMI/YODER 60 JT,5854,MIAMI-YODER SENIOR HIGH SCHOOL,9TH,2,1,0,2,22,27,5,19%
1130,MIAMI/YODER 60 JT,5854,MIAMI-YODER SENIOR HIGH SCHOOL,10TH,1,0,0,2,21,24,3,13%
1130,MIAMI/YODER 60 JT,5854,MIAMI-YODER SENIOR HIGH SCHOOL,11TH,2,1,0,5,25,33,8,24%
1130,MIAMI/YODER 60 JT,5854,MIAMI-YODER SENIOR HIGH SCHOOL,12TH,0,0,1,5,19,25,6,24%
1130,MIAMI/YODER 60 JT,5854,MIAMI-YODER SENIOR HIGH SCHOOL,SCHOOL TOTAL,5,2,1,14,87,109,22,20%
1130,MIAMI/YODER 60 JT,5870,MIAMI-YODER JUNIOR HIGH SCHOOL,6TH,2,1,2,0,10,15,5,33%
1130,MIAMI/YODER 60 JT,5870,MIAMI-YODER JUNIOR HIGH SCHOOL,7TH,1,1,0,5,24,31,7,23%
1130,MIAMI/YODER 60 JT,5870,MIAMI-YODER JUNIOR HIGH SCHOOL,8TH,0,2,1,2,19,24,5,21%
1130,MIAMI/YODER 60 JT,5870,MIAMI-YODER JUNIOR HIGH SCHOOL,SCHOOL TOTAL,3,4,3,7,53,70,17,24%
1130,MIAMI/YODER 60 JT,,DISTRICT TOTAL,,18,9,8,38,256,329,73,22%
1140,CANON CITY RE-1,1262,CANON CITY MIDDLE SCHOOL,6TH,0,1,1,5,125,132,7,5%
1140,CANON CITY RE-1,1262,CANON CITY MIDDLE SCHOOL,7TH,3,1,3,11,132,150,18,12%
1140,CANON CITY RE-1,1262,CANON CITY MIDDLE SCHOOL,8TH,3,5,3,15,148,174,26,15%
1140,CANON CITY RE-1,1262,CANON CITY MIDDLE SCHOOL,SCHOOL TOTAL,6,7,7,31,405,456,51,11%
1140,CANON CITY RE-1,1266,CANON CITY HIGH SCHOOL,9TH,1,6,5,23,230,265,35,13%
1140,CANON CITY RE-1,1266,CANON CITY HIGH SCHOOL,10TH,3,3,2,25,243,276,33,12%
1140,CANON CITY RE-1,1266,CANON CITY HIGH SCHOOL,11TH,4,7,0,23,224,258,34,13%
1140,CANON CITY RE-1,1266,CANON CITY HIGH SCHOOL,12TH,3,2,2,25,234,266,32,12%
1140,CANON CITY RE-1,1266,CANON CITY HIGH SCHOOL,SCHOOL TOTAL,11,18,9,96,931,1065,134,13%
1140,CANON CITY RE-1,3211,GARDEN PARK HIGH SCHOOL,9TH,1,0,0,3,16,20,4,20%
1140,CANON CITY RE-1,3211,GARDEN PARK HIGH SCHOOL,10TH,0,0,0,1,16,17,1,6%
1140,CANON CITY RE-1,3211,GARDEN PARK HIGH SCHOOL,11TH,1,1,0,3,17,22,5,23%
1140,CANON CITY RE-1,3211,GARDEN PARK HIGH SCHOOL,12TH,0,0,0,5,32,37,5,14%
1140,CANON CITY RE-1,3211,GARDEN PARK HIGH SCHOOL,SCHOOL TOTAL,2,1,0,12,81,96,15,16%
1140,CANON CITY RE-1,3802,HARRISON SCHOOL,KINDERGARTEN,1,0,2,14,49,66,17,26%
1140,CANON CITY RE-1,3802,HARRISON SCHOOL,1ST,0,2,0,7,52,61,9,15%
1140,CANON CITY RE-1,3802,HARRISON SCHOOL,2ND,0,0,0,6,64,70,6,9%
1140,CANON CITY RE-1,3802,HARRISON SCHOOL,3RD,0,0,0,4,47,51,4,8%
1140,CANON CITY RE-1,3802,HARRISON SCHOOL,4TH,0,2,0,8,66,76,10,13%
1140,CANON CITY RE-1,3802,HARRISON SCHOOL,5TH,1,0,1,4,57,63,6,10%
1140,CANON CITY RE-1,3802,HARRISON SCHOOL,6TH,0,0,2,10,103,115,12,10%
1140,CANON CITY RE-1,3802,HARRISON SCHOOL,7TH,1,0,1,11,106,119,13,11%
1140,CANON CITY RE-1,3802,HARRISON SCHOOL,8TH,1,1,0,15,73,90,17,19%
1140,CANON CITY RE-1,3802,HARRISON SCHOOL,SCHOOL TOTAL,4,5,6,79,617,711,94,13%
1140,CANON CITY RE-1,5166,LINCOLN ELEMENTARY SCHOOL,HALF DAY K,0,0,0,0,3,3,0,0%
1140,CANON CITY RE-1,5166,LINCOLN ELEMENTARY SCHOOL,KINDERGARTEN,0,0,0,3,34,37,3,8%
1140,CANON CITY RE-1,5166,LINCOLN ELEMENTARY SCHOOL,1ST,1,0,0,6,32,39,7,18%
1140,CANON CITY RE-1,5166,LINCOLN ELEMENTARY SCHOOL,2ND,0,0,1,2,36,39,3,8%
1140,CANON CITY RE-1,5166,LINCOLN ELEMENTARY SCHOOL,3RD,2,0,0,2,27,31,4,13%
1140,CANON CITY RE-1,5166,LINCOLN ELEMENTARY SCHOOL,4TH,1,1,0,3,34,39,5,13%
1140,CANON CITY RE-1,5166,LINCOLN ELEMENTARY SCHOOL,5TH,2,0,2,1,39,44,5,11%
1140,CANON CITY RE-1,5166,LINCOLN ELEMENTARY SCHOOL,SCHOOL TOTAL,6,1,3,17,205,232,27,12%
1140,CANON CITY RE-1,5414,MADISON EXPLORATORY SCHOOL,1ST,0,0,0,1,8,9,1,11%
1140,CANON CITY RE-1,5414,MADISON EXPLORATORY SCHOOL,2ND,0,1,0,0,13,14,1,7%
1140,CANON CITY RE-1,5414,MADISON EXPLORATORY SCHOOL,3RD,0,0,0,0,12,12,0,0%
1140,CANON CITY RE-1,5414,MADISON EXPLORATORY SCHOOL,4TH,0,0,0,0,12,12,0,0%
1140,CANON CITY RE-1,5414,MADISON EXPLORATORY SCHOOL,5TH,0,0,0,2,11,13,2,15%
1140,CANON CITY RE-1,5414,MADISON EXPLORATORY SCHOOL,6TH,0,0,0,0,9,9,0,0%
1140,CANON CITY RE-1,5414,MADISON EXPLORATORY SCHOOL,SCHOOL TOTAL,0,1,0,3,65,69,4,6%
1140,CANON CITY RE-1,5704,MCKINLEY ELEMENTARY SCHOOL,KINDERGARTEN,0,0,2,5,37,44,7,16%
1140,CANON CITY RE-1,5704,MCKINLEY ELEMENTARY SCHOOL,1ST,1,0,0,9,36,46,10,22%
1140,CANON CITY RE-1,5704,MCKINLEY ELEMENTARY SCHOOL,2ND,0,0,0,7,42,49,7,14%
1140,CANON CITY RE-1,5704,MCKINLEY ELEMENTARY SCHOOL,3RD,1,0,0,6,37,44,7,16%
1140,CANON CITY RE-1,5704,MCKINLEY ELEMENTARY SCHOOL,4TH,0,0,1,2,30,33,3,9%
1140,CANON CITY RE-1,5704,MCKINLEY ELEMENTARY SCHOOL,5TH,0,1,0,6,40,47,7,15%
1140,CANON CITY RE-1,5704,MCKINLEY ELEMENTARY SCHOOL,SCHOOL TOTAL,2,1,3,35,222,263,41,16%
1140,CANON CITY RE-1,6752,MOUNT VIEW CORE KNOWLEDGE CHARTER SCHOOL,KINDERGARTEN,1,2,0,3,19,25,6,24%
1140,CANON CITY RE-1,6752,MOUNT VIEW CORE KNOWLEDGE CHARTER SCHOOL,1ST,0,0,0,1,26,27,1,4%
1140,CANON CITY RE-1,6752,MOUNT VIEW CORE KNOWLEDGE CHARTER SCHOOL,2ND,0,1,0,3,23,27,4,15%
1140,CANON CITY RE-1,6752,MOUNT VIEW CORE KNOWLEDGE CHARTER SCHOOL,3RD,0,0,0,1,26,27,1,4%
1140,CANON CITY RE-1,6752,MOUNT VIEW CORE KNOWLEDGE CHARTER SCHOOL,4TH,0,2,0,2,23,27,4,15%
1140,CANON CITY RE-1,6752,MOUNT VIEW CORE KNOWLEDGE CHARTER SCHOOL,5TH,0,1,1,1,25,28,3,11%
1140,CANON CITY RE-1,6752,MOUNT VIEW CORE KNOWLEDGE CHARTER SCHOOL,6TH,0,0,0,3,21,24,3,13%
1140,CANON CITY RE-1,6752,MOUNT VIEW CORE KNOWLEDGE CHARTER SCHOOL,7TH,0,1,0,0,25,26,1,4%
1140,CANON CITY RE-1,6752,MOUNT VIEW CORE KNOWLEDGE CHARTER SCHOOL,8TH,0,1,0,2,18,21,3,14%
1140,CANON CITY RE-1,6752,MOUNT VIEW CORE KNOWLEDGE CHARTER SCHOOL,SCHOOL TOTAL,1,8,1,16,206,232,26,11%
1140,CANON CITY RE-1,7950,SKYLINE ELEMENTARY SCHOOL,HALF DAY K,0,0,0,0,1,1,0,0%
1140,CANON CITY RE-1,7950,SKYLINE ELEMENTARY SCHOOL,KINDERGARTEN,0,0,0,3,35,38,3,8%
1140,CANON CITY RE-1,7950,SKYLINE ELEMENTARY SCHOOL,1ST,0,0,1,6,31,38,7,18%
1140,CANON CITY RE-1,7950,SKYLINE ELEMENTARY SCHOOL,2ND,0,0,0,4,28,32,4,13%
1140,CANON CITY RE-1,7950,SKYLINE ELEMENTARY SCHOOL,3RD,0,0,0,4,43,47,4,9%
1140,CANON CITY RE-1,7950,SKYLINE ELEMENTARY SCHOOL,4TH,0,0,0,4,29,33,4,12%
1140,CANON CITY RE-1,7950,SKYLINE ELEMENTARY SCHOOL,5TH,0,0,0,5,21,26,5,19%
1140,CANON CITY RE-1,7950,SKYLINE ELEMENTARY SCHOOL,SCHOOL TOTAL,0,0,1,26,188,215,27,13%
1140,CANON CITY RE-1,9248,WASHINGTON ELEMENTARY SCHOOL,HALF DAY K,0,0,0,0,1,1,0,0%
1140,CANON CITY RE-1,9248,WASHINGTON ELEMENTARY SCHOOL,KINDERGARTEN,0,1,2,8,40,51,11,22%
1140,CANON CITY RE-1,9248,WASHINGTON ELEMENTARY SCHOOL,1ST,1,0,2,9,55,67,12,18%
1140,CANON CITY RE-1,9248,WASHINGTON ELEMENTARY SCHOOL,2ND,1,1,2,11,47,62,15,24%
1140,CANON CITY RE-1,9248,WASHINGTON ELEMENTARY SCHOOL,3RD,0,4,0,4,49,57,8,14%
1140,CANON CITY RE-1,9248,WASHINGTON ELEMENTARY SCHOOL,4TH,0,1,3,9,57,70,13,19%
1140,CANON CITY RE-1,9248,WASHINGTON ELEMENTARY SCHOOL,5TH,1,1,0,5,45,52,7,13%
1140,CANON CITY RE-1,9248,WASHINGTON ELEMENTARY SCHOOL,SCHOOL TOTAL,3,8,9,46,294,360,66,18%
1140,CANON CITY RE-1,,DISTRICT TOTAL,,35,50,39,361,3214,3699,485,13%
1150,FREMONT RE-2,3002,FLORENCE HIGH SCHOOL,9TH,0,2,3,13,105,123,18,15%
1150,FREMONT RE-2,3002,FLORENCE HIGH SCHOOL,10TH,3,1,1,12,109,126,17,13%
1150,FREMONT RE-2,3002,FLORENCE HIGH SCHOOL,11TH,1,1,6,12,117,137,20,15%
1150,FREMONT RE-2,3002,FLORENCE HIGH SCHOOL,12TH,3,1,1,15,99,119,20,17%
1150,FREMONT RE-2,3002,FLORENCE HIGH SCHOOL,SCHOOL TOTAL,7,5,11,52,430,505,75,15%
1150,FREMONT RE-2,3224,FREMONT ELEMENTARY SCHOOL,KINDERGARTEN,0,1,1,8,70,80,10,13%
1150,FREMONT RE-2,3224,FREMONT ELEMENTARY SCHOOL,1ST,1,0,0,14,55,70,15,21%
1150,FREMONT RE-2,3224,FREMONT ELEMENTARY SCHOOL,2ND,0,1,1,15,51,68,17,25%
1150,FREMONT RE-2,3224,FREMONT ELEMENTARY SCHOOL,3RD,0,0,0,13,56,69,13,19%
1150,FREMONT RE-2,3224,FREMONT ELEMENTARY SCHOOL,4TH,1,0,0,12,69,82,13,16%
1150,FREMONT RE-2,3224,FREMONT ELEMENTARY SCHOOL,5TH,1,1,0,12,63,77,14,18%
1150,FREMONT RE-2,3224,FREMONT ELEMENTARY SCHOOL,SCHOOL TOTAL,3,3,2,74,364,446,82,18%
1150,FREMONT RE-2,3226,FREMONT MIDDLE SCHOOL,6TH,2,2,0,11,99,114,15,13%
1150,FREMONT RE-2,3226,FREMONT MIDDLE SCHOOL,7TH,3,0,0,13,140,156,16,10%
1150,FREMONT RE-2,3226,FREMONT MIDDLE SCHOOL,8TH,5,2,2,14,128,151,23,15%
1150,FREMONT RE-2,3226,FREMONT MIDDLE SCHOOL,SCHOOL TOTAL,10,4,2,38,367,421,54,13%
1150,FREMONT RE-2,6858,PENROSE ELEMENTARY SCHOOL,KINDERGARTEN,0,0,1,3,36,40,4,10%
1150,FREMONT RE-2,6858,PENROSE ELEMENTARY SCHOOL,1ST,0,0,1,5,26,32,6,19%
1150,FREMONT RE-2,6858,PENROSE ELEMENTARY SCHOOL,2ND,0,0,0,10,31,41,10,24%
1150,FREMONT RE-2,6858,PENROSE ELEMENTARY SCHOOL,3RD,0,0,0,8,43,51,8,16%
1150,FREMONT RE-2,6858,PENROSE ELEMENTARY SCHOOL,4TH,0,0,2,8,37,47,10,21%
1150,FREMONT RE-2,6858,PENROSE ELEMENTARY SCHOOL,5TH,0,0,0,8,32,40,8,20%
1150,FREMONT RE-2,6858,PENROSE ELEMENTARY SCHOOL,SCHOOL TOTAL,0,0,4,42,205,251,46,18%
1150,FREMONT RE-2,,DISTRICT TOTAL,,20,12,19,206,1366,1623,257,16%
1160,COTOPAXI RE-3,3220,COTOPAXI ELEMENTARY SCHOOL,PK,0,0,0,0,18,18,0,0%
1160,COTOPAXI RE-3,3220,COTOPAXI ELEMENTARY SCHOOL,KINDERGARTEN,0,0,0,0,19,19,0,0%
1160,COTOPAXI RE-3,3220,COTOPAXI ELEMENTARY SCHOOL,1ST,0,0,0,0,17,17,0,0%
1160,COTOPAXI RE-3,3220,COTOPAXI ELEMENTARY SCHOOL,2ND,0,0,0,1,20,21,1,5%
1160,COTOPAXI RE-3,3220,COTOPAXI ELEMENTARY SCHOOL,3RD,0,0,0,0,16,16,0,0%
1160,COTOPAXI RE-3,3220,COTOPAXI ELEMENTARY SCHOOL,4TH,0,0,0,0,11,11,0,0%
1160,COTOPAXI RE-3,3220,COTOPAXI ELEMENTARY SCHOOL,5TH,0,0,0,0,12,12,0,0%
1160,COTOPAXI RE-3,3220,COTOPAXI ELEMENTARY SCHOOL,SCHOOL TOTAL,0,0,0,1,113,114,1,1%
1160,COTOPAXI RE-3,3228,COTOPAXI JUNIOR-SENIOR HIGH SCHOOL,6TH,0,0,0,0,11,11,0,0%
1160,COTOPAXI RE-3,3228,COTOPAXI JUNIOR-SENIOR HIGH SCHOOL,7TH,0,0,0,1,11,12,1,8%
1160,COTOPAXI RE-3,3228,COTOPAXI JUNIOR-SENIOR HIGH SCHOOL,8TH,0,0,0,3,11,14,3,21%
1160,COTOPAXI RE-3,3228,COTOPAXI JUNIOR-SENIOR HIGH SCHOOL,9TH,0,0,0,1,13,14,1,7%
1160,COTOPAXI RE-3,3228,COTOPAXI JUNIOR-SENIOR HIGH SCHOOL,10TH,0,0,0,1,15,16,1,6%
1160,COTOPAXI RE-3,3228,COTOPAXI JUNIOR-SENIOR HIGH SCHOOL,11TH,0,0,0,2,19,21,2,10%
1160,COTOPAXI RE-3,3228,COTOPAXI JUNIOR-SENIOR HIGH SCHOOL,12TH,0,0,0,3,19,22,3,14%
1160,COTOPAXI RE-3,3228,COTOPAXI JUNIOR-SENIOR HIGH SCHOOL,SCHOOL TOTAL,0,0,0,11,99,110,11,10%
1160,COTOPAXI RE-3,,DISTRICT TOTAL,,0,0,0,12,212,224,12,5%
1180,ROARING FORK RE-1,0429,CARBONDALE COMMUNITY CHARTER SCHOOL,KINDERGARTEN,0,0,0,3,11,14,3,21%
1180,ROARING FORK RE-1,0429,CARBONDALE COMMUNITY CHARTER SCHOOL,1ST,0,0,0,2,13,15,2,13%
1180,ROARING FORK RE-1,0429,CARBONDALE COMMUNITY CHARTER SCHOOL,2ND,0,0,0,1,13,14,1,7%
1180,ROARING FORK RE-1,0429,CARBONDALE COMMUNITY CHARTER SCHOOL,3RD,0,0,0,2,13,15,2,13%
1180,ROARING FORK RE-1,0429,CARBONDALE COMMUNITY CHARTER SCHOOL,4TH,0,2,0,2,11,15,4,27%
1180,ROARING FORK RE-1,0429,CARBONDALE COMMUNITY CHARTER SCHOOL,5TH,0,1,0,4,10,15,5,33%
1180,ROARING FORK RE-1,0429,CARBONDALE COMMUNITY CHARTER SCHOOL,6TH,0,1,0,2,12,15,3,20%
1180,ROARING FORK RE-1,0429,CARBONDALE COMMUNITY CHARTER SCHOOL,7TH,0,0,0,1,13,14,1,7%
1180,ROARING FORK RE-1,0429,CARBONDALE COMMUNITY CHARTER SCHOOL,8TH,0,0,0,3,12,15,3,20%
1180,ROARING FORK RE-1,0429,CARBONDALE COMMUNITY CHARTER SCHOOL,SCHOOL TOTAL,0,4,0,20,108,132,24,18%
1180,ROARING FORK RE-1,0560,BASALT ELEMENTARY SCHOOL,PK,0,0,0,23,6,29,23,79%
1180,ROARING FORK RE-1,0560,BASALT ELEMENTARY SCHOOL,HALF DAY K,0,1,0,2,14,17,3,18%
1180,ROARING FORK RE-1,0560,BASALT ELEMENTARY SCHOOL,KINDERGARTEN,0,5,0,41,54,100,46,46%
1180,ROARING FORK RE-1,0560,BASALT ELEMENTARY SCHOOL,1ST,0,4,0,86,74,164,90,55%
1180,ROARING FORK RE-1,0560,BASALT ELEMENTARY SCHOOL,2ND,0,0,0,58,71,129,58,45%
1180,ROARING FORK RE-1,0560,BASALT ELEMENTARY SCHOOL,3RD,0,2,1,51,60,114,54,47%
1180,ROARING FORK RE-1,0560,BASALT ELEMENTARY SCHOOL,4TH,0,2,0,60,54,116,62,53%
1180,ROARING FORK RE-1,0560,BASALT ELEMENTARY SCHOOL,SCHOOL TOTAL,0,14,1,321,333,669,336,50%
1180,ROARING FORK RE-1,0561,BASALT MIDDLE SCHOOL,5TH,1,2,0,50,49,102,53,52%
1180,ROARING FORK RE-1,0561,BASALT MIDDLE SCHOOL,6TH,0,2,2,58,45,107,62,58%
1180,ROARING FORK RE-1,0561,BASALT MIDDLE SCHOOL,7TH,0,0,0,52,47,99,52,53%
1180,ROARING FORK RE-1,0561,BASALT MIDDLE SCHOOL,8TH,0,2,2,65,53,122,69,57%
1180,ROARING FORK RE-1,0561,BASALT MIDDLE SCHOOL,SCHOOL TOTAL,1,6,4,225,194,430,236,55%
1180,ROARING FORK RE-1,0570,BASALT HIGH SCHOOL,9TH,0,1,0,60,47,108,61,56%
1180,ROARING FORK RE-1,0570,BASALT HIGH SCHOOL,10TH,0,3,2,36,67,108,41,38%
1180,ROARING FORK RE-1,0570,BASALT HIGH SCHOOL,11TH,0,0,0,52,50,102,52,51%
1180,ROARING FORK RE-1,0570,BASALT HIGH SCHOOL,12TH,0,0,1,48,77,126,49,39%
1180,ROARING FORK RE-1,0570,BASALT HIGH SCHOOL,SCHOOL TOTAL,0,4,3,196,241,444,203,46%
1180,ROARING FORK RE-1,1006,BRIDGES,9TH,0,0,0,3,5,8,3,38%
1180,ROARING FORK RE-1,1006,BRIDGES,10TH,0,0,0,6,12,18,6,33%
1180,ROARING FORK RE-1,1006,BRIDGES,11TH,0,0,0,5,17,22,5,23%
1180,ROARING FORK RE-1,1006,BRIDGES,12TH,1,0,0,8,26,35,9,26%
1180,ROARING FORK RE-1,1006,BRIDGES,SCHOOL TOTAL,1,0,0,22,60,83,23,28%
1180,ROARING FORK RE-1,1296,CARBONDALE MIDDLE SCHOOL,5TH,0,0,0,58,25,83,58,70%
1180,ROARING FORK RE-1,1296,CARBONDALE MIDDLE SCHOOL,6TH,1,1,0,55,22,79,57,72%
1180,ROARING FORK RE-1,1296,CARBONDALE MIDDLE SCHOOL,7TH,0,0,0,54,20,74,54,73%
1180,ROARING FORK RE-1,1296,CARBONDALE MIDDLE SCHOOL,8TH,1,2,1,52,21,77,56,73%
1180,ROARING FORK RE-1,1296,CARBONDALE MIDDLE SCHOOL,SCHOOL TOTAL,2,3,1,219,88,313,225,72%
1180,ROARING FORK RE-1,2063,CRYSTAL RIVER ELEMENTARY SCHOOL,PK,1,1,0,30,5,37,32,86%
1180,ROARING FORK RE-1,2063,CRYSTAL RIVER ELEMENTARY SCHOOL,HALF DAY K,1,1,0,21,7,30,23,77%
1180,ROARING FORK RE-1,2063,CRYSTAL RIVER ELEMENTARY SCHOOL,KINDERGARTEN,0,1,0,39,15,55,40,73%
1180,ROARING FORK RE-1,2063,CRYSTAL RIVER ELEMENTARY SCHOOL,1ST,0,1,0,89,22,112,90,80%
1180,ROARING FORK RE-1,2063,CRYSTAL RIVER ELEMENTARY SCHOOL,2ND,2,2,0,54,28,86,58,67%
1180,ROARING FORK RE-1,2063,CRYSTAL RIVER ELEMENTARY SCHOOL,3RD,0,1,0,63,16,80,64,80%
1180,ROARING FORK RE-1,2063,CRYSTAL RIVER ELEMENTARY SCHOOL,4TH,2,0,0,71,24,97,73,75%
1180,ROARING FORK RE-1,2063,CRYSTAL RIVER ELEMENTARY SCHOOL,SCHOOL TOTAL,6,7,0,367,117,497,380,76%
1180,ROARING FORK RE-1,3460,GLENWOOD SPRINGS ELEMENTARY SCHOOL,PK,0,0,0,12,7,19,12,63%
1180,ROARING FORK RE-1,3460,GLENWOOD SPRINGS ELEMENTARY SCHOOL,HALF DAY K,1,0,0,18,17,36,19,53%
1180,ROARING FORK RE-1,3460,GLENWOOD SPRINGS ELEMENTARY SCHOOL,KINDERGARTEN,0,0,0,33,21,54,33,61%
1180,ROARING FORK RE-1,3460,GLENWOOD SPRINGS ELEMENTARY SCHOOL,1ST,0,0,0,54,38,92,54,59%
1180,ROARING FORK RE-1,3460,GLENWOOD SPRINGS ELEMENTARY SCHOOL,2ND,1,0,1,54,39,95,56,59%
1180,ROARING FORK RE-1,3460,GLENWOOD SPRINGS ELEMENTARY SCHOOL,3RD,0,0,0,49,35,84,49,58%
1180,ROARING FORK RE-1,3460,GLENWOOD SPRINGS ELEMENTARY SCHOOL,4TH,1,2,0,48,33,84,51,61%
1180,ROARING FORK RE-1,3460,GLENWOOD SPRINGS ELEMENTARY SCHOOL,5TH,1,0,0,34,28,63,35,56%
1180,ROARING FORK RE-1,3460,GLENWOOD SPRINGS ELEMENTARY SCHOOL,SCHOOL TOTAL,4,2,1,302,218,527,309,59%
1180,ROARING FORK RE-1,3464,GLENWOOD SPRINGS MIDDLE SCHOOL,6TH,1,4,0,80,83,168,85,51%
1180,ROARING FORK RE-1,3464,GLENWOOD SPRINGS MIDDLE SCHOOL,7TH,1,0,1,78,106,186,80,43%
1180,ROARING FORK RE-1,3464,GLENWOOD SPRINGS MIDDLE SCHOOL,8TH,1,1,0,64,91,157,66,42%
1180,ROARING FORK RE-1,3464,GLENWOOD SPRINGS MIDDLE SCHOOL,SCHOOL TOTAL,3,5,1,222,280,511,231,45%
1180,ROARING FORK RE-1,3468,GLENWOOD SPRINGS HIGH SCHOOL,9TH,1,2,0,96,145,244,99,41%
1180,ROARING FORK RE-1,3468,GLENWOOD SPRINGS HIGH SCHOOL,10TH,2,1,0,76,126,205,79,39%
1180,ROARING FORK RE-1,3468,GLENWOOD SPRINGS HIGH SCHOOL,11TH,2,3,0,73,94,172,78,45%
1180,ROARING FORK RE-1,3468,GLENWOOD SPRINGS HIGH SCHOOL,12TH,2,1,0,35,110,148,38,26%
1180,ROARING FORK RE-1,3468,GLENWOOD SPRINGS HIGH SCHOOL,SCHOOL TOTAL,7,7,0,280,475,769,294,38%
1180,ROARING FORK RE-1,7422,ROARING FORK HIGH SCHOOL,9TH,2,1,0,56,30,89,59,66%
1180,ROARING FORK RE-1,7422,ROARING FORK HIGH SCHOOL,10TH,1,2,0,50,24,77,53,69%
1180,ROARING FORK RE-1,7422,ROARING FORK HIGH SCHOOL,11TH,0,2,0,54,28,84,56,67%
1180,ROARING FORK RE-1,7422,ROARING FORK HIGH SCHOOL,12TH,0,2,0,41,22,65,43,66%
1180,ROARING FORK RE-1,7422,ROARING FORK HIGH SCHOOL,SCHOOL TOTAL,3,7,0,201,104,315,211,67%
1180,ROARING FORK RE-1,8038,SOPRIS ELEMENTARY SCHOOL,PK,1,1,0,16,10,28,18,64%
1180,ROARING FORK RE-1,8038,SOPRIS ELEMENTARY SCHOOL,HALF DAY K,0,0,0,20,12,32,20,63%
1180,ROARING FORK RE-1,8038,SOPRIS ELEMENTARY SCHOOL,KINDERGARTEN,0,1,0,26,45,72,27,38%
1180,ROARING FORK RE-1,8038,SOPRIS ELEMENTARY SCHOOL,1ST,0,1,0,42,60,103,43,42%
1180,ROARING FORK RE-1,8038,SOPRIS ELEMENTARY SCHOOL,2ND,1,1,0,50,48,100,52,52%
1180,ROARING FORK RE-1,8038,SOPRIS ELEMENTARY SCHOOL,3RD,1,1,0,49,59,110,51,46%
1180,ROARING FORK RE-1,8038,SOPRIS ELEMENTARY SCHOOL,4TH,2,0,1,41,73,117,44,38%
1180,ROARING FORK RE-1,8038,SOPRIS ELEMENTARY SCHOOL,5TH,0,3,0,42,47,92,45,49%
1180,ROARING FORK RE-1,8038,SOPRIS ELEMENTARY SCHOOL,SCHOOL TOTAL,5,8,1,286,354,654,300,46%
1180,ROARING FORK RE-1,,DISTRICT TOTAL,,32,67,12,2661,2572,5344,2772,52%
1195,GARFIELD RE-2,0065,COAL RIDGE HIGH SCHOOL,9TH,0,0,1,44,82,127,45,35%
1195,GARFIELD RE-2,0065,COAL RIDGE HIGH SCHOOL,10TH,1,1,1,32,69,104,35,34%
1195,GARFIELD RE-2,0065,COAL RIDGE HIGH SCHOOL,11TH,0,0,0,45,73,118,45,38%
1195,GARFIELD RE-2,0065,COAL RIDGE HIGH SCHOOL,12TH,1,0,1,27,80,109,29,27%
1195,GARFIELD RE-2,0065,COAL RIDGE HIGH SCHOOL,SCHOOL TOTAL,2,1,3,148,304,458,154,34%
1195,GARFIELD RE-2,2573,ELK CREEK ELEMENTARY,PK,0,0,1,10,15,26,11,42%
1195,GARFIELD RE-2,2573,ELK CREEK ELEMENTARY,HALF DAY K,0,0,0,7,12,19,7,37%
1195,GARFIELD RE-2,2573,ELK CREEK ELEMENTARY,KINDERGARTEN,0,0,0,12,26,38,12,32%
1195,GARFIELD RE-2,2573,ELK CREEK ELEMENTARY,1ST,0,1,1,19,29,50,21,42%
1195,GARFIELD RE-2,2573,ELK CREEK ELEMENTARY,2ND,0,0,1,21,27,49,22,45%
1195,GARFIELD RE-2,2573,ELK CREEK ELEMENTARY,3RD,0,0,0,20,30,50,20,40%
1195,GARFIELD RE-2,2573,ELK CREEK ELEMENTARY,4TH,0,0,1,18,34,53,19,36%
1195,GARFIELD RE-2,2573,ELK CREEK ELEMENTARY,SCHOOL TOTAL,0,1,4,107,173,285,112,39%
1195,GARFIELD RE-2,3281,GRAHAM MESA ELEMENTARY SCHOOL,PK,3,0,0,10,11,24,13,54%
1195,GARFIELD RE-2,3281,GRAHAM MESA ELEMENTARY SCHOOL,HALF DAY K,1,0,0,15,25,41,16,39%
1195,GARFIELD RE-2,3281,GRAHAM MESA ELEMENTARY SCHOOL,KINDERGARTEN,0,0,0,10,9,19,10,53%
1195,GARFIELD RE-2,3281,GRAHAM MESA ELEMENTARY SCHOOL,1ST,0,0,1,26,31,58,27,47%
1195,GARFIELD RE-2,3281,GRAHAM MESA ELEMENTARY SCHOOL,2ND,0,0,1,26,34,61,27,44%
1195,GARFIELD RE-2,3281,GRAHAM MESA ELEMENTARY SCHOOL,3RD,2,1,0,18,45,66,21,32%
1195,GARFIELD RE-2,3281,GRAHAM MESA ELEMENTARY SCHOOL,4TH,0,0,1,28,33,62,29,47%
1195,GARFIELD RE-2,3281,GRAHAM MESA ELEMENTARY SCHOOL,SCHOOL TOTAL,6,1,3,133,188,331,143,43%
1195,GARFIELD RE-2,3325,GARFIELD RE-2 CENTER FOR INTEGRATIVE STUDIES,9TH,0,1,3,3,21,28,7,25%
1195,GARFIELD RE-2,3325,GARFIELD RE-2 CENTER FOR INTEGRATIVE STUDIES,10TH,1,1,9,24,62,97,35,36%
1195,GARFIELD RE-2,3325,GARFIELD RE-2 CENTER FOR INTEGRATIVE STUDIES,11TH,5,1,6,19,77,108,31,29%
1195,GARFIELD RE-2,3325,GARFIELD RE-2 CENTER FOR INTEGRATIVE STUDIES,12TH,3,2,6,18,76,105,29,28%
1195,GARFIELD RE-2,3325,GARFIELD RE-2 CENTER FOR INTEGRATIVE STUDIES,SCHOOL TOTAL,9,5,24,64,236,338,102,30%
1195,GARFIELD RE-2,3967,HIGHLAND ELEMENTARY SCHOOL,PK,0,0,0,19,8,27,19,70%
1195,GARFIELD RE-2,3967,HIGHLAND ELEMENTARY SCHOOL,HALF DAY K,0,0,0,16,20,36,16,44%
1195,GARFIELD RE-2,3967,HIGHLAND ELEMENTARY SCHOOL,KINDERGARTEN,0,1,0,24,14,39,25,64%
1195,GARFIELD RE-2,3967,HIGHLAND ELEMENTARY SCHOOL,1ST,0,0,0,41,28,69,41,59%
1195,GARFIELD RE-2,3967,HIGHLAND ELEMENTARY SCHOOL,2ND,0,0,0,30,35,65,30,46%
1195,GARFIELD RE-2,3967,HIGHLAND ELEMENTARY SCHOOL,3RD,0,0,0,38,28,66,38,58%
1195,GARFIELD RE-2,3967,HIGHLAND ELEMENTARY SCHOOL,4TH,1,1,0,35,30,67,37,55%
1195,GARFIELD RE-2,3967,HIGHLAND ELEMENTARY SCHOOL,SCHOOL TOTAL,1,2,0,203,163,369,206,56%
1195,GARFIELD RE-2,4510,KATHRYN SENOR ELEMENTARY SCHOOL,PK,0,0,0,9,19,28,9,32%
1195,GARFIELD RE-2,4510,KATHRYN SENOR ELEMENTARY SCHOOL,HALF DAY K,0,0,0,10,11,21,10,48%
1195,GARFIELD RE-2,4510,KATHRYN SENOR ELEMENTARY SCHOOL,KINDERGARTEN,0,1,0,14,27,42,15,36%
1195,GARFIELD RE-2,4510,KATHRYN SENOR ELEMENTARY SCHOOL,1ST,1,1,0,23,34,59,25,42%
1195,GARFIELD RE-2,4510,KATHRYN SENOR ELEMENTARY SCHOOL,2ND,0,0,1,20,47,68,21,31%
1195,GARFIELD RE-2,4510,KATHRYN SENOR ELEMENTARY SCHOOL,3RD,0,1,0,26,40,67,27,40%
1195,GARFIELD RE-2,4510,KATHRYN SENOR ELEMENTARY SCHOOL,4TH,1,1,0,22,48,72,24,33%
1195,GARFIELD RE-2,4510,KATHRYN SENOR ELEMENTARY SCHOOL,SCHOOL TOTAL,2,4,1,124,226,357,131,37%
1195,GARFIELD RE-2,7356,RIFLE MIDDLE SCHOOL,5TH,1,0,0,93,104,198,94,47%
1195,GARFIELD RE-2,7356,RIFLE MIDDLE SCHOOL,6TH,1,2,1,81,81,166,85,51%
1195,GARFIELD RE-2,7356,RIFLE MIDDLE SCHOOL,7TH,1,0,1,98,90,190,100,53%
1195,GARFIELD RE-2,7356,RIFLE MIDDLE SCHOOL,8TH,4,1,1,70,102,178,76,43%
1195,GARFIELD RE-2,7356,RIFLE MIDDLE SCHOOL,SCHOOL TOTAL,7,3,3,342,377,732,355,48%
1195,GARFIELD RE-2,7360,RIFLE HIGH SCHOOL,9TH,1,0,0,82,92,175,83,47%
1195,GARFIELD RE-2,7360,RIFLE HIGH SCHOOL,10TH,0,1,1,68,90,160,70,44%
1195,GARFIELD RE-2,7360,RIFLE HIGH SCHOOL,11TH,1,3,0,48,80,132,52,39%
1195,GARFIELD RE-2,7360,RIFLE HIGH SCHOOL,12TH,0,2,0,42,104,148,44,30%
1195,GARFIELD RE-2,7360,RIFLE HIGH SCHOOL,SCHOOL TOTAL,2,6,1,240,366,615,249,40%
1195,GARFIELD RE-2,7388,RIVERSIDE SCHOOL,5TH,2,1,0,74,113,190,77,41%
1195,GARFIELD RE-2,7388,RIVERSIDE SCHOOL,6TH,2,1,2,61,108,174,66,38%
1195,GARFIELD RE-2,7388,RIVERSIDE SCHOOL,7TH,1,1,0,82,97,181,84,46%
1195,GARFIELD RE-2,7388,RIVERSIDE SCHOOL,8TH,1,2,3,56,89,151,62,41%
1195,GARFIELD RE-2,7388,RIVERSIDE SCHOOL,SCHOOL TOTAL,6,5,5,273,407,696,289,42%
1195,GARFIELD RE-2,7890,CACTUS VALLEY ELEMENTARY SCHOOL,PK,0,1,1,9,18,29,11,38%
1195,GARFIELD RE-2,7890,CACTUS VALLEY ELEMENTARY SCHOOL,HALF DAY K,0,0,1,12,22,35,13,37%
1195,GARFIELD RE-2,7890,CACTUS VALLEY ELEMENTARY SCHOOL,KINDERGARTEN,1,1,0,16,22,40,18,45%
1195,GARFIELD RE-2,7890,CACTUS VALLEY ELEMENTARY SCHOOL,1ST,0,0,1,30,54,85,31,36%
1195,GARFIELD RE-2,7890,CACTUS VALLEY ELEMENTARY SCHOOL,2ND,0,1,2,28,49,80,31,39%
1195,GARFIELD RE-2,7890,CACTUS VALLEY ELEMENTARY SCHOOL,3RD,3,1,1,32,44,81,37,46%
1195,GARFIELD RE-2,7890,CACTUS VALLEY ELEMENTARY SCHOOL,4TH,1,0,1,37,53,92,39,42%
1195,GARFIELD RE-2,7890,CACTUS VALLEY ELEMENTARY SCHOOL,SCHOOL TOTAL,5,4,7,164,262,442,180,41%
1195,GARFIELD RE-2,9231,WAMSLEY ELEMENTARY SCHOOL,PK,1,0,1,13,10,25,15,60%
1195,GARFIELD RE-2,9231,WAMSLEY ELEMENTARY SCHOOL,HALF DAY K,0,0,1,14,9,24,15,63%
1195,GARFIELD RE-2,9231,WAMSLEY ELEMENTARY SCHOOL,KINDERGARTEN,0,0,0,24,13,37,24,65%
1195,GARFIELD RE-2,9231,WAMSLEY ELEMENTARY SCHOOL,1ST,0,0,0,30,20,50,30,60%
1195,GARFIELD RE-2,9231,WAMSLEY ELEMENTARY SCHOOL,2ND,0,1,0,33,23,57,34,60%
1195,GARFIELD RE-2,9231,WAMSLEY ELEMENTARY SCHOOL,3RD,0,0,0,30,32,62,30,48%
1195,GARFIELD RE-2,9231,WAMSLEY ELEMENTARY SCHOOL,4TH,1,1,0,29,26,57,31,54%
1195,GARFIELD RE-2,9231,WAMSLEY ELEMENTARY SCHOOL,SCHOOL TOTAL,2,2,2,173,133,312,179,57%
1195,GARFIELD RE-2,,DISTRICT TOTAL,,42,34,53,1971,2835,4935,2100,43%
1220,GARFIELD 16,3578,BEA UNDERWOOD ELEMENTARY SCHOOL,1ST,2,1,2,37,51,93,42,45%
1220,GARFIELD 16,3578,BEA UNDERWOOD ELEMENTARY SCHOOL,2ND,1,0,0,28,67,96,29,30%
1220,GARFIELD 16,3578,BEA UNDERWOOD ELEMENTARY SCHOOL,3RD,2,0,0,23,53,78,25,32%
1220,GARFIELD 16,3578,BEA UNDERWOOD ELEMENTARY SCHOOL,SCHOOL TOTAL,5,1,2,88,171,267,96,36%
1220,GARFIELD 16,3585,GRAND VALLEY CENTER FOR FAMILY LEARNING,PK,1,1,0,36,67,105,38,36%
1220,GARFIELD 16,3585,GRAND VALLEY CENTER FOR FAMILY LEARNING,HALF DAY K,0,0,0,16,27,43,16,37%
1220,GARFIELD 16,3585,GRAND VALLEY CENTER FOR FAMILY LEARNING,KINDERGARTEN,1,0,2,8,24,35,11,31%
1220,GARFIELD 16,3585,GRAND VALLEY CENTER FOR FAMILY LEARNING,SCHOOL TOTAL,2,1,2,60,118,183,65,36%
1220,GARFIELD 16,3586,GRAND VALLEY HIGH SCHOOL,9TH,1,0,3,32,54,90,36,40%
1220,GARFIELD 16,3586,GRAND VALLEY HIGH SCHOOL,10TH,1,1,1,21,59,83,24,29%
1220,GARFIELD 16,3586,GRAND VALLEY HIGH SCHOOL,11TH,1,0,0,20,70,91,21,23%
1220,GARFIELD 16,3586,GRAND VALLEY HIGH SCHOOL,12TH,0,2,0,26,60,88,28,32%
1220,GARFIELD 16,3586,GRAND VALLEY HIGH SCHOOL,SCHOOL TOTAL,3,3,4,99,243,352,109,31%
1220,GARFIELD 16,3603,L.W. ST. JOHN ELEMENTARY SCHOOL,4TH,3,0,1,27,55,86,31,36%
1220,GARFIELD 16,3603,L.W. ST. JOHN ELEMENTARY SCHOOL,5TH,2,1,1,21,59,84,25,30%
1220,GARFIELD 16,3603,L.W. ST. JOHN ELEMENTARY SCHOOL,SCHOOL TOTAL,5,1,2,48,114,170,56,33%
1220,GARFIELD 16,8274,GRAND VALLEY MIDDLE SCHOOL,6TH,3,1,0,26,53,83,30,36%
1220,GARFIELD 16,8274,GRAND VALLEY MIDDLE SCHOOL,7TH,1,1,0,34,48,84,36,43%
1220,GARFIELD 16,8274,GRAND VALLEY MIDDLE SCHOOL,8TH,4,3,3,27,53,90,37,41%
1220,GARFIELD 16,8274,GRAND VALLEY MIDDLE SCHOOL,SCHOOL TOTAL,8,5,3,87,154,257,103,40%
1220,GARFIELD 16,,DISTRICT TOTAL,,23,11,13,382,800,1229,429,35%
1330,GILPIN COUNTY RE-1,1632,GILPIN COUNTY ELEMENTARY SCHOOL,PK,0,1,0,2,42,45,3,7%
1330,GILPIN COUNTY RE-1,1632,GILPIN COUNTY ELEMENTARY SCHOOL,HALF DAY K,0,0,0,0,4,4,0,0%
1330,GILPIN COUNTY RE-1,1632,GILPIN COUNTY ELEMENTARY SCHOOL,KINDERGARTEN,0,1,0,5,20,26,6,23%
1330,GILPIN COUNTY RE-1,1632,GILPIN COUNTY ELEMENTARY SCHOOL,1ST,0,0,2,5,23,30,7,23%
1330,GILPIN COUNTY RE-1,1632,GILPIN COUNTY ELEMENTARY SCHOOL,2ND,0,0,0,1,33,34,1,3%
1330,GILPIN COUNTY RE-1,1632,GILPIN COUNTY ELEMENTARY SCHOOL,3RD,0,2,0,2,26,30,4,13%
1330,GILPIN COUNTY RE-1,1632,GILPIN COUNTY ELEMENTARY SCHOOL,4TH,0,0,0,1,30,31,1,3%
1330,GILPIN COUNTY RE-1,1632,GILPIN COUNTY ELEMENTARY SCHOOL,5TH,0,0,1,1,20,22,2,9%
1330,GILPIN COUNTY RE-1,1632,GILPIN COUNTY ELEMENTARY SCHOOL,SCHOOL TOTAL,0,4,3,17,198,222,24,11%
1330,GILPIN COUNTY RE-1,1634,GILPIN COUNTY UNDIVIDED HIGH SCHOOL,6TH,0,0,0,2,15,17,2,12%
1330,GILPIN COUNTY RE-1,1634,GILPIN COUNTY UNDIVIDED HIGH SCHOOL,7TH,0,1,0,2,21,24,3,13%
1330,GILPIN COUNTY RE-1,1634,GILPIN COUNTY UNDIVIDED HIGH SCHOOL,8TH,0,0,0,1,18,19,1,5%
1330,GILPIN COUNTY RE-1,1634,GILPIN COUNTY UNDIVIDED HIGH SCHOOL,9TH,0,0,0,2,18,20,2,10%
1330,GILPIN COUNTY RE-1,1634,GILPIN COUNTY UNDIVIDED HIGH SCHOOL,10TH,0,0,0,1,22,23,1,4%
1330,GILPIN COUNTY RE-1,1634,GILPIN COUNTY UNDIVIDED HIGH SCHOOL,11TH,1,0,0,3,16,20,4,20%
1330,GILPIN COUNTY RE-1,1634,GILPIN COUNTY UNDIVIDED HIGH SCHOOL,12TH,1,0,0,1,14,16,2,13%
1330,GILPIN COUNTY RE-1,1634,GILPIN COUNTY UNDIVIDED HIGH SCHOOL,SCHOOL TOTAL,2,1,0,12,124,139,15,11%
1330,GILPIN COUNTY RE-1,,DISTRICT TOTAL,,2,5,3,29,322,361,39,11%
1340,WEST GRAND 1-JT.,9416,WEST GRAND ELEMENTARY SCHOOL,KINDERGARTEN,1,0,0,6,28,35,7,20%
1340,WEST GRAND 1-JT.,9416,WEST GRAND ELEMENTARY SCHOOL,1ST,0,0,0,11,32,43,11,26%
1340,WEST GRAND 1-JT.,9416,WEST GRAND ELEMENTARY SCHOOL,2ND,0,0,0,9,28,37,9,24%
1340,WEST GRAND 1-JT.,9416,WEST GRAND ELEMENTARY SCHOOL,3RD,0,0,0,9,26,35,9,26%
1340,WEST GRAND 1-JT.,9416,WEST GRAND ELEMENTARY SCHOOL,4TH,0,0,0,7,28,35,7,20%
1340,WEST GRAND 1-JT.,9416,WEST GRAND ELEMENTARY SCHOOL,5TH,0,1,0,8,36,45,9,20%
1340,WEST GRAND 1-JT.,9416,WEST GRAND ELEMENTARY SCHOOL,SCHOOL TOTAL,1,1,0,50,178,230,52,23%
1340,WEST GRAND 1-JT.,9420,WEST GRAND HIGH SCHOOL,9TH,0,1,0,5,23,29,6,21%
1340,WEST GRAND 1-JT.,9420,WEST GRAND HIGH SCHOOL,10TH,0,0,0,1,26,27,1,4%
1340,WEST GRAND 1-JT.,9420,WEST GRAND HIGH SCHOOL,11TH,0,1,0,2,21,24,3,13%
1340,WEST GRAND 1-JT.,9420,WEST GRAND HIGH SCHOOL,12TH,0,0,0,0,28,28,0,0%
1340,WEST GRAND 1-JT.,9420,WEST GRAND HIGH SCHOOL,SCHOOL TOTAL,0,2,0,8,98,108,10,9%
1340,WEST GRAND 1-JT.,9422,WEST GRAND MIDDLE SCHOOL,6TH,0,0,0,6,31,37,6,16%
1340,WEST GRAND 1-JT.,9422,WEST GRAND MIDDLE SCHOOL,7TH,0,0,0,5,25,30,5,17%
1340,WEST GRAND 1-JT.,9422,WEST GRAND MIDDLE SCHOOL,8TH,0,1,0,3,42,46,4,9%
1340,WEST GRAND 1-JT.,9422,WEST GRAND MIDDLE SCHOOL,SCHOOL TOTAL,0,1,0,14,98,113,15,13%
1340,WEST GRAND 1-JT.,,DISTRICT TOTAL,,1,4,0,72,374,451,77,17%
1350,EAST GRAND 2,2376,EAST GRAND MIDDLE SCHOOL,6TH,0,2,0,12,87,101,14,14%
1350,EAST GRAND 2,2376,EAST GRAND MIDDLE SCHOOL,7TH,0,0,1,10,79,90,11,12%
1350,EAST GRAND 2,2376,EAST GRAND MIDDLE SCHOOL,8TH,0,0,1,6,74,81,7,9%
1350,EAST GRAND 2,2376,EAST GRAND MIDDLE SCHOOL,SCHOOL TOTAL,0,2,2,28,240,272,32,12%
1350,EAST GRAND 2,3182,FRASER VALLEY ELEMENTARY SCHOOL,PK,0,0,0,6,9,15,6,40%
1350,EAST GRAND 2,3182,FRASER VALLEY ELEMENTARY SCHOOL,KINDERGARTEN,0,3,0,6,36,45,9,20%
1350,EAST GRAND 2,3182,FRASER VALLEY ELEMENTARY SCHOOL,1ST,1,2,1,5,36,45,9,20%
1350,EAST GRAND 2,3182,FRASER VALLEY ELEMENTARY SCHOOL,2ND,0,1,0,6,38,45,7,16%
1350,EAST GRAND 2,3182,FRASER VALLEY ELEMENTARY SCHOOL,3RD,0,0,0,3,50,53,3,6%
1350,EAST GRAND 2,3182,FRASER VALLEY ELEMENTARY SCHOOL,4TH,0,0,1,4,41,46,5,11%
1350,EAST GRAND 2,3182,FRASER VALLEY ELEMENTARY SCHOOL,5TH,0,0,0,4,30,34,4,12%
1350,EAST GRAND 2,3182,FRASER VALLEY ELEMENTARY SCHOOL,SCHOOL TOTAL,1,6,2,34,240,283,43,15%
1350,EAST GRAND 2,3556,GRANBY ELEMENTARY SCHOOL,PK,2,0,1,7,32,42,10,24%
1350,EAST GRAND 2,3556,GRANBY ELEMENTARY SCHOOL,KINDERGARTEN,0,2,0,10,36,48,12,25%
1350,EAST GRAND 2,3556,GRANBY ELEMENTARY SCHOOL,1ST,0,2,0,7,54,63,9,14%
1350,EAST GRAND 2,3556,GRANBY ELEMENTARY SCHOOL,2ND,0,1,1,5,37,44,7,16%
1350,EAST GRAND 2,3556,GRANBY ELEMENTARY SCHOOL,3RD,0,1,0,7,38,46,8,17%
1350,EAST GRAND 2,3556,GRANBY ELEMENTARY SCHOOL,4TH,0,0,0,7,57,64,7,11%
1350,EAST GRAND 2,3556,GRANBY ELEMENTARY SCHOOL,5TH,1,0,1,3,41,46,5,11%
1350,EAST GRAND 2,3556,GRANBY ELEMENTARY SCHOOL,SCHOOL TOTAL,3,6,3,46,295,353,58,16%
1350,EAST GRAND 2,3572,GRAND LAKE ELEMENTARY SCHOOL,KINDERGARTEN,0,0,0,1,7,8,1,13%
1350,EAST GRAND 2,3572,GRAND LAKE ELEMENTARY SCHOOL,1ST,0,0,0,0,9,9,0,0%
1350,EAST GRAND 2,3572,GRAND LAKE ELEMENTARY SCHOOL,2ND,0,0,0,2,8,10,2,20%
1350,EAST GRAND 2,3572,GRAND LAKE ELEMENTARY SCHOOL,3RD,0,0,0,0,8,8,0,0%
1350,EAST GRAND 2,3572,GRAND LAKE ELEMENTARY SCHOOL,4TH,0,0,0,0,13,13,0,0%
1350,EAST GRAND 2,3572,GRAND LAKE ELEMENTARY SCHOOL,5TH,0,0,0,0,13,13,0,0%
1350,EAST GRAND 2,3572,GRAND LAKE ELEMENTARY SCHOOL,SCHOOL TOTAL,0,0,0,3,58,61,3,5%
1350,EAST GRAND 2,4277,INDIAN PEAKS CHARTER SCHOOL,KINDERGARTEN,0,0,0,0,5,5,0,0%
1350,EAST GRAND 2,4277,INDIAN PEAKS CHARTER SCHOOL,1ST,0,0,0,0,6,6,0,0%
1350,EAST GRAND 2,4277,INDIAN PEAKS CHARTER SCHOOL,2ND,0,0,0,0,6,6,0,0%
1350,EAST GRAND 2,4277,INDIAN PEAKS CHARTER SCHOOL,3RD,0,0,1,0,3,4,1,25%
1350,EAST GRAND 2,4277,INDIAN PEAKS CHARTER SCHOOL,4TH,0,0,0,0,4,4,0,0%
1350,EAST GRAND 2,4277,INDIAN PEAKS CHARTER SCHOOL,5TH,0,0,0,0,5,5,0,0%
1350,EAST GRAND 2,4277,INDIAN PEAKS CHARTER SCHOOL,6TH,0,0,0,0,6,6,0,0%
1350,EAST GRAND 2,4277,INDIAN PEAKS CHARTER SCHOOL,7TH,0,0,0,0,5,5,0,0%
1350,EAST GRAND 2,4277,INDIAN PEAKS CHARTER SCHOOL,8TH,0,1,0,0,9,10,1,10%
1350,EAST GRAND 2,4277,INDIAN PEAKS CHARTER SCHOOL,SCHOOL TOTAL,0,1,1,0,49,51,2,4%
1350,EAST GRAND 2,5864,MIDDLE PARK HIGH SCHOOL,9TH,0,3,0,7,95,105,10,10%
1350,EAST GRAND 2,5864,MIDDLE PARK HIGH SCHOOL,10TH,3,2,2,12,91,110,19,17%
1350,EAST GRAND 2,5864,MIDDLE PARK HIGH SCHOOL,11TH,1,3,0,7,83,94,11,12%
1350,EAST GRAND 2,5864,MIDDLE PARK HIGH SCHOOL,12TH,0,1,0,14,94,109,15,14%
1350,EAST GRAND 2,5864,MIDDLE PARK HIGH SCHOOL,SCHOOL TOTAL,4,9,2,40,363,418,55,13%
1350,EAST GRAND 2,,DISTRICT TOTAL,,8,24,10,151,1245,1438,193,13%
1360,GUNNISON WATERSHED RE1J,2006,CRESTED BUTTE COMMUNITY SCHOOL,HALF DAY K,0,0,0,0,24,24,0,0%
1360,GUNNISON WATERSHED RE1J,2006,CRESTED BUTTE COMMUNITY SCHOOL,KINDERGARTEN,0,0,0,0,25,25,0,0%
1360,GUNNISON WATERSHED RE1J,2006,CRESTED BUTTE COMMUNITY SCHOOL,1ST,0,0,1,2,54,57,3,5%
1360,GUNNISON WATERSHED RE1J,2006,CRESTED BUTTE COMMUNITY SCHOOL,2ND,0,0,0,3,47,50,3,6%
1360,GUNNISON WATERSHED RE1J,2006,CRESTED BUTTE COMMUNITY SCHOOL,3RD,2,0,0,3,51,56,5,9%
1360,GUNNISON WATERSHED RE1J,2006,CRESTED BUTTE COMMUNITY SCHOOL,4TH,0,0,0,1,35,36,1,3%
1360,GUNNISON WATERSHED RE1J,2006,CRESTED BUTTE COMMUNITY SCHOOL,5TH,1,1,0,1,36,39,3,8%
1360,GUNNISON WATERSHED RE1J,2006,CRESTED BUTTE COMMUNITY SCHOOL,6TH,0,0,0,0,40,40,0,0%
1360,GUNNISON WATERSHED RE1J,2006,CRESTED BUTTE COMMUNITY SCHOOL,7TH,1,0,0,3,28,32,4,13%
1360,GUNNISON WATERSHED RE1J,2006,CRESTED BUTTE COMMUNITY SCHOOL,8TH,2,1,0,2,39,44,5,11%
1360,GUNNISON WATERSHED RE1J,2006,CRESTED BUTTE COMMUNITY SCHOOL,9TH,0,0,0,0,30,30,0,0%
1360,GUNNISON WATERSHED RE1J,2006,CRESTED BUTTE COMMUNITY SCHOOL,10TH,1,0,0,2,26,29,3,10%
1360,GUNNISON WATERSHED RE1J,2006,CRESTED BUTTE COMMUNITY SCHOOL,11TH,0,3,0,1,27,31,4,13%
1360,GUNNISON WATERSHED RE1J,2006,CRESTED BUTTE COMMUNITY SCHOOL,12TH,0,0,0,2,19,21,2,10%
1360,GUNNISON WATERSHED RE1J,2006,CRESTED BUTTE COMMUNITY SCHOOL,SCHOOL TOTAL,7,5,1,20,481,514,33,6%
1360,GUNNISON WATERSHED RE1J,3690,GUNNISON ELEMENTARY SCHOOL,1ST,0,1,0,15,73,89,16,18%
1360,GUNNISON WATERSHED RE1J,3690,GUNNISON ELEMENTARY SCHOOL,2ND,0,1,1,16,84,102,18,18%
1360,GUNNISON WATERSHED RE1J,3690,GUNNISON ELEMENTARY SCHOOL,3RD,2,0,1,22,67,92,25,27%
1360,GUNNISON WATERSHED RE1J,3690,GUNNISON ELEMENTARY SCHOOL,4TH,0,0,0,13,84,97,13,13%
1360,GUNNISON WATERSHED RE1J,3690,GUNNISON ELEMENTARY SCHOOL,5TH,0,0,0,15,72,87,15,17%
1360,GUNNISON WATERSHED RE1J,3690,GUNNISON ELEMENTARY SCHOOL,SCHOOL TOTAL,2,2,2,81,380,467,87,19%
1360,GUNNISON WATERSHED RE1J,3694,GUNNISON HIGH SCHOOL,9TH,0,2,0,9,62,73,11,15%
1360,GUNNISON WATERSHED RE1J,3694,GUNNISON HIGH SCHOOL,10TH,2,1,0,12,68,83,15,18%
1360,GUNNISON WATERSHED RE1J,3694,GUNNISON HIGH SCHOOL,11TH,0,2,0,12,68,82,14,17%
1360,GUNNISON WATERSHED RE1J,3694,GUNNISON HIGH SCHOOL,12TH,1,2,0,9,68,80,12,15%
1360,GUNNISON WATERSHED RE1J,3694,GUNNISON HIGH SCHOOL,SCHOOL TOTAL,3,7,0,42,266,318,52,16%
1360,GUNNISON WATERSHED RE1J,3697,GUNNISON MIDDLE SCHOOL,6TH,0,0,1,16,54,71,17,24%
1360,GUNNISON WATERSHED RE1J,3697,GUNNISON MIDDLE SCHOOL,7TH,0,0,0,15,69,84,15,18%
1360,GUNNISON WATERSHED RE1J,3697,GUNNISON MIDDLE SCHOOL,8TH,2,0,0,22,81,105,24,23%
1360,GUNNISON WATERSHED RE1J,3697,GUNNISON MIDDLE SCHOOL,SCHOOL TOTAL,2,0,1,53,204,260,56,22%
1360,GUNNISON WATERSHED RE1J,3701,GUNNISON VALLEY SCHOOL,9TH,0,0,0,0,2,2,0,0%
1360,GUNNISON WATERSHED RE1J,3701,GUNNISON VALLEY SCHOOL,10TH,0,0,0,0,3,3,0,0%
1360,GUNNISON WATERSHED RE1J,3701,GUNNISON VALLEY SCHOOL,11TH,1,0,0,2,7,10,3,30%
1360,GUNNISON WATERSHED RE1J,3701,GUNNISON VALLEY SCHOOL,12TH,1,0,0,0,4,5,1,20%
1360,GUNNISON WATERSHED RE1J,3701,GUNNISON VALLEY SCHOOL,SCHOOL TOTAL,2,0,0,2,16,20,4,20%
1360,GUNNISON WATERSHED RE1J,3702,LAKE SCHOOL,PK,0,0,0,28,61,89,28,31%
1360,GUNNISON WATERSHED RE1J,3702,LAKE SCHOOL,HALF DAY K,0,0,0,1,28,29,1,3%
1360,GUNNISON WATERSHED RE1J,3702,LAKE SCHOOL,KINDERGARTEN,0,0,0,20,61,81,20,25%
1360,GUNNISON WATERSHED RE1J,3702,LAKE SCHOOL,SCHOOL TOTAL,0,0,0,49,150,199,49,25%
1360,GUNNISON WATERSHED RE1J,5577,MARBLE CHARTER SCHOOL,KINDERGARTEN,1,0,0,1,4,6,2,33%
1360,GUNNISON WATERSHED RE1J,5577,MARBLE CHARTER SCHOOL,1ST,1,0,0,0,6,7,1,14%
1360,GUNNISON WATERSHED RE1J,5577,MARBLE CHARTER SCHOOL,2ND,0,0,0,0,3,3,0,0%
1360,GUNNISON WATERSHED RE1J,5577,MARBLE CHARTER SCHOOL,3RD,0,0,0,2,2,4,2,50%
1360,GUNNISON WATERSHED RE1J,5577,MARBLE CHARTER SCHOOL,4TH,0,0,0,0,4,4,0,0%
1360,GUNNISON WATERSHED RE1J,5577,MARBLE CHARTER SCHOOL,5TH,1,0,0,0,1,2,1,50%
1360,GUNNISON WATERSHED RE1J,5577,MARBLE CHARTER SCHOOL,6TH,0,0,0,1,3,4,1,25%
1360,GUNNISON WATERSHED RE1J,5577,MARBLE CHARTER SCHOOL,7TH,0,0,0,0,6,6,0,0%
1360,GUNNISON WATERSHED RE1J,5577,MARBLE CHARTER SCHOOL,8TH,0,0,0,0,3,3,0,0%
1360,GUNNISON WATERSHED RE1J,5577,MARBLE CHARTER SCHOOL,9TH,0,0,0,0,1,1,0,0%
1360,GUNNISON WATERSHED RE1J,5577,MARBLE CHARTER SCHOOL,SCHOOL TOTAL,3,0,0,4,33,40,7,18%
1360,GUNNISON WATERSHED RE1J,,DISTRICT TOTAL,,19,14,4,251,1530,1818,288,16%
1380,HINSDALE COUNTY RE 1,4899,LAKE CITY COMMUNITY SCHOOL,PK,0,0,0,0,13,13,0,0%
1380,HINSDALE COUNTY RE 1,4899,LAKE CITY COMMUNITY SCHOOL,KINDERGARTEN,0,0,0,0,6,6,0,0%
1380,HINSDALE COUNTY RE 1,4899,LAKE CITY COMMUNITY SCHOOL,1ST,0,0,0,0,9,9,0,0%
1380,HINSDALE COUNTY RE 1,4899,LAKE CITY COMMUNITY SCHOOL,2ND,1,0,0,0,3,4,1,25%
1380,HINSDALE COUNTY RE 1,4899,LAKE CITY COMMUNITY SCHOOL,3RD,0,1,0,0,6,7,1,14%
1380,HINSDALE COUNTY RE 1,4899,LAKE CITY COMMUNITY SCHOOL,4TH,0,1,0,0,8,9,1,11%
1380,HINSDALE COUNTY RE 1,4899,LAKE CITY COMMUNITY SCHOOL,5TH,0,0,0,0,6,6,0,0%
1380,HINSDALE COUNTY RE 1,4899,LAKE CITY COMMUNITY SCHOOL,6TH,1,0,0,0,8,9,1,11%
1380,HINSDALE COUNTY RE 1,4899,LAKE CITY COMMUNITY SCHOOL,7TH,0,0,0,0,3,3,0,0%
1380,HINSDALE COUNTY RE 1,4899,LAKE CITY COMMUNITY SCHOOL,8TH,1,0,1,1,6,9,3,33%
1380,HINSDALE COUNTY RE 1,4899,LAKE CITY COMMUNITY SCHOOL,9TH,0,0,1,0,4,5,1,20%
1380,HINSDALE COUNTY RE 1,4899,LAKE CITY COMMUNITY SCHOOL,10TH,0,0,1,0,4,5,1,20%
1380,HINSDALE COUNTY RE 1,4899,LAKE CITY COMMUNITY SCHOOL,11TH,0,0,0,0,4,4,0,0%
1380,HINSDALE COUNTY RE 1,4899,LAKE CITY COMMUNITY SCHOOL,12TH,0,0,0,0,4,4,0,0%
1380,HINSDALE COUNTY RE 1,4899,LAKE CITY COMMUNITY SCHOOL,SCHOOL TOTAL,3,2,3,1,84,93,9,10%
1380,HINSDALE COUNTY RE 1,,DISTRICT TOTAL,,3,2,3,1,84,93,9,10%
1390,HUERFANO RE-1,0063,PEAKVIEW SCHOOL,PK,0,0,0,18,9,27,18,67%
1390,HUERFANO RE-1,0063,PEAKVIEW SCHOOL,KINDERGARTEN,3,1,0,30,5,39,34,87%
1390,HUERFANO RE-1,0063,PEAKVIEW SCHOOL,1ST,2,1,2,43,13,61,48,79%
1390,HUERFANO RE-1,0063,PEAKVIEW SCHOOL,2ND,4,0,0,17,7,28,21,75%
1390,HUERFANO RE-1,0063,PEAKVIEW SCHOOL,3RD,2,2,1,24,13,42,29,69%
1390,HUERFANO RE-1,0063,PEAKVIEW SCHOOL,4TH,3,0,0,18,16,37,21,57%
1390,HUERFANO RE-1,0063,PEAKVIEW SCHOOL,5TH,4,0,1,23,9,37,28,76%
1390,HUERFANO RE-1,0063,PEAKVIEW SCHOOL,6TH,1,1,0,23,9,34,25,74%
1390,HUERFANO RE-1,0063,PEAKVIEW SCHOOL,7TH,0,0,0,15,10,25,15,60%
1390,HUERFANO RE-1,0063,PEAKVIEW SCHOOL,SCHOOL TOTAL,19,5,4,211,91,330,239,72%
1390,HUERFANO RE-1,3306,GARDNER ELEMENTARY SCHOOL,PK,1,0,0,6,1,8,7,88%
1390,HUERFANO RE-1,3306,GARDNER ELEMENTARY SCHOOL,HALF DAY K,0,0,0,4,0,4,4,100%
1390,HUERFANO RE-1,3306,GARDNER ELEMENTARY SCHOOL,1ST,0,0,0,2,3,5,2,40%
1390,HUERFANO RE-1,3306,GARDNER ELEMENTARY SCHOOL,2ND,1,0,0,3,3,7,4,57%
1390,HUERFANO RE-1,3306,GARDNER ELEMENTARY SCHOOL,3RD,0,0,0,9,0,9,9,100%
1390,HUERFANO RE-1,3306,GARDNER ELEMENTARY SCHOOL,4TH,1,0,0,3,0,4,4,100%
1390,HUERFANO RE-1,3306,GARDNER ELEMENTARY SCHOOL,5TH,0,0,1,8,4,13,9,69%
1390,HUERFANO RE-1,3306,GARDNER ELEMENTARY SCHOOL,6TH,0,0,0,3,4,7,3,43%
1390,HUERFANO RE-1,3306,GARDNER ELEMENTARY SCHOOL,7TH,0,0,0,1,2,3,1,33%
1390,HUERFANO RE-1,3306,GARDNER ELEMENTARY SCHOOL,8TH,0,0,0,3,5,8,3,38%
1390,HUERFANO RE-1,3306,GARDNER ELEMENTARY SCHOOL,SCHOOL TOTAL,3,0,1,42,22,68,46,68%
1390,HUERFANO RE-1,4161,HUERFANO COUNTY OPPORTUNITY AND ENRICHMENT SCHOOL,8TH,0,0,0,0,1,1,0,0%
1390,HUERFANO RE-1,4161,HUERFANO COUNTY OPPORTUNITY AND ENRICHMENT SCHOOL,9TH,0,0,0,6,5,11,6,55%
1390,HUERFANO RE-1,4161,HUERFANO COUNTY OPPORTUNITY AND ENRICHMENT SCHOOL,10TH,0,0,0,4,0,4,4,100%
1390,HUERFANO RE-1,4161,HUERFANO COUNTY OPPORTUNITY AND ENRICHMENT SCHOOL,11TH,0,0,0,2,1,3,2,67%
1390,HUERFANO RE-1,4161,HUERFANO COUNTY OPPORTUNITY AND ENRICHMENT SCHOOL,12TH,0,0,0,1,0,1,1,100%
1390,HUERFANO RE-1,4161,HUERFANO COUNTY OPPORTUNITY AND ENRICHMENT SCHOOL,SCHOOL TOTAL,0,0,0,13,7,20,13,65%
1390,HUERFANO RE-1,9212,JOHN MALL JUNIOR-SENIOR HIGH SCHOOL,8TH,1,0,0,25,7,33,26,79%
1390,HUERFANO RE-1,9212,JOHN MALL JUNIOR-SENIOR HIGH SCHOOL,9TH,1,0,1,36,14,52,38,73%
1390,HUERFANO RE-1,9212,JOHN MALL JUNIOR-SENIOR HIGH SCHOOL,10TH,1,0,0,27,15,43,28,65%
1390,HUERFANO RE-1,9212,JOHN MALL JUNIOR-SENIOR HIGH SCHOOL,11TH,0,0,0,27,11,38,27,71%
1390,HUERFANO RE-1,9212,JOHN MALL JUNIOR-SENIOR HIGH SCHOOL,12TH,0,1,0,23,12,36,24,67%
1390,HUERFANO RE-1,9212,JOHN MALL JUNIOR-SENIOR HIGH SCHOOL,SCHOOL TOTAL,3,1,1,138,59,202,143,71%
1390,HUERFANO RE-1,,DISTRICT TOTAL,,25,6,6,404,179,620,441,71%
1400,LA VETA RE-2,4860,LA VETA ELEMENTARY SCHOOL,PK,0,0,0,2,9,11,2,18%
1400,LA VETA RE-2,4860,LA VETA ELEMENTARY SCHOOL,KINDERGARTEN,0,0,0,1,10,11,1,9%
1400,LA VETA RE-2,4860,LA VETA ELEMENTARY SCHOOL,1ST,0,0,0,9,13,22,9,41%
1400,LA VETA RE-2,4860,LA VETA ELEMENTARY SCHOOL,2ND,0,0,0,6,12,18,6,33%
1400,LA VETA RE-2,4860,LA VETA ELEMENTARY SCHOOL,3RD,0,0,0,2,11,13,2,15%
1400,LA VETA RE-2,4860,LA VETA ELEMENTARY SCHOOL,4TH,1,0,0,2,12,15,3,20%
1400,LA VETA RE-2,4860,LA VETA ELEMENTARY SCHOOL,5TH,0,0,0,2,9,11,2,18%
1400,LA VETA RE-2,4860,LA VETA ELEMENTARY SCHOOL,6TH,0,1,0,3,13,17,4,24%
1400,LA VETA RE-2,4860,LA VETA ELEMENTARY SCHOOL,SCHOOL TOTAL,1,1,0,27,89,118,29,25%
1400,LA VETA RE-2,4864,LA VETA JUNIOR-SENIOR HIGH SCHOOL,7TH,2,1,0,1,12,16,4,25%
1400,LA VETA RE-2,4864,LA VETA JUNIOR-SENIOR HIGH SCHOOL,8TH,0,0,0,4,12,16,4,25%
1400,LA VETA RE-2,4864,LA VETA JUNIOR-SENIOR HIGH SCHOOL,9TH,1,0,0,5,24,30,6,20%
1400,LA VETA RE-2,4864,LA VETA JUNIOR-SENIOR HIGH SCHOOL,10TH,0,0,0,6,20,26,6,23%
1400,LA VETA RE-2,4864,LA VETA JUNIOR-SENIOR HIGH SCHOOL,11TH,0,0,0,2,25,27,2,7%
1400,LA VETA RE-2,4864,LA VETA JUNIOR-SENIOR HIGH SCHOOL,12TH,0,1,0,4,16,21,5,24%
1400,LA VETA RE-2,4864,LA VETA JUNIOR-SENIOR HIGH SCHOOL,SCHOOL TOTAL,3,2,0,22,109,136,27,20%
1400,LA VETA RE-2,,DISTRICT TOTAL,,4,3,0,49,198,254,56,22%
1410,NORTH PARK R-1 ,6358,NORTH PARK JUNIOR-SENIOR HIGH SCHOOL,6TH,0,0,0,2,17,19,2,11%
1410,NORTH PARK R-1 ,6358,NORTH PARK JUNIOR-SENIOR HIGH SCHOOL,7TH,0,0,0,3,8,11,3,27%
1410,NORTH PARK R-1 ,6358,NORTH PARK JUNIOR-SENIOR HIGH SCHOOL,8TH,0,0,0,1,13,14,1,7%
1410,NORTH PARK R-1 ,6358,NORTH PARK JUNIOR-SENIOR HIGH SCHOOL,9TH,2,0,0,1,9,12,3,25%
1410,NORTH PARK R-1 ,6358,NORTH PARK JUNIOR-SENIOR HIGH SCHOOL,10TH,0,0,0,6,13,19,6,32%
1410,NORTH PARK R-1 ,6358,NORTH PARK JUNIOR-SENIOR HIGH SCHOOL,11TH,0,0,0,1,8,9,1,11%
1410,NORTH PARK R-1 ,6358,NORTH PARK JUNIOR-SENIOR HIGH SCHOOL,12TH,0,0,0,1,17,18,1,6%
1410,NORTH PARK R-1 ,6358,NORTH PARK JUNIOR-SENIOR HIGH SCHOOL,SCHOOL TOTAL,2,0,0,15,85,102,17,17%
1410,NORTH PARK R-1 ,9198,WALDEN ELEMENTARY SCHOOL,PK,0,0,0,9,22,31,9,29%
1410,NORTH PARK R-1 ,9198,WALDEN ELEMENTARY SCHOOL,HALF DAY K,0,0,0,0,1,1,0,0%
1410,NORTH PARK R-1 ,9198,WALDEN ELEMENTARY SCHOOL,KINDERGARTEN,0,0,0,4,12,16,4,25%
1410,NORTH PARK R-1 ,9198,WALDEN ELEMENTARY SCHOOL,1ST,0,0,0,3,16,19,3,16%
1410,NORTH PARK R-1 ,9198,WALDEN ELEMENTARY SCHOOL,2ND,0,0,0,3,14,17,3,18%
1410,NORTH PARK R-1 ,9198,WALDEN ELEMENTARY SCHOOL,3RD,0,0,0,1,12,13,1,8%
1410,NORTH PARK R-1 ,9198,WALDEN ELEMENTARY SCHOOL,4TH,0,0,0,2,11,13,2,15%
1410,NORTH PARK R-1 ,9198,WALDEN ELEMENTARY SCHOOL,5TH,1,0,1,4,12,18,6,33%
1410,NORTH PARK R-1 ,9198,WALDEN ELEMENTARY SCHOOL,SCHOOL TOTAL,1,0,1,26,100,128,28,22%
1410,NORTH PARK R-1 ,,DISTRICT TOTAL,,3,0,1,41,185,230,45,20%
1420,JEFFERSON COUNTY R-1,0030,ADAMS ELEMENTARY SCHOOL,PK,0,14,3,13,66,96,30,31%
1420,JEFFERSON COUNTY R-1,0030,ADAMS ELEMENTARY SCHOOL,HALF DAY K,1,4,2,11,25,43,18,42%
1420,JEFFERSON COUNTY R-1,0030,ADAMS ELEMENTARY SCHOOL,KINDERGARTEN,1,3,0,2,18,24,6,25%
1420,JEFFERSON COUNTY R-1,0030,ADAMS ELEMENTARY SCHOOL,1ST,0,14,1,4,44,63,19,30%
1420,JEFFERSON COUNTY R-1,0030,ADAMS ELEMENTARY SCHOOL,2ND,1,5,1,13,37,57,20,35%
1420,JEFFERSON COUNTY R-1,0030,ADAMS ELEMENTARY SCHOOL,3RD,1,8,0,8,31,48,17,35%
1420,JEFFERSON COUNTY R-1,0030,ADAMS ELEMENTARY SCHOOL,4TH,1,9,2,8,47,67,20,30%
1420,JEFFERSON COUNTY R-1,0030,ADAMS ELEMENTARY SCHOOL,5TH,1,3,3,10,37,54,17,31%
1420,JEFFERSON COUNTY R-1,0030,ADAMS ELEMENTARY SCHOOL,6TH,0,4,0,7,36,47,11,23%
1420,JEFFERSON COUNTY R-1,0030,ADAMS ELEMENTARY SCHOOL,SCHOOL TOTAL,6,64,12,76,341,499,158,32%
1420,JEFFERSON COUNTY R-1,0033,MC LAIN HIGH SCHOOL,9TH,0,0,0,1,3,4,1,25%
1420,JEFFERSON COUNTY R-1,0033,MC LAIN HIGH SCHOOL,10TH,0,0,2,8,22,32,10,31%
1420,JEFFERSON COUNTY R-1,0033,MC LAIN HIGH SCHOOL,11TH,3,2,3,33,105,146,41,28%
1420,JEFFERSON COUNTY R-1,0033,MC LAIN HIGH SCHOOL,12TH,5,3,3,59,181,251,70,28%
1420,JEFFERSON COUNTY R-1,0033,MC LAIN HIGH SCHOOL,SCHOOL TOTAL,8,5,8,101,311,433,122,28%
1420,JEFFERSON COUNTY R-1,0034,MC LAIN COMMUNITY HIGH SCHOOL,12TH,6,4,3,55,122,190,68,36%
1420,JEFFERSON COUNTY R-1,0034,MC LAIN COMMUNITY HIGH SCHOOL,SCHOOL TOTAL,6,4,3,55,122,190,68,36%
1420,JEFFERSON COUNTY R-1,0108,ALAMEDA HIGH SCHOOL,9TH,8,13,6,126,42,195,153,78%
1420,JEFFERSON COUNTY R-1,0108,ALAMEDA HIGH SCHOOL,10TH,5,20,6,127,55,213,158,74%
1420,JEFFERSON COUNTY R-1,0108,ALAMEDA HIGH SCHOOL,11TH,2,12,3,100,53,170,117,69%
1420,JEFFERSON COUNTY R-1,0108,ALAMEDA HIGH SCHOOL,12TH,2,19,4,90,53,168,115,68%
1420,JEFFERSON COUNTY R-1,0108,ALAMEDA HIGH SCHOOL,SCHOOL TOTAL,17,64,19,443,203,746,543,73%
1420,JEFFERSON COUNTY R-1,0148,ALLENDALE ELEMENTARY SCHOOL,KINDERGARTEN,0,0,1,6,19,26,7,27%
1420,JEFFERSON COUNTY R-1,0148,ALLENDALE ELEMENTARY SCHOOL,1ST,0,2,1,12,13,28,15,54%
1420,JEFFERSON COUNTY R-1,0148,ALLENDALE ELEMENTARY SCHOOL,2ND,2,0,0,10,18,30,12,40%
1420,JEFFERSON COUNTY R-1,0148,ALLENDALE ELEMENTARY SCHOOL,3RD,0,1,1,10,17,29,12,41%
1420,JEFFERSON COUNTY R-1,0148,ALLENDALE ELEMENTARY SCHOOL,4TH,0,0,3,15,17,35,18,51%
1420,JEFFERSON COUNTY R-1,0148,ALLENDALE ELEMENTARY SCHOOL,5TH,1,0,1,14,17,33,16,48%
1420,JEFFERSON COUNTY R-1,0148,ALLENDALE ELEMENTARY SCHOOL,6TH,0,0,1,15,27,43,16,37%
1420,JEFFERSON COUNTY R-1,0148,ALLENDALE ELEMENTARY SCHOOL,SCHOOL TOTAL,3,3,8,82,128,224,96,43%
1420,JEFFERSON COUNTY R-1,0366,ARVADA MIDDLE SCHOOL,7TH,8,1,2,58,65,134,69,51%
1420,JEFFERSON COUNTY R-1,0366,ARVADA MIDDLE SCHOOL,8TH,3,5,9,48,65,130,65,50%
1420,JEFFERSON COUNTY R-1,0366,ARVADA MIDDLE SCHOOL,SCHOOL TOTAL,11,6,11,106,130,264,134,51%
1420,JEFFERSON COUNTY R-1,0370,ARVADA HIGH SCHOOL,9TH,1,15,10,105,179,310,131,42%
1420,JEFFERSON COUNTY R-1,0370,ARVADA HIGH SCHOOL,10TH,9,16,3,99,165,292,127,43%
1420,JEFFERSON COUNTY R-1,0370,ARVADA HIGH SCHOOL,11TH,3,15,1,108,149,276,127,46%
1420,JEFFERSON COUNTY R-1,0370,ARVADA HIGH SCHOOL,12TH,7,21,9,100,184,321,137,43%
1420,JEFFERSON COUNTY R-1,0370,ARVADA HIGH SCHOOL,SCHOOL TOTAL,20,67,23,412,677,1199,522,44%
1420,JEFFERSON COUNTY R-1,0378,ARVADA WEST HIGH SCHOOL,9TH,3,11,7,45,376,442,66,15%
1420,JEFFERSON COUNTY R-1,0378,ARVADA WEST HIGH SCHOOL,10TH,8,10,7,52,381,458,77,17%
1420,JEFFERSON COUNTY R-1,0378,ARVADA WEST HIGH SCHOOL,11TH,1,5,9,46,355,416,61,15%
1420,JEFFERSON COUNTY R-1,0378,ARVADA WEST HIGH SCHOOL,12TH,2,7,4,42,328,383,55,14%
1420,JEFFERSON COUNTY R-1,0378,ARVADA WEST HIGH SCHOOL,SCHOOL TOTAL,14,33,27,185,1440,1699,259,15%
1420,JEFFERSON COUNTY R-1,0660,BEAR CREEK K-8 SCHOOL,HALF DAY K,1,3,1,9,44,58,14,24%
1420,JEFFERSON COUNTY R-1,0660,BEAR CREEK K-8 SCHOOL,KINDERGARTEN,1,4,1,6,41,53,12,23%
1420,JEFFERSON COUNTY R-1,0660,BEAR CREEK K-8 SCHOOL,1ST,1,10,1,36,90,138,48,35%
1420,JEFFERSON COUNTY R-1,0660,BEAR CREEK K-8 SCHOOL,2ND,1,8,5,23,72,109,37,34%
1420,JEFFERSON COUNTY R-1,0660,BEAR CREEK K-8 SCHOOL,3RD,2,11,2,35,78,128,50,39%
1420,JEFFERSON COUNTY R-1,0660,BEAR CREEK K-8 SCHOOL,4TH,2,8,3,30,93,136,43,32%
1420,JEFFERSON COUNTY R-1,0660,BEAR CREEK K-8 SCHOOL,5TH,2,16,5,49,77,149,72,48%
1420,JEFFERSON COUNTY R-1,0660,BEAR CREEK K-8 SCHOOL,6TH,2,15,2,44,103,166,63,38%
1420,JEFFERSON COUNTY R-1,0660,BEAR CREEK K-8 SCHOOL,7TH,2,13,5,30,69,119,50,42%
1420,JEFFERSON COUNTY R-1,0660,BEAR CREEK K-8 SCHOOL,8TH,2,10,4,18,55,89,34,38%
1420,JEFFERSON COUNTY R-1,0660,BEAR CREEK K-8 SCHOOL,SCHOOL TOTAL,16,98,29,280,722,1145,423,37%
1420,JEFFERSON COUNTY R-1,0664,BEAR CREEK HIGH SCHOOL,9TH,7,31,10,129,348,525,177,34%
1420,JEFFERSON COUNTY R-1,0664,BEAR CREEK HIGH SCHOOL,10TH,10,31,16,146,281,484,203,42%
1420,JEFFERSON COUNTY R-1,0664,BEAR CREEK HIGH SCHOOL,11TH,6,19,4,86,303,418,115,28%
1420,JEFFERSON COUNTY R-1,0664,BEAR CREEK HIGH SCHOOL,12TH,3,26,16,102,287,434,147,34%
1420,JEFFERSON COUNTY R-1,0664,BEAR CREEK HIGH SCHOOL,SCHOOL TOTAL,26,107,46,463,1219,1861,642,34%
1420,JEFFERSON COUNTY R-1,0694,BELL MIDDLE SCHOOL,7TH,2,11,5,45,188,251,63,25%
1420,JEFFERSON COUNTY R-1,0694,BELL MIDDLE SCHOOL,8TH,1,7,6,29,239,282,43,15%
1420,JEFFERSON COUNTY R-1,0694,BELL MIDDLE SCHOOL,SCHOOL TOTAL,3,18,11,74,427,533,106,20%
1420,JEFFERSON COUNTY R-1,0724,BELMAR ELEMENTARY SCHOOL,KINDERGARTEN,0,1,1,15,32,49,17,35%
1420,JEFFERSON COUNTY R-1,0724,BELMAR ELEMENTARY SCHOOL,1ST,1,4,0,16,27,48,21,44%
1420,JEFFERSON COUNTY R-1,0724,BELMAR ELEMENTARY SCHOOL,2ND,1,4,5,8,24,42,18,43%
1420,JEFFERSON COUNTY R-1,0724,BELMAR ELEMENTARY SCHOOL,3RD,0,3,1,10,30,44,14,32%
1420,JEFFERSON COUNTY R-1,0724,BELMAR ELEMENTARY SCHOOL,4TH,0,4,0,14,26,44,18,41%
1420,JEFFERSON COUNTY R-1,0724,BELMAR ELEMENTARY SCHOOL,5TH,1,4,2,18,30,55,25,45%
1420,JEFFERSON COUNTY R-1,0724,BELMAR ELEMENTARY SCHOOL,6TH,0,6,7,18,26,57,31,54%
1420,JEFFERSON COUNTY R-1,0724,BELMAR ELEMENTARY SCHOOL,SCHOOL TOTAL,3,26,16,99,195,339,144,42%
1420,JEFFERSON COUNTY R-1,0776,BERGEN MEADOW PRIMARY SCHOOL,PK,0,2,0,1,79,82,3,4%
1420,JEFFERSON COUNTY R-1,0776,BERGEN MEADOW PRIMARY SCHOOL,HALF DAY K,0,0,0,0,4,4,0,0%
1420,JEFFERSON COUNTY R-1,0776,BERGEN MEADOW PRIMARY SCHOOL,KINDERGARTEN,0,1,2,3,64,70,6,9%
1420,JEFFERSON COUNTY R-1,0776,BERGEN MEADOW PRIMARY SCHOOL,1ST,2,7,0,2,113,124,11,9%
1420,JEFFERSON COUNTY R-1,0776,BERGEN MEADOW PRIMARY SCHOOL,2ND,0,4,0,4,75,83,8,10%
1420,JEFFERSON COUNTY R-1,0776,BERGEN MEADOW PRIMARY SCHOOL,SCHOOL TOTAL,2,14,2,10,335,363,28,8%
1420,JEFFERSON COUNTY R-1,0779,BERGEN VALLEY INTERMEDIATE SCHOOL,3RD,1,2,0,3,107,113,6,5%
1420,JEFFERSON COUNTY R-1,0779,BERGEN VALLEY INTERMEDIATE SCHOOL,4TH,0,2,0,3,101,106,5,5%
1420,JEFFERSON COUNTY R-1,0779,BERGEN VALLEY INTERMEDIATE SCHOOL,5TH,0,3,0,2,104,109,5,5%
1420,JEFFERSON COUNTY R-1,0779,BERGEN VALLEY INTERMEDIATE SCHOOL,SCHOOL TOTAL,1,7,0,8,312,328,16,5%
1420,JEFFERSON COUNTY R-1,0950,BRADFORD PRIMARY SCHOOL,HALF DAY K,0,1,0,1,51,53,2,4%
1420,JEFFERSON COUNTY R-1,0950,BRADFORD PRIMARY SCHOOL,KINDERGARTEN,1,0,0,3,47,51,4,8%
1420,JEFFERSON COUNTY R-1,0950,BRADFORD PRIMARY SCHOOL,1ST,1,1,0,5,85,92,7,8%
1420,JEFFERSON COUNTY R-1,0950,BRADFORD PRIMARY SCHOOL,2ND,2,3,0,10,121,136,15,11%
1420,JEFFERSON COUNTY R-1,0950,BRADFORD PRIMARY SCHOOL,3RD,1,3,2,5,111,122,11,9%
1420,JEFFERSON COUNTY R-1,0950,BRADFORD PRIMARY SCHOOL,SCHOOL TOTAL,5,8,2,24,415,454,39,9%
1420,JEFFERSON COUNTY R-1,0951,BLUE HERON ELEMENTARY SCHOOL,PK,1,8,0,11,35,55,20,36%
1420,JEFFERSON COUNTY R-1,0951,BLUE HERON ELEMENTARY SCHOOL,HALF DAY K,1,1,1,1,7,11,4,36%
1420,JEFFERSON COUNTY R-1,0951,BLUE HERON ELEMENTARY SCHOOL,KINDERGARTEN,0,4,1,10,46,61,15,25%
1420,JEFFERSON COUNTY R-1,0951,BLUE HERON ELEMENTARY SCHOOL,1ST,0,10,0,8,46,64,18,28%
1420,JEFFERSON COUNTY R-1,0951,BLUE HERON ELEMENTARY SCHOOL,2ND,1,7,0,8,53,69,16,23%
1420,JEFFERSON COUNTY R-1,0951,BLUE HERON ELEMENTARY SCHOOL,3RD,0,8,1,15,46,70,24,34%
1420,JEFFERSON COUNTY R-1,0951,BLUE HERON ELEMENTARY SCHOOL,4TH,0,10,0,5,37,52,15,29%
1420,JEFFERSON COUNTY R-1,0951,BLUE HERON ELEMENTARY SCHOOL,5TH,1,14,0,11,38,64,26,41%
1420,JEFFERSON COUNTY R-1,0951,BLUE HERON ELEMENTARY SCHOOL,6TH,0,7,0,11,32,50,18,36%
1420,JEFFERSON COUNTY R-1,0951,BLUE HERON ELEMENTARY SCHOOL,SCHOOL TOTAL,4,69,3,80,340,496,156,31%
1420,JEFFERSON COUNTY R-1,0952,BRADFORD INTERMEDIATE SCHOOL,4TH,0,2,1,6,115,124,9,7%
1420,JEFFERSON COUNTY R-1,0952,BRADFORD INTERMEDIATE SCHOOL,5TH,1,4,0,5,107,117,10,9%
1420,JEFFERSON COUNTY R-1,0952,BRADFORD INTERMEDIATE SCHOOL,6TH,0,4,0,3,125,132,7,5%
1420,JEFFERSON COUNTY R-1,0952,BRADFORD INTERMEDIATE SCHOOL,SCHOOL TOTAL,1,10,1,14,347,373,26,7%
1420,JEFFERSON COUNTY R-1,0965,BRADY EXPLORATION SCHOOL,9TH,1,0,1,1,2,5,3,60%
1420,JEFFERSON COUNTY R-1,0965,BRADY EXPLORATION SCHOOL,10TH,3,0,1,36,20,60,40,67%
1420,JEFFERSON COUNTY R-1,0965,BRADY EXPLORATION SCHOOL,11TH,16,1,9,143,69,238,169,71%
1420,JEFFERSON COUNTY R-1,0965,BRADY EXPLORATION SCHOOL,12TH,2,0,2,12,12,28,16,57%
1420,JEFFERSON COUNTY R-1,0965,BRADY EXPLORATION SCHOOL,SCHOOL TOTAL,22,1,13,192,103,331,228,69%
1420,JEFFERSON COUNTY R-1,1238,CAMPBELL ELEMENTARY SCHOOL,PK,1,6,4,19,101,131,30,23%
1420,JEFFERSON COUNTY R-1,1238,CAMPBELL ELEMENTARY SCHOOL,KINDERGARTEN,0,3,5,6,39,53,14,26%
1420,JEFFERSON COUNTY R-1,1238,CAMPBELL ELEMENTARY SCHOOL,1ST,1,0,2,4,34,41,7,17%
1420,JEFFERSON COUNTY R-1,1238,CAMPBELL ELEMENTARY SCHOOL,2ND,0,0,3,3,36,42,6,14%
1420,JEFFERSON COUNTY R-1,1238,CAMPBELL ELEMENTARY SCHOOL,3RD,2,0,4,3,46,55,9,16%
1420,JEFFERSON COUNTY R-1,1238,CAMPBELL ELEMENTARY SCHOOL,4TH,1,0,2,8,30,41,11,27%
1420,JEFFERSON COUNTY R-1,1238,CAMPBELL ELEMENTARY SCHOOL,5TH,0,3,1,5,33,42,9,21%
1420,JEFFERSON COUNTY R-1,1238,CAMPBELL ELEMENTARY SCHOOL,6TH,0,1,2,3,44,50,6,12%
1420,JEFFERSON COUNTY R-1,1238,CAMPBELL ELEMENTARY SCHOOL,SCHOOL TOTAL,5,13,23,51,363,455,92,20%
1420,JEFFERSON COUNTY R-1,1318,CARMODY MIDDLE SCHOOL,7TH,6,14,3,100,216,339,123,36%
1420,JEFFERSON COUNTY R-1,1318,CARMODY MIDDLE SCHOOL,8TH,5,17,8,73,206,309,103,33%
1420,JEFFERSON COUNTY R-1,1318,CARMODY MIDDLE SCHOOL,SCHOOL TOTAL,11,31,11,173,422,648,226,35%
1420,JEFFERSON COUNTY R-1,1522,CHATFIELD HIGH SCHOOL,9TH,2,17,5,34,430,488,58,12%
1420,JEFFERSON COUNTY R-1,1522,CHATFIELD HIGH SCHOOL,10TH,1,21,6,38,425,491,66,13%
1420,JEFFERSON COUNTY R-1,1522,CHATFIELD HIGH SCHOOL,11TH,5,15,10,37,469,536,67,13%
1420,JEFFERSON COUNTY R-1,1522,CHATFIELD HIGH SCHOOL,12TH,8,11,7,41,430,497,67,13%
1420,JEFFERSON COUNTY R-1,1522,CHATFIELD HIGH SCHOOL,SCHOOL TOTAL,16,64,28,150,1754,2012,258,13%
1420,JEFFERSON COUNTY R-1,1730,COAL CREEK CANYON K-8 ELEMENTARY SCHOOL,KINDERGARTEN,0,0,0,0,23,23,0,0%
1420,JEFFERSON COUNTY R-1,1730,COAL CREEK CANYON K-8 ELEMENTARY SCHOOL,1ST,0,0,1,0,13,14,1,7%
1420,JEFFERSON COUNTY R-1,1730,COAL CREEK CANYON K-8 ELEMENTARY SCHOOL,2ND,0,0,0,2,12,14,2,14%
1420,JEFFERSON COUNTY R-1,1730,COAL CREEK CANYON K-8 ELEMENTARY SCHOOL,3RD,0,0,0,1,16,17,1,6%
1420,JEFFERSON COUNTY R-1,1730,COAL CREEK CANYON K-8 ELEMENTARY SCHOOL,4TH,1,0,0,0,14,15,1,7%
1420,JEFFERSON COUNTY R-1,1730,COAL CREEK CANYON K-8 ELEMENTARY SCHOOL,5TH,1,0,0,1,8,10,2,20%
1420,JEFFERSON COUNTY R-1,1730,COAL CREEK CANYON K-8 ELEMENTARY SCHOOL,6TH,0,0,0,2,19,21,2,10%
1420,JEFFERSON COUNTY R-1,1730,COAL CREEK CANYON K-8 ELEMENTARY SCHOOL,7TH,0,0,0,2,11,13,2,15%
1420,JEFFERSON COUNTY R-1,1730,COAL CREEK CANYON K-8 ELEMENTARY SCHOOL,8TH,0,0,0,1,5,6,1,17%
1420,JEFFERSON COUNTY R-1,1730,COAL CREEK CANYON K-8 ELEMENTARY SCHOOL,SCHOOL TOTAL,2,0,1,9,121,133,12,9%
1420,JEFFERSON COUNTY R-1,1790,COLOROW ELEMENTARY SCHOOL,HALF DAY K,0,3,2,6,26,37,11,30%
1420,JEFFERSON COUNTY R-1,1790,COLOROW ELEMENTARY SCHOOL,1ST,0,2,3,6,33,44,11,25%
1420,JEFFERSON COUNTY R-1,1790,COLOROW ELEMENTARY SCHOOL,2ND,1,3,2,10,32,48,16,33%
1420,JEFFERSON COUNTY R-1,1790,COLOROW ELEMENTARY SCHOOL,3RD,0,4,0,9,27,40,13,33%
1420,JEFFERSON COUNTY R-1,1790,COLOROW ELEMENTARY SCHOOL,4TH,0,1,1,4,34,40,6,15%
1420,JEFFERSON COUNTY R-1,1790,COLOROW ELEMENTARY SCHOOL,5TH,0,1,1,10,29,41,12,29%
1420,JEFFERSON COUNTY R-1,1790,COLOROW ELEMENTARY SCHOOL,6TH,0,1,1,6,33,41,8,20%
1420,JEFFERSON COUNTY R-1,1790,COLOROW ELEMENTARY SCHOOL,SCHOOL TOTAL,1,15,10,51,214,291,77,26%
1420,JEFFERSON COUNTY R-1,1861,COLUMBINE HILLS ELEMENTARY SCHOOL,PK,1,3,8,17,97,126,29,23%
1420,JEFFERSON COUNTY R-1,1861,COLUMBINE HILLS ELEMENTARY SCHOOL,KINDERGARTEN,1,2,1,6,43,53,10,19%
1420,JEFFERSON COUNTY R-1,1861,COLUMBINE HILLS ELEMENTARY SCHOOL,1ST,0,4,1,6,40,51,11,22%
1420,JEFFERSON COUNTY R-1,1861,COLUMBINE HILLS ELEMENTARY SCHOOL,2ND,0,0,3,10,40,53,13,25%
1420,JEFFERSON COUNTY R-1,1861,COLUMBINE HILLS ELEMENTARY SCHOOL,3RD,0,0,2,10,31,43,12,28%
1420,JEFFERSON COUNTY R-1,1861,COLUMBINE HILLS ELEMENTARY SCHOOL,4TH,0,1,1,7,28,37,9,24%
1420,JEFFERSON COUNTY R-1,1861,COLUMBINE HILLS ELEMENTARY SCHOOL,5TH,3,0,1,8,28,40,12,30%
1420,JEFFERSON COUNTY R-1,1861,COLUMBINE HILLS ELEMENTARY SCHOOL,6TH,0,3,0,7,26,36,10,28%
1420,JEFFERSON COUNTY R-1,1861,COLUMBINE HILLS ELEMENTARY SCHOOL,SCHOOL TOTAL,5,13,17,71,333,439,106,24%
1420,JEFFERSON COUNTY R-1,1864,COLUMBINE HIGH SCHOOL,9TH,6,17,5,66,312,406,94,23%
1420,JEFFERSON COUNTY R-1,1864,COLUMBINE HIGH SCHOOL,10TH,6,22,12,58,335,433,98,23%
1420,JEFFERSON COUNTY R-1,1864,COLUMBINE HIGH SCHOOL,11TH,3,13,2,55,315,388,73,19%
1420,JEFFERSON COUNTY R-1,1864,COLUMBINE HIGH SCHOOL,12TH,6,17,7,53,326,409,83,20%
1420,JEFFERSON COUNTY R-1,1864,COLUMBINE HIGH SCHOOL,SCHOOL TOTAL,21,69,26,232,1288,1636,348,21%
1420,JEFFERSON COUNTY R-1,1869,COMPASS MONTESSORI - WHEAT RIDGE CHARTER SCHOOL,PK,0,2,2,2,47,53,6,11%
1420,JEFFERSON COUNTY R-1,1869,COMPASS MONTESSORI - WHEAT RIDGE CHARTER SCHOOL,HALF DAY K,0,1,0,0,4,5,1,20%
1420,JEFFERSON COUNTY R-1,1869,COMPASS MONTESSORI - WHEAT RIDGE CHARTER SCHOOL,KINDERGARTEN,1,4,0,1,44,50,6,12%
1420,JEFFERSON COUNTY R-1,1869,COMPASS MONTESSORI - WHEAT RIDGE CHARTER SCHOOL,1ST,1,3,1,6,46,57,11,19%
1420,JEFFERSON COUNTY R-1,1869,COMPASS MONTESSORI - WHEAT RIDGE CHARTER SCHOOL,2ND,1,2,0,4,55,62,7,11%
1420,JEFFERSON COUNTY R-1,1869,COMPASS MONTESSORI - WHEAT RIDGE CHARTER SCHOOL,3RD,0,2,0,5,48,55,7,13%
1420,JEFFERSON COUNTY R-1,1869,COMPASS MONTESSORI - WHEAT RIDGE CHARTER SCHOOL,4TH,1,2,2,7,61,73,12,16%
1420,JEFFERSON COUNTY R-1,1869,COMPASS MONTESSORI - WHEAT RIDGE CHARTER SCHOOL,5TH,2,3,0,5,58,68,10,15%
1420,JEFFERSON COUNTY R-1,1869,COMPASS MONTESSORI - WHEAT RIDGE CHARTER SCHOOL,6TH,2,1,0,7,49,59,10,17%
1420,JEFFERSON COUNTY R-1,1869,COMPASS MONTESSORI - WHEAT RIDGE CHARTER SCHOOL,7TH,0,1,1,1,50,53,3,6%
1420,JEFFERSON COUNTY R-1,1869,COMPASS MONTESSORI - WHEAT RIDGE CHARTER SCHOOL,8TH,0,0,3,3,38,44,6,14%
1420,JEFFERSON COUNTY R-1,1869,COMPASS MONTESSORI - WHEAT RIDGE CHARTER SCHOOL,9TH,0,2,0,1,31,34,3,9%
1420,JEFFERSON COUNTY R-1,1869,COMPASS MONTESSORI - WHEAT RIDGE CHARTER SCHOOL,10TH,0,2,1,3,22,28,6,21%
1420,JEFFERSON COUNTY R-1,1869,COMPASS MONTESSORI - WHEAT RIDGE CHARTER SCHOOL,11TH,0,0,0,3,41,44,3,7%
1420,JEFFERSON COUNTY R-1,1869,COMPASS MONTESSORI - WHEAT RIDGE CHARTER SCHOOL,12TH,1,0,1,2,25,29,4,14%
1420,JEFFERSON COUNTY R-1,1869,COMPASS MONTESSORI - WHEAT RIDGE CHARTER SCHOOL,SCHOOL TOTAL,9,25,11,50,619,714,95,13%
1420,JEFFERSON COUNTY R-1,1876,CORONADO ELEMENTARY SCHOOL,PK,1,2,2,2,31,38,7,18%
1420,JEFFERSON COUNTY R-1,1876,CORONADO ELEMENTARY SCHOOL,HALF DAY K,0,1,2,4,35,42,7,17%
1420,JEFFERSON COUNTY R-1,1876,CORONADO ELEMENTARY SCHOOL,KINDERGARTEN,0,0,0,3,21,24,3,13%
1420,JEFFERSON COUNTY R-1,1876,CORONADO ELEMENTARY SCHOOL,1ST,0,2,1,7,74,84,10,12%
1420,JEFFERSON COUNTY R-1,1876,CORONADO ELEMENTARY SCHOOL,2ND,0,5,0,3,50,58,8,14%
1420,JEFFERSON COUNTY R-1,1876,CORONADO ELEMENTARY SCHOOL,3RD,0,2,0,3,74,79,5,6%
1420,JEFFERSON COUNTY R-1,1876,CORONADO ELEMENTARY SCHOOL,4TH,1,5,0,9,73,88,15,17%
1420,JEFFERSON COUNTY R-1,1876,CORONADO ELEMENTARY SCHOOL,5TH,0,2,1,9,76,88,12,14%
1420,JEFFERSON COUNTY R-1,1876,CORONADO ELEMENTARY SCHOOL,6TH,1,3,0,5,41,50,9,18%
1420,JEFFERSON COUNTY R-1,1876,CORONADO ELEMENTARY SCHOOL,SCHOOL TOTAL,3,22,6,45,475,551,76,14%
1420,JEFFERSON COUNTY R-1,1880,COMPASS MONTESSORI - GOLDEN CHARTER SCHOOL,PK,0,0,0,0,26,26,0,0%
1420,JEFFERSON COUNTY R-1,1880,COMPASS MONTESSORI - GOLDEN CHARTER SCHOOL,KINDERGARTEN,0,0,0,1,13,14,1,7%
1420,JEFFERSON COUNTY R-1,1880,COMPASS MONTESSORI - GOLDEN CHARTER SCHOOL,1ST,0,1,1,1,14,17,3,18%
1420,JEFFERSON COUNTY R-1,1880,COMPASS MONTESSORI - GOLDEN CHARTER SCHOOL,2ND,0,1,1,2,15,19,4,21%
1420,JEFFERSON COUNTY R-1,1880,COMPASS MONTESSORI - GOLDEN CHARTER SCHOOL,3RD,1,2,0,2,10,15,5,33%
1420,JEFFERSON COUNTY R-1,1880,COMPASS MONTESSORI - GOLDEN CHARTER SCHOOL,4TH,0,1,1,1,14,17,3,18%
1420,JEFFERSON COUNTY R-1,1880,COMPASS MONTESSORI - GOLDEN CHARTER SCHOOL,5TH,1,0,1,3,10,15,5,33%
1420,JEFFERSON COUNTY R-1,1880,COMPASS MONTESSORI - GOLDEN CHARTER SCHOOL,6TH,0,1,1,2,13,17,4,24%
1420,JEFFERSON COUNTY R-1,1880,COMPASS MONTESSORI - GOLDEN CHARTER SCHOOL,7TH,0,0,2,4,41,47,6,13%
1420,JEFFERSON COUNTY R-1,1880,COMPASS MONTESSORI - GOLDEN CHARTER SCHOOL,8TH,0,0,1,4,36,41,5,12%
1420,JEFFERSON COUNTY R-1,1880,COMPASS MONTESSORI - GOLDEN CHARTER SCHOOL,9TH,0,1,1,5,22,29,7,24%
1420,JEFFERSON COUNTY R-1,1880,COMPASS MONTESSORI - GOLDEN CHARTER SCHOOL,10TH,0,2,1,4,20,27,7,26%
1420,JEFFERSON COUNTY R-1,1880,COMPASS MONTESSORI - GOLDEN CHARTER SCHOOL,11TH,1,0,0,6,26,33,7,21%
1420,JEFFERSON COUNTY R-1,1880,COMPASS MONTESSORI - GOLDEN CHARTER SCHOOL,12TH,1,0,0,2,23,26,3,12%
1420,JEFFERSON COUNTY R-1,1880,COMPASS MONTESSORI - GOLDEN CHARTER SCHOOL,SCHOOL TOTAL,4,9,10,37,283,343,60,17%
1420,JEFFERSON COUNTY R-1,1886,CONIFER SENIOR HIGH SCHOOL,9TH,5,4,2,11,211,233,22,9%
1420,JEFFERSON COUNTY R-1,1886,CONIFER SENIOR HIGH SCHOOL,10TH,4,3,2,8,203,220,17,8%
1420,JEFFERSON COUNTY R-1,1886,CONIFER SENIOR HIGH SCHOOL,11TH,2,2,2,14,256,276,20,7%
1420,JEFFERSON COUNTY R-1,1886,CONIFER SENIOR HIGH SCHOOL,12TH,4,1,1,11,262,279,17,6%
1420,JEFFERSON COUNTY R-1,1886,CONIFER SENIOR HIGH SCHOOL,SCHOOL TOTAL,15,10,7,44,932,1008,76,8%
1420,JEFFERSON COUNTY R-1,1976,CREIGHTON MIDDLE SCHOOL,7TH,6,19,9,103,191,328,137,42%
1420,JEFFERSON COUNTY R-1,1976,CREIGHTON MIDDLE SCHOOL,8TH,5,16,12,92,210,335,125,37%
1420,JEFFERSON COUNTY R-1,1976,CREIGHTON MIDDLE SCHOOL,SCHOOL TOTAL,11,35,21,195,401,663,262,40%
1420,JEFFERSON COUNTY R-1,2093,DAKOTA RIDGE SENIOR HIGH SCHOOL,9TH,3,17,6,46,322,394,72,18%
1420,JEFFERSON COUNTY R-1,2093,DAKOTA RIDGE SENIOR HIGH SCHOOL,10TH,10,12,8,52,341,423,82,19%
1420,JEFFERSON COUNTY R-1,2093,DAKOTA RIDGE SENIOR HIGH SCHOOL,11TH,3,9,3,43,325,383,58,15%
1420,JEFFERSON COUNTY R-1,2093,DAKOTA RIDGE SENIOR HIGH SCHOOL,12TH,4,15,4,49,311,383,72,19%
1420,JEFFERSON COUNTY R-1,2093,DAKOTA RIDGE SENIOR HIGH SCHOOL,SCHOOL TOTAL,20,53,21,190,1299,1583,284,18%
1420,JEFFERSON COUNTY R-1,2120,D'EVELYN JUNIOR/SENIOR HIGH SCHOOL,7TH,2,15,2,13,171,203,32,16%
1420,JEFFERSON COUNTY R-1,2120,D'EVELYN JUNIOR/SENIOR HIGH SCHOOL,8TH,2,7,2,10,172,193,21,11%
1420,JEFFERSON COUNTY R-1,2120,D'EVELYN JUNIOR/SENIOR HIGH SCHOOL,9TH,2,13,0,13,148,176,28,16%
1420,JEFFERSON COUNTY R-1,2120,D'EVELYN JUNIOR/SENIOR HIGH SCHOOL,10TH,0,10,0,6,146,162,16,10%
1420,JEFFERSON COUNTY R-1,2120,D'EVELYN JUNIOR/SENIOR HIGH SCHOOL,11TH,1,7,3,17,135,163,28,17%
1420,JEFFERSON COUNTY R-1,2120,D'EVELYN JUNIOR/SENIOR HIGH SCHOOL,12TH,0,6,2,7,123,138,15,11%
1420,JEFFERSON COUNTY R-1,2120,D'EVELYN JUNIOR/SENIOR HIGH SCHOOL,SCHOOL TOTAL,7,58,9,66,895,1035,140,14%
1420,JEFFERSON COUNTY R-1,2130,DEER CREEK MIDDLE SCHOOL,7TH,2,11,3,26,223,265,42,16%
1420,JEFFERSON COUNTY R-1,2130,DEER CREEK MIDDLE SCHOOL,8TH,2,12,4,20,213,251,38,15%
1420,JEFFERSON COUNTY R-1,2130,DEER CREEK MIDDLE SCHOOL,SCHOOL TOTAL,4,23,7,46,436,516,80,16%
1420,JEFFERSON COUNTY R-1,2194,DEVINNY ELEMENTARY SCHOOL,HALF DAY K,0,2,0,4,16,22,6,27%
1420,JEFFERSON COUNTY R-1,2194,DEVINNY ELEMENTARY SCHOOL,KINDERGARTEN,0,2,0,5,43,50,7,14%
1420,JEFFERSON COUNTY R-1,2194,DEVINNY ELEMENTARY SCHOOL,1ST,0,4,0,8,65,77,12,16%
1420,JEFFERSON COUNTY R-1,2194,DEVINNY ELEMENTARY SCHOOL,2ND,0,6,1,6,71,84,13,15%
1420,JEFFERSON COUNTY R-1,2194,DEVINNY ELEMENTARY SCHOOL,3RD,2,1,0,7,76,86,10,12%
1420,JEFFERSON COUNTY R-1,2194,DEVINNY ELEMENTARY SCHOOL,4TH,0,3,2,5,85,95,10,11%
1420,JEFFERSON COUNTY R-1,2194,DEVINNY ELEMENTARY SCHOOL,5TH,1,6,0,12,82,101,19,19%
1420,JEFFERSON COUNTY R-1,2194,DEVINNY ELEMENTARY SCHOOL,6TH,0,6,1,10,82,99,17,17%
1420,JEFFERSON COUNTY R-1,2194,DEVINNY ELEMENTARY SCHOOL,SCHOOL TOTAL,3,30,4,57,520,614,94,15%
1420,JEFFERSON COUNTY R-1,2288,DRAKE JUNIOR HIGH SCHOOL,7TH,2,7,6,46,275,336,61,18%
1420,JEFFERSON COUNTY R-1,2288,DRAKE JUNIOR HIGH SCHOOL,8TH,0,7,3,41,286,337,51,15%
1420,JEFFERSON COUNTY R-1,2288,DRAKE JUNIOR HIGH SCHOOL,SCHOOL TOTAL,2,14,9,87,561,673,112,17%
1420,JEFFERSON COUNTY R-1,2300,DUNSTAN MIDDLE SCHOOL,7TH,1,12,7,41,252,313,61,19%
1420,JEFFERSON COUNTY R-1,2300,DUNSTAN MIDDLE SCHOOL,8TH,6,11,5,53,250,325,75,23%
1420,JEFFERSON COUNTY R-1,2300,DUNSTAN MIDDLE SCHOOL,SCHOOL TOTAL,7,23,12,94,502,638,136,21%
1420,JEFFERSON COUNTY R-1,2322,DUTCH CREEK ELEMENTARY SCHOOL,KINDERGARTEN,0,2,0,8,39,49,10,20%
1420,JEFFERSON COUNTY R-1,2322,DUTCH CREEK ELEMENTARY SCHOOL,1ST,0,2,2,3,23,30,7,23%
1420,JEFFERSON COUNTY R-1,2322,DUTCH CREEK ELEMENTARY SCHOOL,2ND,0,1,2,9,39,51,12,24%
1420,JEFFERSON COUNTY R-1,2322,DUTCH CREEK ELEMENTARY SCHOOL,3RD,0,2,3,7,31,43,12,28%
1420,JEFFERSON COUNTY R-1,2322,DUTCH CREEK ELEMENTARY SCHOOL,4TH,0,3,1,8,44,56,12,21%
1420,JEFFERSON COUNTY R-1,2322,DUTCH CREEK ELEMENTARY SCHOOL,5TH,0,1,1,6,37,45,8,18%
1420,JEFFERSON COUNTY R-1,2322,DUTCH CREEK ELEMENTARY SCHOOL,6TH,1,0,1,7,49,58,9,16%
1420,JEFFERSON COUNTY R-1,2322,DUTCH CREEK ELEMENTARY SCHOOL,SCHOOL TOTAL,1,11,10,48,262,332,70,21%
1420,JEFFERSON COUNTY R-1,2496,EDGEWATER ELEMENTARY SCHOOL,PK,0,0,2,49,11,62,51,82%
1420,JEFFERSON COUNTY R-1,2496,EDGEWATER ELEMENTARY SCHOOL,KINDERGARTEN,1,0,4,45,14,64,50,78%
1420,JEFFERSON COUNTY R-1,2496,EDGEWATER ELEMENTARY SCHOOL,1ST,3,0,4,43,9,59,50,85%
1420,JEFFERSON COUNTY R-1,2496,EDGEWATER ELEMENTARY SCHOOL,2ND,2,0,3,51,8,64,56,88%
1420,JEFFERSON COUNTY R-1,2496,EDGEWATER ELEMENTARY SCHOOL,3RD,1,0,1,45,7,54,47,87%
1420,JEFFERSON COUNTY R-1,2496,EDGEWATER ELEMENTARY SCHOOL,4TH,2,0,2,36,7,47,40,85%
1420,JEFFERSON COUNTY R-1,2496,EDGEWATER ELEMENTARY SCHOOL,5TH,0,0,3,32,5,40,35,88%
1420,JEFFERSON COUNTY R-1,2496,EDGEWATER ELEMENTARY SCHOOL,6TH,1,0,2,39,9,51,42,82%
1420,JEFFERSON COUNTY R-1,2496,EDGEWATER ELEMENTARY SCHOOL,SCHOOL TOTAL,10,0,21,340,70,441,371,84%
1420,JEFFERSON COUNTY R-1,2550,EIBER ELEMENTARY SCHOOL,KINDERGARTEN,1,3,6,37,20,67,47,70%
1420,JEFFERSON COUNTY R-1,2550,EIBER ELEMENTARY SCHOOL,1ST,1,4,3,38,18,64,46,72%
1420,JEFFERSON COUNTY R-1,2550,EIBER ELEMENTARY SCHOOL,2ND,1,1,4,33,23,62,39,63%
1420,JEFFERSON COUNTY R-1,2550,EIBER ELEMENTARY SCHOOL,3RD,1,1,2,32,18,54,36,67%
1420,JEFFERSON COUNTY R-1,2550,EIBER ELEMENTARY SCHOOL,4TH,0,2,4,38,20,64,44,69%
1420,JEFFERSON COUNTY R-1,2550,EIBER ELEMENTARY SCHOOL,5TH,4,6,5,34,20,69,49,71%
1420,JEFFERSON COUNTY R-1,2550,EIBER ELEMENTARY SCHOOL,6TH,2,2,1,21,21,47,26,55%
1420,JEFFERSON COUNTY R-1,2550,EIBER ELEMENTARY SCHOOL,SCHOOL TOTAL,10,19,25,233,140,427,287,67%
1420,JEFFERSON COUNTY R-1,2616,ELK CREEK ELEMENTARY SCHOOL,HALF DAY K,0,0,0,0,22,22,0,0%
1420,JEFFERSON COUNTY R-1,2616,ELK CREEK ELEMENTARY SCHOOL,KINDERGARTEN,0,0,0,0,19,19,0,0%
1420,JEFFERSON COUNTY R-1,2616,ELK CREEK ELEMENTARY SCHOOL,1ST,0,1,0,3,53,57,4,7%
1420,JEFFERSON COUNTY R-1,2616,ELK CREEK ELEMENTARY SCHOOL,2ND,0,2,0,1,47,50,3,6%
1420,JEFFERSON COUNTY R-1,2616,ELK CREEK ELEMENTARY SCHOOL,3RD,0,2,0,2,54,58,4,7%
1420,JEFFERSON COUNTY R-1,2616,ELK CREEK ELEMENTARY SCHOOL,4TH,0,2,2,3,50,57,7,12%
1420,JEFFERSON COUNTY R-1,2616,ELK CREEK ELEMENTARY SCHOOL,5TH,0,0,0,3,73,76,3,4%
1420,JEFFERSON COUNTY R-1,2616,ELK CREEK ELEMENTARY SCHOOL,SCHOOL TOTAL,0,7,2,12,318,339,21,6%
1420,JEFFERSON COUNTY R-1,2799,EXCEL ACADEMY CHARTER SCHOOL,KINDERGARTEN,0,1,0,0,42,43,1,2%
1420,JEFFERSON COUNTY R-1,2799,EXCEL ACADEMY CHARTER SCHOOL,1ST,0,0,0,2,47,49,2,4%
1420,JEFFERSON COUNTY R-1,2799,EXCEL ACADEMY CHARTER SCHOOL,2ND,1,0,2,1,55,59,4,7%
1420,JEFFERSON COUNTY R-1,2799,EXCEL ACADEMY CHARTER SCHOOL,3RD,1,0,0,3,52,56,4,7%
1420,JEFFERSON COUNTY R-1,2799,EXCEL ACADEMY CHARTER SCHOOL,4TH,0,2,2,5,49,58,9,16%
1420,JEFFERSON COUNTY R-1,2799,EXCEL ACADEMY CHARTER SCHOOL,5TH,0,1,1,3,52,57,5,9%
1420,JEFFERSON COUNTY R-1,2799,EXCEL ACADEMY CHARTER SCHOOL,6TH,1,0,2,3,44,50,6,12%
1420,JEFFERSON COUNTY R-1,2799,EXCEL ACADEMY CHARTER SCHOOL,7TH,0,1,1,7,25,34,9,26%
1420,JEFFERSON COUNTY R-1,2799,EXCEL ACADEMY CHARTER SCHOOL,8TH,1,2,1,4,35,43,8,19%
1420,JEFFERSON COUNTY R-1,2799,EXCEL ACADEMY CHARTER SCHOOL,SCHOOL TOTAL,4,7,9,28,401,449,48,11%
1420,JEFFERSON COUNTY R-1,2820,EVERITT MIDDLE SCHOOL,7TH,6,5,2,87,128,228,100,44%
1420,JEFFERSON COUNTY R-1,2820,EVERITT MIDDLE SCHOOL,8TH,8,8,7,81,146,250,104,42%
1420,JEFFERSON COUNTY R-1,2820,EVERITT MIDDLE SCHOOL,SCHOOL TOTAL,14,13,9,168,274,478,204,43%
1420,JEFFERSON COUNTY R-1,2832,EVERGREEN MIDDLE SCHOOL,6TH,1,5,2,5,185,198,13,7%
1420,JEFFERSON COUNTY R-1,2832,EVERGREEN MIDDLE SCHOOL,7TH,3,0,1,7,254,265,11,4%
1420,JEFFERSON COUNTY R-1,2832,EVERGREEN MIDDLE SCHOOL,8TH,1,4,1,4,189,199,10,5%
1420,JEFFERSON COUNTY R-1,2832,EVERGREEN MIDDLE SCHOOL,SCHOOL TOTAL,5,9,4,16,628,662,34,5%
1420,JEFFERSON COUNTY R-1,2836,EVERGREEN HIGH SCHOOL,9TH,1,3,2,8,244,258,14,5%
1420,JEFFERSON COUNTY R-1,2836,EVERGREEN HIGH SCHOOL,10TH,3,3,0,5,268,279,11,4%
1420,JEFFERSON COUNTY R-1,2836,EVERGREEN HIGH SCHOOL,11TH,4,2,3,2,204,215,11,5%
1420,JEFFERSON COUNTY R-1,2836,EVERGREEN HIGH SCHOOL,12TH,1,4,0,6,225,236,11,5%
1420,JEFFERSON COUNTY R-1,2836,EVERGREEN HIGH SCHOOL,SCHOOL TOTAL,9,12,5,21,941,988,47,5%
1420,JEFFERSON COUNTY R-1,2866,FAIRMOUNT ELEMENTARY SCHOOL,HALF DAY K,0,3,0,2,32,37,5,14%
1420,JEFFERSON COUNTY R-1,2866,FAIRMOUNT ELEMENTARY SCHOOL,KINDERGARTEN,1,1,0,4,42,48,6,13%
1420,JEFFERSON COUNTY R-1,2866,FAIRMOUNT ELEMENTARY SCHOOL,1ST,2,6,0,10,99,117,18,15%
1420,JEFFERSON COUNTY R-1,2866,FAIRMOUNT ELEMENTARY SCHOOL,2ND,0,5,2,7,79,93,14,15%
1420,JEFFERSON COUNTY R-1,2866,FAIRMOUNT ELEMENTARY SCHOOL,3RD,0,4,0,7,64,75,11,15%
1420,JEFFERSON COUNTY R-1,2866,FAIRMOUNT ELEMENTARY SCHOOL,4TH,1,7,0,10,70,88,18,20%
1420,JEFFERSON COUNTY R-1,2866,FAIRMOUNT ELEMENTARY SCHOOL,5TH,1,6,1,10,60,78,18,23%
1420,JEFFERSON COUNTY R-1,2866,FAIRMOUNT ELEMENTARY SCHOOL,6TH,0,2,0,6,54,62,8,13%
1420,JEFFERSON COUNTY R-1,2866,FAIRMOUNT ELEMENTARY SCHOOL,SCHOOL TOTAL,5,34,3,56,500,598,98,16%
1420,JEFFERSON COUNTY R-1,2946,FITZMORRIS ELEMENTARY SCHOOL,KINDERGARTEN,1,0,0,8,19,28,9,32%
1420,JEFFERSON COUNTY R-1,2946,FITZMORRIS ELEMENTARY SCHOOL,1ST,2,0,2,11,22,37,15,41%
1420,JEFFERSON COUNTY R-1,2946,FITZMORRIS ELEMENTARY SCHOOL,2ND,0,2,0,4,25,31,6,19%
1420,JEFFERSON COUNTY R-1,2946,FITZMORRIS ELEMENTARY SCHOOL,3RD,2,0,2,8,19,31,12,39%
1420,JEFFERSON COUNTY R-1,2946,FITZMORRIS ELEMENTARY SCHOOL,4TH,0,2,2,9,29,42,13,31%
1420,JEFFERSON COUNTY R-1,2946,FITZMORRIS ELEMENTARY SCHOOL,5TH,1,0,2,5,17,25,8,32%
1420,JEFFERSON COUNTY R-1,2946,FITZMORRIS ELEMENTARY SCHOOL,6TH,0,0,0,10,21,31,10,32%
1420,JEFFERSON COUNTY R-1,2946,FITZMORRIS ELEMENTARY SCHOOL,SCHOOL TOTAL,6,4,8,55,152,225,73,32%
1420,JEFFERSON COUNTY R-1,2963,FALCON BLUFFS MIDDLE SCHOOL,6TH,0,3,1,13,130,147,17,12%
1420,JEFFERSON COUNTY R-1,2963,FALCON BLUFFS MIDDLE SCHOOL,7TH,1,7,2,30,240,280,40,14%
1420,JEFFERSON COUNTY R-1,2963,FALCON BLUFFS MIDDLE SCHOOL,8TH,1,5,3,23,219,251,32,13%
1420,JEFFERSON COUNTY R-1,2963,FALCON BLUFFS MIDDLE SCHOOL,SCHOOL TOTAL,2,15,6,66,589,678,89,13%
1420,JEFFERSON COUNTY R-1,3025,FOOTHILLS ELEMENTARY SCHOOL,PK,0,2,0,8,24,34,10,29%
1420,JEFFERSON COUNTY R-1,3025,FOOTHILLS ELEMENTARY SCHOOL,KINDERGARTEN,1,3,2,13,34,53,19,36%
1420,JEFFERSON COUNTY R-1,3025,FOOTHILLS ELEMENTARY SCHOOL,1ST,4,2,2,11,27,46,19,41%
1420,JEFFERSON COUNTY R-1,3025,FOOTHILLS ELEMENTARY SCHOOL,2ND,0,4,3,8,30,45,15,33%
1420,JEFFERSON COUNTY R-1,3025,FOOTHILLS ELEMENTARY SCHOOL,3RD,0,2,2,7,26,37,11,30%
1420,JEFFERSON COUNTY R-1,3025,FOOTHILLS ELEMENTARY SCHOOL,4TH,1,2,2,8,31,44,13,30%
1420,JEFFERSON COUNTY R-1,3025,FOOTHILLS ELEMENTARY SCHOOL,5TH,1,4,4,8,30,47,17,36%
1420,JEFFERSON COUNTY R-1,3025,FOOTHILLS ELEMENTARY SCHOOL,6TH,0,0,2,6,18,26,8,31%
1420,JEFFERSON COUNTY R-1,3025,FOOTHILLS ELEMENTARY SCHOOL,SCHOOL TOTAL,7,19,17,69,220,332,112,34%
1420,JEFFERSON COUNTY R-1,3088,FOSTER ELEMENTARY SCHOOL,PK,0,0,1,33,23,57,34,60%
1420,JEFFERSON COUNTY R-1,3088,FOSTER ELEMENTARY SCHOOL,KINDERGARTEN,0,1,2,29,31,63,32,51%
1420,JEFFERSON COUNTY R-1,3088,FOSTER ELEMENTARY SCHOOL,1ST,0,1,3,40,25,69,44,64%
1420,JEFFERSON COUNTY R-1,3088,FOSTER ELEMENTARY SCHOOL,2ND,0,0,2,39,28,69,41,59%
1420,JEFFERSON COUNTY R-1,3088,FOSTER ELEMENTARY SCHOOL,3RD,1,0,2,23,23,49,26,53%
1420,JEFFERSON COUNTY R-1,3088,FOSTER ELEMENTARY SCHOOL,4TH,0,0,0,29,26,55,29,53%
1420,JEFFERSON COUNTY R-1,3088,FOSTER ELEMENTARY SCHOOL,5TH,0,0,1,40,23,64,41,64%
1420,JEFFERSON COUNTY R-1,3088,FOSTER ELEMENTARY SCHOOL,6TH,0,0,0,27,16,43,27,63%
1420,JEFFERSON COUNTY R-1,3088,FOSTER ELEMENTARY SCHOOL,SCHOOL TOTAL,1,2,11,260,195,469,274,58%
1420,JEFFERSON COUNTY R-1,3201,FREE HORIZON MONTESSORI CHARTER SCHOOL,PK,0,2,0,1,53,56,3,5%
1420,JEFFERSON COUNTY R-1,3201,FREE HORIZON MONTESSORI CHARTER SCHOOL,HALF DAY K,0,1,0,0,11,12,1,8%
1420,JEFFERSON COUNTY R-1,3201,FREE HORIZON MONTESSORI CHARTER SCHOOL,KINDERGARTEN,0,1,0,2,26,29,3,10%
1420,JEFFERSON COUNTY R-1,3201,FREE HORIZON MONTESSORI CHARTER SCHOOL,1ST,0,0,2,1,47,50,3,6%
1420,JEFFERSON COUNTY R-1,3201,FREE HORIZON MONTESSORI CHARTER SCHOOL,2ND,0,2,1,7,28,38,10,26%
1420,JEFFERSON COUNTY R-1,3201,FREE HORIZON MONTESSORI CHARTER SCHOOL,3RD,1,2,0,4,38,45,7,16%
1420,JEFFERSON COUNTY R-1,3201,FREE HORIZON MONTESSORI CHARTER SCHOOL,4TH,0,3,3,5,20,31,11,35%
1420,JEFFERSON COUNTY R-1,3201,FREE HORIZON MONTESSORI CHARTER SCHOOL,5TH,0,1,0,2,35,38,3,8%
1420,JEFFERSON COUNTY R-1,3201,FREE HORIZON MONTESSORI CHARTER SCHOOL,6TH,0,1,2,2,28,33,5,15%
1420,JEFFERSON COUNTY R-1,3201,FREE HORIZON MONTESSORI CHARTER SCHOOL,SCHOOL TOTAL,1,13,8,24,286,332,46,14%
1420,JEFFERSON COUNTY R-1,3216,FREMONT ELEMENTARY SCHOOL,KINDERGARTEN,0,0,1,8,45,54,9,17%
1420,JEFFERSON COUNTY R-1,3216,FREMONT ELEMENTARY SCHOOL,1ST,1,1,1,7,48,58,10,17%
1420,JEFFERSON COUNTY R-1,3216,FREMONT ELEMENTARY SCHOOL,2ND,1,1,1,7,48,58,10,17%
1420,JEFFERSON COUNTY R-1,3216,FREMONT ELEMENTARY SCHOOL,3RD,1,2,0,8,42,53,11,21%
1420,JEFFERSON COUNTY R-1,3216,FREMONT ELEMENTARY SCHOOL,4TH,1,0,0,5,45,51,6,12%
1420,JEFFERSON COUNTY R-1,3216,FREMONT ELEMENTARY SCHOOL,5TH,0,0,0,5,35,40,5,13%
1420,JEFFERSON COUNTY R-1,3216,FREMONT ELEMENTARY SCHOOL,6TH,0,1,3,5,42,51,9,18%
1420,JEFFERSON COUNTY R-1,3216,FREMONT ELEMENTARY SCHOOL,SCHOOL TOTAL,4,5,6,45,305,365,60,16%
1420,JEFFERSON COUNTY R-1,3250,NORMA ANDERSON PRESCHOOL,PK,0,2,0,20,93,115,22,19%
1420,JEFFERSON COUNTY R-1,3250,NORMA ANDERSON PRESCHOOL,SCHOOL TOTAL,0,2,0,20,93,115,22,19%
1420,JEFFERSON COUNTY R-1,3450,GLENNON HEIGHTS ELEMENTARY SCHOOL,KINDERGARTEN,1,0,0,12,26,39,13,33%
1420,JEFFERSON COUNTY R-1,3450,GLENNON HEIGHTS ELEMENTARY SCHOOL,1ST,2,1,1,10,35,49,14,29%
1420,JEFFERSON COUNTY R-1,3450,GLENNON HEIGHTS ELEMENTARY SCHOOL,2ND,1,5,0,9,22,37,15,41%
1420,JEFFERSON COUNTY R-1,3450,GLENNON HEIGHTS ELEMENTARY SCHOOL,3RD,0,1,3,8,23,35,12,34%
1420,JEFFERSON COUNTY R-1,3450,GLENNON HEIGHTS ELEMENTARY SCHOOL,4TH,0,2,0,13,33,48,15,31%
1420,JEFFERSON COUNTY R-1,3450,GLENNON HEIGHTS ELEMENTARY SCHOOL,5TH,0,2,0,8,21,31,10,32%
1420,JEFFERSON COUNTY R-1,3450,GLENNON HEIGHTS ELEMENTARY SCHOOL,6TH,0,1,4,10,34,49,15,31%
1420,JEFFERSON COUNTY R-1,3450,GLENNON HEIGHTS ELEMENTARY SCHOOL,SCHOOL TOTAL,4,12,8,70,194,288,94,33%
1420,JEFFERSON COUNTY R-1,3502,GOLDEN HIGH SCHOOL,9TH,4,12,2,25,261,304,43,14%
1420,JEFFERSON COUNTY R-1,3502,GOLDEN HIGH SCHOOL,10TH,2,11,3,26,319,361,42,12%
1420,JEFFERSON COUNTY R-1,3502,GOLDEN HIGH SCHOOL,11TH,6,5,2,17,312,342,30,9%
1420,JEFFERSON COUNTY R-1,3502,GOLDEN HIGH SCHOOL,12TH,1,9,2,26,251,289,38,13%
1420,JEFFERSON COUNTY R-1,3502,GOLDEN HIGH SCHOOL,SCHOOL TOTAL,13,37,9,94,1143,1296,153,12%
1420,JEFFERSON COUNTY R-1,3536,GOVERNOR'S RANCH ELEMENTARY SCHOOL,HALF DAY K,0,0,1,2,16,19,3,16%
1420,JEFFERSON COUNTY R-1,3536,GOVERNOR'S RANCH ELEMENTARY SCHOOL,KINDERGARTEN,0,3,1,2,39,45,6,13%
1420,JEFFERSON COUNTY R-1,3536,GOVERNOR'S RANCH ELEMENTARY SCHOOL,1ST,1,3,0,7,59,70,11,16%
1420,JEFFERSON COUNTY R-1,3536,GOVERNOR'S RANCH ELEMENTARY SCHOOL,2ND,1,2,0,8,54,65,11,17%
1420,JEFFERSON COUNTY R-1,3536,GOVERNOR'S RANCH ELEMENTARY SCHOOL,3RD,1,3,2,4,52,62,10,16%
1420,JEFFERSON COUNTY R-1,3536,GOVERNOR'S RANCH ELEMENTARY SCHOOL,4TH,1,4,4,10,51,70,19,27%
1420,JEFFERSON COUNTY R-1,3536,GOVERNOR'S RANCH ELEMENTARY SCHOOL,5TH,1,4,2,6,65,78,13,17%
1420,JEFFERSON COUNTY R-1,3536,GOVERNOR'S RANCH ELEMENTARY SCHOOL,6TH,0,6,0,10,63,79,16,20%
1420,JEFFERSON COUNTY R-1,3536,GOVERNOR'S RANCH ELEMENTARY SCHOOL,SCHOOL TOTAL,5,25,10,49,399,488,89,18%
1420,JEFFERSON COUNTY R-1,3622,GREEN GABLES ELEMENTARY SCHOOL,KINDERGARTEN,2,1,0,10,36,49,13,27%
1420,JEFFERSON COUNTY R-1,3622,GREEN GABLES ELEMENTARY SCHOOL,1ST,0,2,2,6,30,40,10,25%
1420,JEFFERSON COUNTY R-1,3622,GREEN GABLES ELEMENTARY SCHOOL,2ND,0,1,0,11,32,44,12,27%
1420,JEFFERSON COUNTY R-1,3622,GREEN GABLES ELEMENTARY SCHOOL,3RD,2,1,0,14,24,41,17,41%
1420,JEFFERSON COUNTY R-1,3622,GREEN GABLES ELEMENTARY SCHOOL,4TH,0,3,1,9,30,43,13,30%
1420,JEFFERSON COUNTY R-1,3622,GREEN GABLES ELEMENTARY SCHOOL,5TH,0,3,1,12,45,61,16,26%
1420,JEFFERSON COUNTY R-1,3622,GREEN GABLES ELEMENTARY SCHOOL,6TH,0,1,0,15,38,54,16,30%
1420,JEFFERSON COUNTY R-1,3622,GREEN GABLES ELEMENTARY SCHOOL,SCHOOL TOTAL,4,12,4,77,235,332,97,29%
1420,JEFFERSON COUNTY R-1,3624,GREEN MOUNTAIN ELEMENTARY SCHOOL,PK,2,3,2,26,73,106,33,31%
1420,JEFFERSON COUNTY R-1,3624,GREEN MOUNTAIN ELEMENTARY SCHOOL,KINDERGARTEN,0,4,1,9,34,48,14,29%
1420,JEFFERSON COUNTY R-1,3624,GREEN MOUNTAIN ELEMENTARY SCHOOL,1ST,1,2,2,12,33,50,17,34%
1420,JEFFERSON COUNTY R-1,3624,GREEN MOUNTAIN ELEMENTARY SCHOOL,2ND,0,0,0,10,28,38,10,26%
1420,JEFFERSON COUNTY R-1,3624,GREEN MOUNTAIN ELEMENTARY SCHOOL,3RD,0,0,0,11,28,39,11,28%
1420,JEFFERSON COUNTY R-1,3624,GREEN MOUNTAIN ELEMENTARY SCHOOL,4TH,0,2,1,7,23,33,10,30%
1420,JEFFERSON COUNTY R-1,3624,GREEN MOUNTAIN ELEMENTARY SCHOOL,5TH,1,1,2,8,18,30,12,40%
1420,JEFFERSON COUNTY R-1,3624,GREEN MOUNTAIN ELEMENTARY SCHOOL,6TH,1,1,0,7,25,34,9,26%
1420,JEFFERSON COUNTY R-1,3624,GREEN MOUNTAIN ELEMENTARY SCHOOL,SCHOOL TOTAL,5,13,8,90,262,378,116,31%
1420,JEFFERSON COUNTY R-1,3628,GREEN MOUNTAIN HIGH SCHOOL,9TH,4,12,6,29,248,299,51,17%
1420,JEFFERSON COUNTY R-1,3628,GREEN MOUNTAIN HIGH SCHOOL,10TH,8,13,7,44,277,349,72,21%
1420,JEFFERSON COUNTY R-1,3628,GREEN MOUNTAIN HIGH SCHOOL,11TH,1,14,4,47,278,344,66,19%
1420,JEFFERSON COUNTY R-1,3628,GREEN MOUNTAIN HIGH SCHOOL,12TH,8,12,9,36,294,359,65,18%
1420,JEFFERSON COUNTY R-1,3628,GREEN MOUNTAIN HIGH SCHOOL,SCHOOL TOTAL,21,51,26,156,1097,1351,254,19%
1420,JEFFERSON COUNTY R-1,3726,HACKBERRY HILL ELEMENTARY SCHOOL,HALF DAY K,1,3,0,5,30,39,9,23%
1420,JEFFERSON COUNTY R-1,3726,HACKBERRY HILL ELEMENTARY SCHOOL,1ST,1,2,1,14,46,64,18,28%
1420,JEFFERSON COUNTY R-1,3726,HACKBERRY HILL ELEMENTARY SCHOOL,2ND,1,2,0,9,52,64,12,19%
1420,JEFFERSON COUNTY R-1,3726,HACKBERRY HILL ELEMENTARY SCHOOL,3RD,0,3,1,9,60,73,13,18%
1420,JEFFERSON COUNTY R-1,3726,HACKBERRY HILL ELEMENTARY SCHOOL,4TH,0,4,3,13,56,76,20,26%
1420,JEFFERSON COUNTY R-1,3726,HACKBERRY HILL ELEMENTARY SCHOOL,5TH,1,3,2,15,53,74,21,28%
1420,JEFFERSON COUNTY R-1,3726,HACKBERRY HILL ELEMENTARY SCHOOL,6TH,1,3,2,16,60,82,22,27%
1420,JEFFERSON COUNTY R-1,3726,HACKBERRY HILL ELEMENTARY SCHOOL,SCHOOL TOTAL,5,20,9,81,357,472,115,24%
1420,JEFFERSON COUNTY R-1,4190,HUTCHINSON ELEMENTARY SCHOOL,HALF DAY K,0,0,0,0,24,24,0,0%
1420,JEFFERSON COUNTY R-1,4190,HUTCHINSON ELEMENTARY SCHOOL,KINDERGARTEN,0,0,0,1,33,34,1,3%
1420,JEFFERSON COUNTY R-1,4190,HUTCHINSON ELEMENTARY SCHOOL,1ST,0,0,2,5,52,59,7,12%
1420,JEFFERSON COUNTY R-1,4190,HUTCHINSON ELEMENTARY SCHOOL,2ND,0,1,1,2,49,53,4,8%
1420,JEFFERSON COUNTY R-1,4190,HUTCHINSON ELEMENTARY SCHOOL,3RD,0,0,2,10,49,61,12,20%
1420,JEFFERSON COUNTY R-1,4190,HUTCHINSON ELEMENTARY SCHOOL,4TH,0,4,2,6,48,60,12,20%
1420,JEFFERSON COUNTY R-1,4190,HUTCHINSON ELEMENTARY SCHOOL,5TH,2,0,0,3,59,64,5,8%
1420,JEFFERSON COUNTY R-1,4190,HUTCHINSON ELEMENTARY SCHOOL,6TH,0,3,2,6,48,59,11,19%
1420,JEFFERSON COUNTY R-1,4190,HUTCHINSON ELEMENTARY SCHOOL,SCHOOL TOTAL,2,8,9,33,362,414,52,13%
1420,JEFFERSON COUNTY R-1,4402,JEFFERSON ACADEMY CHARTER SCHOOL,HALF DAY K,0,1,0,1,40,42,2,5%
1420,JEFFERSON COUNTY R-1,4402,JEFFERSON ACADEMY CHARTER SCHOOL,1ST,0,3,0,2,51,56,5,9%
1420,JEFFERSON COUNTY R-1,4402,JEFFERSON ACADEMY CHARTER SCHOOL,2ND,0,5,1,3,47,56,9,16%
1420,JEFFERSON COUNTY R-1,4402,JEFFERSON ACADEMY CHARTER SCHOOL,3RD,0,6,2,1,48,57,9,16%
1420,JEFFERSON COUNTY R-1,4402,JEFFERSON ACADEMY CHARTER SCHOOL,4TH,0,4,0,2,50,56,6,11%
1420,JEFFERSON COUNTY R-1,4402,JEFFERSON ACADEMY CHARTER SCHOOL,5TH,0,6,1,6,43,56,13,23%
1420,JEFFERSON COUNTY R-1,4402,JEFFERSON ACADEMY CHARTER SCHOOL,6TH,0,3,1,0,50,54,4,7%
1420,JEFFERSON COUNTY R-1,4402,JEFFERSON ACADEMY CHARTER SCHOOL,SCHOOL TOTAL,0,28,5,15,329,377,48,13%
1420,JEFFERSON COUNTY R-1,4404,JEFFERSON CHARTER ACADEMY JUNIOR HIGH SCHOOL,7TH,0,2,2,9,69,82,13,16%
1420,JEFFERSON COUNTY R-1,4404,JEFFERSON CHARTER ACADEMY JUNIOR HIGH SCHOOL,8TH,0,4,3,8,71,86,15,17%
1420,JEFFERSON COUNTY R-1,4404,JEFFERSON CHARTER ACADEMY JUNIOR HIGH SCHOOL,SCHOOL TOTAL,0,6,5,17,140,168,28,17%
1420,JEFFERSON COUNTY R-1,4408,JEFFCO'S 21ST CENTURY VIRTUAL ACADEMY,8TH,0,0,0,0,1,1,0,0%
1420,JEFFERSON COUNTY R-1,4408,JEFFCO'S 21ST CENTURY VIRTUAL ACADEMY,9TH,0,0,0,1,9,10,1,10%
1420,JEFFERSON COUNTY R-1,4408,JEFFCO'S 21ST CENTURY VIRTUAL ACADEMY,10TH,0,0,0,3,16,19,3,16%
1420,JEFFERSON COUNTY R-1,4408,JEFFCO'S 21ST CENTURY VIRTUAL ACADEMY,11TH,0,0,2,3,17,22,5,23%
1420,JEFFERSON COUNTY R-1,4408,JEFFCO'S 21ST CENTURY VIRTUAL ACADEMY,12TH,0,0,1,4,35,40,5,13%
1420,JEFFERSON COUNTY R-1,4408,JEFFCO'S 21ST CENTURY VIRTUAL ACADEMY,SCHOOL TOTAL,0,0,3,11,78,92,14,15%
1420,JEFFERSON COUNTY R-1,4410,JEFFERSON CHARTER ACADEMY SENIOR HIGH SCHOOL,9TH,1,4,0,18,75,98,23,23%
1420,JEFFERSON COUNTY R-1,4410,JEFFERSON CHARTER ACADEMY SENIOR HIGH SCHOOL,10TH,2,3,3,15,61,84,23,27%
1420,JEFFERSON COUNTY R-1,4410,JEFFERSON CHARTER ACADEMY SENIOR HIGH SCHOOL,11TH,0,3,1,6,53,63,10,16%
1420,JEFFERSON COUNTY R-1,4410,JEFFERSON CHARTER ACADEMY SENIOR HIGH SCHOOL,12TH,0,1,2,3,39,45,6,13%
1420,JEFFERSON COUNTY R-1,4410,JEFFERSON CHARTER ACADEMY SENIOR HIGH SCHOOL,SCHOOL TOTAL,3,11,6,42,228,290,62,21%
1420,JEFFERSON COUNTY R-1,4422,JEFFERSON HIGH SCHOOL,9TH,5,1,4,106,37,153,116,76%
1420,JEFFERSON COUNTY R-1,4422,JEFFERSON HIGH SCHOOL,10TH,7,1,9,111,17,145,128,88%
1420,JEFFERSON COUNTY R-1,4422,JEFFERSON HIGH SCHOOL,11TH,4,1,10,130,31,176,145,82%
1420,JEFFERSON COUNTY R-1,4422,JEFFERSON HIGH SCHOOL,12TH,0,1,3,94,27,125,98,78%
1420,JEFFERSON COUNTY R-1,4422,JEFFERSON HIGH SCHOOL,SCHOOL TOTAL,16,4,26,441,112,599,487,81%
1420,JEFFERSON COUNTY R-1,4478,SHERIDAN GREEN ELEMENTARY SCHOOL,HALF DAY K,0,7,1,5,23,36,13,36%
1420,JEFFERSON COUNTY R-1,4478,SHERIDAN GREEN ELEMENTARY SCHOOL,KINDERGARTEN,0,2,1,7,32,42,10,24%
1420,JEFFERSON COUNTY R-1,4478,SHERIDAN GREEN ELEMENTARY SCHOOL,1ST,0,4,4,9,40,57,17,30%
1420,JEFFERSON COUNTY R-1,4478,SHERIDAN GREEN ELEMENTARY SCHOOL,2ND,0,5,1,21,38,65,27,42%
1420,JEFFERSON COUNTY R-1,4478,SHERIDAN GREEN ELEMENTARY SCHOOL,3RD,2,4,2,12,47,67,20,30%
1420,JEFFERSON COUNTY R-1,4478,SHERIDAN GREEN ELEMENTARY SCHOOL,4TH,0,3,0,10,30,43,13,30%
1420,JEFFERSON COUNTY R-1,4478,SHERIDAN GREEN ELEMENTARY SCHOOL,5TH,1,4,2,12,35,54,19,35%
1420,JEFFERSON COUNTY R-1,4478,SHERIDAN GREEN ELEMENTARY SCHOOL,6TH,0,4,1,12,35,52,17,33%
1420,JEFFERSON COUNTY R-1,4478,SHERIDAN GREEN ELEMENTARY SCHOOL,SCHOOL TOTAL,3,33,12,88,280,416,136,33%
1420,JEFFERSON COUNTY R-1,4548,KEN CARYL MIDDLE SCHOOL,7TH,8,13,2,36,242,301,59,20%
1420,JEFFERSON COUNTY R-1,4548,KEN CARYL MIDDLE SCHOOL,8TH,7,12,9,24,241,293,52,18%
1420,JEFFERSON COUNTY R-1,4548,KEN CARYL MIDDLE SCHOOL,SCHOOL TOTAL,15,25,11,60,483,594,111,19%
1420,JEFFERSON COUNTY R-1,4549,KENDALLVUE ELEMENTARY SCHOOL,PK,1,2,1,9,62,75,13,17%
1420,JEFFERSON COUNTY R-1,4549,KENDALLVUE ELEMENTARY SCHOOL,HALF DAY K,0,0,0,6,39,45,6,13%
1420,JEFFERSON COUNTY R-1,4549,KENDALLVUE ELEMENTARY SCHOOL,KINDERGARTEN,0,0,0,2,23,25,2,8%
1420,JEFFERSON COUNTY R-1,4549,KENDALLVUE ELEMENTARY SCHOOL,1ST,1,1,3,16,54,75,21,28%
1420,JEFFERSON COUNTY R-1,4549,KENDALLVUE ELEMENTARY SCHOOL,2ND,1,0,0,11,53,65,12,18%
1420,JEFFERSON COUNTY R-1,4549,KENDALLVUE ELEMENTARY SCHOOL,3RD,2,3,2,17,41,65,24,37%
1420,JEFFERSON COUNTY R-1,4549,KENDALLVUE ELEMENTARY SCHOOL,4TH,1,0,0,12,52,65,13,20%
1420,JEFFERSON COUNTY R-1,4549,KENDALLVUE ELEMENTARY SCHOOL,5TH,1,0,2,20,54,77,23,30%
1420,JEFFERSON COUNTY R-1,4549,KENDALLVUE ELEMENTARY SCHOOL,6TH,4,1,0,11,52,68,16,24%
1420,JEFFERSON COUNTY R-1,4549,KENDALLVUE ELEMENTARY SCHOOL,SCHOOL TOTAL,11,7,8,104,430,560,130,23%
1420,JEFFERSON COUNTY R-1,4550,KENDRICK LAKES ELEMENTARY SCHOOL,PK,0,0,0,5,28,33,5,15%
1420,JEFFERSON COUNTY R-1,4550,KENDRICK LAKES ELEMENTARY SCHOOL,KINDERGARTEN,1,1,0,15,46,63,17,27%
1420,JEFFERSON COUNTY R-1,4550,KENDRICK LAKES ELEMENTARY SCHOOL,1ST,0,3,1,9,37,50,13,26%
1420,JEFFERSON COUNTY R-1,4550,KENDRICK LAKES ELEMENTARY SCHOOL,2ND,0,0,3,10,35,48,13,27%
1420,JEFFERSON COUNTY R-1,4550,KENDRICK LAKES ELEMENTARY SCHOOL,3RD,0,2,2,14,52,70,18,26%
1420,JEFFERSON COUNTY R-1,4550,KENDRICK LAKES ELEMENTARY SCHOOL,4TH,1,2,0,15,44,62,18,29%
1420,JEFFERSON COUNTY R-1,4550,KENDRICK LAKES ELEMENTARY SCHOOL,5TH,0,1,1,7,43,52,9,17%
1420,JEFFERSON COUNTY R-1,4550,KENDRICK LAKES ELEMENTARY SCHOOL,6TH,0,4,1,13,37,55,18,33%
1420,JEFFERSON COUNTY R-1,4550,KENDRICK LAKES ELEMENTARY SCHOOL,SCHOOL TOTAL,2,13,8,88,322,433,111,26%
1420,JEFFERSON COUNTY R-1,4798,JOHNSON INTERVENTION,7TH,0,0,0,3,1,4,3,75%
1420,JEFFERSON COUNTY R-1,4798,JOHNSON INTERVENTION,8TH,0,0,0,1,7,8,1,13%
1420,JEFFERSON COUNTY R-1,4798,JOHNSON INTERVENTION,9TH,1,0,0,8,7,16,9,56%
1420,JEFFERSON COUNTY R-1,4798,JOHNSON INTERVENTION,10TH,1,0,0,5,11,17,6,35%
1420,JEFFERSON COUNTY R-1,4798,JOHNSON INTERVENTION,SCHOOL TOTAL,2,0,0,17,26,45,19,42%
1420,JEFFERSON COUNTY R-1,4802,KULLERSTRAND ELEMENTARY SCHOOL,KINDERGARTEN,1,0,0,11,35,47,12,26%
1420,JEFFERSON COUNTY R-1,4802,KULLERSTRAND ELEMENTARY SCHOOL,1ST,1,0,1,16,23,41,18,44%
1420,JEFFERSON COUNTY R-1,4802,KULLERSTRAND ELEMENTARY SCHOOL,2ND,0,1,0,14,26,41,15,37%
1420,JEFFERSON COUNTY R-1,4802,KULLERSTRAND ELEMENTARY SCHOOL,3RD,0,0,0,12,30,42,12,29%
1420,JEFFERSON COUNTY R-1,4802,KULLERSTRAND ELEMENTARY SCHOOL,4TH,3,0,4,13,18,38,20,53%
1420,JEFFERSON COUNTY R-1,4802,KULLERSTRAND ELEMENTARY SCHOOL,5TH,1,0,1,15,20,37,17,46%
1420,JEFFERSON COUNTY R-1,4802,KULLERSTRAND ELEMENTARY SCHOOL,6TH,1,0,1,6,24,32,8,25%
1420,JEFFERSON COUNTY R-1,4802,KULLERSTRAND ELEMENTARY SCHOOL,SCHOOL TOTAL,7,1,7,87,176,278,102,37%
1420,JEFFERSON COUNTY R-1,4830,KYFFIN ELEMENTARY SCHOOL,HALF DAY K,0,3,0,0,12,15,3,20%
1420,JEFFERSON COUNTY R-1,4830,KYFFIN ELEMENTARY SCHOOL,KINDERGARTEN,0,4,0,1,47,52,5,10%
1420,JEFFERSON COUNTY R-1,4830,KYFFIN ELEMENTARY SCHOOL,1ST,0,6,0,3,82,91,9,10%
1420,JEFFERSON COUNTY R-1,4830,KYFFIN ELEMENTARY SCHOOL,2ND,0,6,0,2,74,82,8,10%
1420,JEFFERSON COUNTY R-1,4830,KYFFIN ELEMENTARY SCHOOL,3RD,0,7,0,3,65,75,10,13%
1420,JEFFERSON COUNTY R-1,4830,KYFFIN ELEMENTARY SCHOOL,4TH,0,5,0,5,93,103,10,10%
1420,JEFFERSON COUNTY R-1,4830,KYFFIN ELEMENTARY SCHOOL,5TH,0,7,1,6,71,85,14,16%
1420,JEFFERSON COUNTY R-1,4830,KYFFIN ELEMENTARY SCHOOL,6TH,1,6,4,6,66,83,17,20%
1420,JEFFERSON COUNTY R-1,4830,KYFFIN ELEMENTARY SCHOOL,SCHOOL TOTAL,1,44,5,26,510,586,76,13%
1420,JEFFERSON COUNTY R-1,4942,LAKEWOOD HIGH SCHOOL,9TH,8,38,9,149,360,564,204,36%
1420,JEFFERSON COUNTY R-1,4942,LAKEWOOD HIGH SCHOOL,10TH,13,26,15,107,367,528,161,30%
1420,JEFFERSON COUNTY R-1,4942,LAKEWOOD HIGH SCHOOL,11TH,15,26,14,100,321,476,155,33%
1420,JEFFERSON COUNTY R-1,4942,LAKEWOOD HIGH SCHOOL,12TH,3,28,9,65,293,398,105,26%
1420,JEFFERSON COUNTY R-1,4942,LAKEWOOD HIGH SCHOOL,SCHOOL TOTAL,39,118,47,421,1341,1966,625,32%
1420,JEFFERSON COUNTY R-1,5004,LASLEY ELEMENTARY SCHOOL,KINDERGARTEN,2,4,2,44,27,79,52,66%
1420,JEFFERSON COUNTY R-1,5004,LASLEY ELEMENTARY SCHOOL,1ST,3,12,2,44,21,82,61,74%
1420,JEFFERSON COUNTY R-1,5004,LASLEY ELEMENTARY SCHOOL,2ND,1,7,2,56,27,93,66,71%
1420,JEFFERSON COUNTY R-1,5004,LASLEY ELEMENTARY SCHOOL,3RD,4,8,1,63,19,95,76,80%
1420,JEFFERSON COUNTY R-1,5004,LASLEY ELEMENTARY SCHOOL,4TH,2,7,1,50,16,76,60,79%
1420,JEFFERSON COUNTY R-1,5004,LASLEY ELEMENTARY SCHOOL,5TH,0,8,4,62,25,99,74,75%
1420,JEFFERSON COUNTY R-1,5004,LASLEY ELEMENTARY SCHOOL,6TH,2,9,6,75,30,122,92,75%
1420,JEFFERSON COUNTY R-1,5004,LASLEY ELEMENTARY SCHOOL,SCHOOL TOTAL,14,55,18,394,165,646,481,74%
1420,JEFFERSON COUNTY R-1,5024,LAWRENCE ELEMENTARY SCHOOL,PK,0,1,1,7,20,29,9,31%
1420,JEFFERSON COUNTY R-1,5024,LAWRENCE ELEMENTARY SCHOOL,KINDERGARTEN,1,2,4,13,31,51,20,39%
1420,JEFFERSON COUNTY R-1,5024,LAWRENCE ELEMENTARY SCHOOL,1ST,1,3,0,14,39,57,18,32%
1420,JEFFERSON COUNTY R-1,5024,LAWRENCE ELEMENTARY SCHOOL,2ND,2,4,2,13,28,49,21,43%
1420,JEFFERSON COUNTY R-1,5024,LAWRENCE ELEMENTARY SCHOOL,3RD,0,2,2,15,47,66,19,29%
1420,JEFFERSON COUNTY R-1,5024,LAWRENCE ELEMENTARY SCHOOL,4TH,6,3,2,12,37,60,23,38%
1420,JEFFERSON COUNTY R-1,5024,LAWRENCE ELEMENTARY SCHOOL,5TH,2,2,4,10,24,42,18,43%
1420,JEFFERSON COUNTY R-1,5024,LAWRENCE ELEMENTARY SCHOOL,6TH,6,2,2,15,36,61,25,41%
1420,JEFFERSON COUNTY R-1,5024,LAWRENCE ELEMENTARY SCHOOL,SCHOOL TOTAL,18,19,17,99,262,415,153,37%
1420,JEFFERSON COUNTY R-1,5036,LEAWOOD ELEMENTARY SCHOOL,PK,0,6,0,8,49,63,14,22%
1420,JEFFERSON COUNTY R-1,5036,LEAWOOD ELEMENTARY SCHOOL,HALF DAY K,1,2,0,5,32,40,8,20%
1420,JEFFERSON COUNTY R-1,5036,LEAWOOD ELEMENTARY SCHOOL,KINDERGARTEN,0,2,2,2,17,23,6,26%
1420,JEFFERSON COUNTY R-1,5036,LEAWOOD ELEMENTARY SCHOOL,1ST,1,1,3,8,42,55,13,24%
1420,JEFFERSON COUNTY R-1,5036,LEAWOOD ELEMENTARY SCHOOL,2ND,0,3,2,5,41,51,10,20%
1420,JEFFERSON COUNTY R-1,5036,LEAWOOD ELEMENTARY SCHOOL,3RD,0,4,3,9,34,50,16,32%
1420,JEFFERSON COUNTY R-1,5036,LEAWOOD ELEMENTARY SCHOOL,4TH,0,4,2,6,44,56,12,21%
1420,JEFFERSON COUNTY R-1,5036,LEAWOOD ELEMENTARY SCHOOL,5TH,0,1,1,11,38,51,13,25%
1420,JEFFERSON COUNTY R-1,5036,LEAWOOD ELEMENTARY SCHOOL,6TH,0,2,2,12,40,56,16,29%
1420,JEFFERSON COUNTY R-1,5036,LEAWOOD ELEMENTARY SCHOOL,SCHOOL TOTAL,2,25,15,66,337,445,108,24%
1420,JEFFERSON COUNTY R-1,5145,LINCOLN CHARTER ACADEMY,HALF DAY K,0,4,1,4,32,41,9,22%
1420,JEFFERSON COUNTY R-1,5145,LINCOLN CHARTER ACADEMY,KINDERGARTEN,0,2,0,3,15,20,5,25%
1420,JEFFERSON COUNTY R-1,5145,LINCOLN CHARTER ACADEMY,1ST,0,2,3,8,45,58,13,22%
1420,JEFFERSON COUNTY R-1,5145,LINCOLN CHARTER ACADEMY,2ND,0,3,1,5,49,58,9,16%
1420,JEFFERSON COUNTY R-1,5145,LINCOLN CHARTER ACADEMY,3RD,1,4,3,10,40,58,18,31%
1420,JEFFERSON COUNTY R-1,5145,LINCOLN CHARTER ACADEMY,4TH,0,0,1,7,48,56,8,14%
1420,JEFFERSON COUNTY R-1,5145,LINCOLN CHARTER ACADEMY,5TH,0,3,0,8,47,58,11,19%
1420,JEFFERSON COUNTY R-1,5145,LINCOLN CHARTER ACADEMY,6TH,2,3,2,9,41,57,16,28%
1420,JEFFERSON COUNTY R-1,5145,LINCOLN CHARTER ACADEMY,7TH,0,1,1,6,41,49,8,16%
1420,JEFFERSON COUNTY R-1,5145,LINCOLN CHARTER ACADEMY,8TH,0,3,0,5,29,37,8,22%
1420,JEFFERSON COUNTY R-1,5145,LINCOLN CHARTER ACADEMY,SCHOOL TOTAL,3,25,12,65,387,492,105,21%
1420,JEFFERSON COUNTY R-1,5222,LITTLE ELEMENTARY SCHOOL,KINDERGARTEN,0,2,1,11,46,60,14,23%
1420,JEFFERSON COUNTY R-1,5222,LITTLE ELEMENTARY SCHOOL,1ST,0,3,4,11,30,48,18,38%
1420,JEFFERSON COUNTY R-1,5222,LITTLE ELEMENTARY SCHOOL,2ND,1,0,0,13,47,61,14,23%
1420,JEFFERSON COUNTY R-1,5222,LITTLE ELEMENTARY SCHOOL,3RD,0,2,2,10,42,56,14,25%
1420,JEFFERSON COUNTY R-1,5222,LITTLE ELEMENTARY SCHOOL,4TH,1,3,1,12,29,46,17,37%
1420,JEFFERSON COUNTY R-1,5222,LITTLE ELEMENTARY SCHOOL,5TH,2,2,5,15,39,63,24,38%
1420,JEFFERSON COUNTY R-1,5222,LITTLE ELEMENTARY SCHOOL,6TH,0,4,4,14,25,47,22,47%
1420,JEFFERSON COUNTY R-1,5222,LITTLE ELEMENTARY SCHOOL,SCHOOL TOTAL,4,16,17,86,258,381,123,32%
1420,JEFFERSON COUNTY R-1,5350,LUKAS ELEMENTARY SCHOOL,HALF DAY K,1,1,1,4,23,30,7,23%
1420,JEFFERSON COUNTY R-1,5350,LUKAS ELEMENTARY SCHOOL,KINDERGARTEN,1,2,0,3,13,19,6,32%
1420,JEFFERSON COUNTY R-1,5350,LUKAS ELEMENTARY SCHOOL,1ST,1,4,1,2,65,73,8,11%
1420,JEFFERSON COUNTY R-1,5350,LUKAS ELEMENTARY SCHOOL,2ND,0,3,1,4,54,62,8,13%
1420,JEFFERSON COUNTY R-1,5350,LUKAS ELEMENTARY SCHOOL,3RD,0,1,2,10,64,77,13,17%
1420,JEFFERSON COUNTY R-1,5350,LUKAS ELEMENTARY SCHOOL,4TH,0,2,3,9,58,72,14,19%
1420,JEFFERSON COUNTY R-1,5350,LUKAS ELEMENTARY SCHOOL,5TH,1,1,2,10,50,64,14,22%
1420,JEFFERSON COUNTY R-1,5350,LUKAS ELEMENTARY SCHOOL,6TH,1,2,2,2,63,70,7,10%
1420,JEFFERSON COUNTY R-1,5350,LUKAS ELEMENTARY SCHOOL,SCHOOL TOTAL,5,16,12,44,390,467,77,16%
1420,JEFFERSON COUNTY R-1,5354,LUMBERG ELEMENTARY SCHOOL,KINDERGARTEN,1,0,7,55,18,81,63,78%
1420,JEFFERSON COUNTY R-1,5354,LUMBERG ELEMENTARY SCHOOL,1ST,2,0,2,65,18,87,69,79%
1420,JEFFERSON COUNTY R-1,5354,LUMBERG ELEMENTARY SCHOOL,2ND,4,0,4,57,15,80,65,81%
1420,JEFFERSON COUNTY R-1,5354,LUMBERG ELEMENTARY SCHOOL,3RD,0,0,3,58,9,70,61,87%
1420,JEFFERSON COUNTY R-1,5354,LUMBERG ELEMENTARY SCHOOL,4TH,1,2,2,51,10,66,56,85%
1420,JEFFERSON COUNTY R-1,5354,LUMBERG ELEMENTARY SCHOOL,5TH,2,0,3,60,9,74,65,88%
1420,JEFFERSON COUNTY R-1,5354,LUMBERG ELEMENTARY SCHOOL,6TH,3,1,2,42,10,58,48,83%
1420,JEFFERSON COUNTY R-1,5354,LUMBERG ELEMENTARY SCHOOL,SCHOOL TOTAL,13,3,23,388,89,516,427,83%
1420,JEFFERSON COUNTY R-1,5415,ROCKY MOUNTAIN DEAF SCHOOL,PK,0,0,1,3,4,8,4,50%
1420,JEFFERSON COUNTY R-1,5415,ROCKY MOUNTAIN DEAF SCHOOL,KINDERGARTEN,0,0,0,2,1,3,2,67%
1420,JEFFERSON COUNTY R-1,5415,ROCKY MOUNTAIN DEAF SCHOOL,1ST,0,0,0,0,5,5,0,0%
1420,JEFFERSON COUNTY R-1,5415,ROCKY MOUNTAIN DEAF SCHOOL,2ND,0,1,0,0,1,2,1,50%
1420,JEFFERSON COUNTY R-1,5415,ROCKY MOUNTAIN DEAF SCHOOL,3RD,0,0,0,0,2,2,0,0%
1420,JEFFERSON COUNTY R-1,5415,ROCKY MOUNTAIN DEAF SCHOOL,4TH,0,0,1,3,1,5,4,80%
1420,JEFFERSON COUNTY R-1,5415,ROCKY MOUNTAIN DEAF SCHOOL,5TH,0,0,0,1,3,4,1,25%
1420,JEFFERSON COUNTY R-1,5415,ROCKY MOUNTAIN DEAF SCHOOL,6TH,1,0,0,2,4,7,3,43%
1420,JEFFERSON COUNTY R-1,5415,ROCKY MOUNTAIN DEAF SCHOOL,7TH,0,0,1,1,7,9,2,22%
1420,JEFFERSON COUNTY R-1,5415,ROCKY MOUNTAIN DEAF SCHOOL,8TH,0,0,0,2,1,3,2,67%
1420,JEFFERSON COUNTY R-1,5415,ROCKY MOUNTAIN DEAF SCHOOL,SCHOOL TOTAL,1,1,3,14,29,48,19,40%
1420,JEFFERSON COUNTY R-1,5454,MANDALAY MIDDLE SCHOOL,7TH,2,33,3,32,144,214,70,33%
1420,JEFFERSON COUNTY R-1,5454,MANDALAY MIDDLE SCHOOL,8TH,2,24,4,38,138,206,68,33%
1420,JEFFERSON COUNTY R-1,5454,MANDALAY MIDDLE SCHOOL,SCHOOL TOTAL,4,57,7,70,282,420,138,33%
1420,JEFFERSON COUNTY R-1,5472,MANNING OPTIONS SCHOOL,7TH,2,12,3,21,202,240,38,16%
1420,JEFFERSON COUNTY R-1,5472,MANNING OPTIONS SCHOOL,8TH,0,10,2,13,182,207,25,12%
1420,JEFFERSON COUNTY R-1,5472,MANNING OPTIONS SCHOOL,SCHOOL TOTAL,2,22,5,34,384,447,63,14%
1420,JEFFERSON COUNTY R-1,5524,MAPLE GROVE ELEMENTARY SCHOOL,HALF DAY K,0,0,0,1,22,23,1,4%
1420,JEFFERSON COUNTY R-1,5524,MAPLE GROVE ELEMENTARY SCHOOL,KINDERGARTEN,0,0,0,0,26,26,0,0%
1420,JEFFERSON COUNTY R-1,5524,MAPLE GROVE ELEMENTARY SCHOOL,1ST,0,0,0,4,61,65,4,6%
1420,JEFFERSON COUNTY R-1,5524,MAPLE GROVE ELEMENTARY SCHOOL,2ND,0,1,1,7,49,58,9,16%
1420,JEFFERSON COUNTY R-1,5524,MAPLE GROVE ELEMENTARY SCHOOL,3RD,0,3,1,4,52,60,8,13%
1420,JEFFERSON COUNTY R-1,5524,MAPLE GROVE ELEMENTARY SCHOOL,4TH,1,1,1,4,47,54,7,13%
1420,JEFFERSON COUNTY R-1,5524,MAPLE GROVE ELEMENTARY SCHOOL,5TH,0,0,2,1,58,61,3,5%
1420,JEFFERSON COUNTY R-1,5524,MAPLE GROVE ELEMENTARY SCHOOL,6TH,0,1,1,3,56,61,5,8%
1420,JEFFERSON COUNTY R-1,5524,MAPLE GROVE ELEMENTARY SCHOOL,SCHOOL TOTAL,1,6,6,24,371,408,37,9%
1420,JEFFERSON COUNTY R-1,5580,MARSHDALE ELEMENTARY SCHOOL,HALF DAY K,2,2,0,0,19,23,4,17%
1420,JEFFERSON COUNTY R-1,5580,MARSHDALE ELEMENTARY SCHOOL,KINDERGARTEN,0,1,0,0,24,25,1,4%
1420,JEFFERSON COUNTY R-1,5580,MARSHDALE ELEMENTARY SCHOOL,1ST,0,2,0,0,47,49,2,4%
1420,JEFFERSON COUNTY R-1,5580,MARSHDALE ELEMENTARY SCHOOL,2ND,0,2,0,1,62,65,3,5%
1420,JEFFERSON COUNTY R-1,5580,MARSHDALE ELEMENTARY SCHOOL,3RD,0,2,0,2,58,62,4,6%
1420,JEFFERSON COUNTY R-1,5580,MARSHDALE ELEMENTARY SCHOOL,4TH,1,4,0,4,63,72,9,13%
1420,JEFFERSON COUNTY R-1,5580,MARSHDALE ELEMENTARY SCHOOL,5TH,0,0,0,1,46,47,1,2%
1420,JEFFERSON COUNTY R-1,5580,MARSHDALE ELEMENTARY SCHOOL,SCHOOL TOTAL,3,13,0,8,319,343,24,7%
1420,JEFFERSON COUNTY R-1,5596,MARTENSEN ELEMENTARY SCHOOL,PK,1,0,0,18,22,41,19,46%
1420,JEFFERSON COUNTY R-1,5596,MARTENSEN ELEMENTARY SCHOOL,KINDERGARTEN,0,1,0,18,21,40,19,48%
1420,JEFFERSON COUNTY R-1,5596,MARTENSEN ELEMENTARY SCHOOL,1ST,2,0,0,11,16,29,13,45%
1420,JEFFERSON COUNTY R-1,5596,MARTENSEN ELEMENTARY SCHOOL,2ND,1,0,1,8,8,18,10,56%
1420,JEFFERSON COUNTY R-1,5596,MARTENSEN ELEMENTARY SCHOOL,3RD,1,1,0,12,10,24,14,58%
1420,JEFFERSON COUNTY R-1,5596,MARTENSEN ELEMENTARY SCHOOL,4TH,1,2,1,9,17,30,13,43%
1420,JEFFERSON COUNTY R-1,5596,MARTENSEN ELEMENTARY SCHOOL,5TH,2,0,1,12,10,25,15,60%
1420,JEFFERSON COUNTY R-1,5596,MARTENSEN ELEMENTARY SCHOOL,6TH,0,0,1,16,14,31,17,55%
1420,JEFFERSON COUNTY R-1,5596,MARTENSEN ELEMENTARY SCHOOL,SCHOOL TOTAL,8,4,4,104,118,238,120,50%
1420,JEFFERSON COUNTY R-1,5623,LONGVIEW HIGH SCHOOL,10TH,0,0,0,0,3,3,0,0%
1420,JEFFERSON COUNTY R-1,5623,LONGVIEW HIGH SCHOOL,11TH,0,0,1,2,9,12,3,25%
1420,JEFFERSON COUNTY R-1,5623,LONGVIEW HIGH SCHOOL,12TH,1,0,1,8,28,38,10,26%
1420,JEFFERSON COUNTY R-1,5623,LONGVIEW HIGH SCHOOL,SCHOOL TOTAL,1,0,2,10,40,53,13,25%
1420,JEFFERSON COUNTY R-1,5758,MEIKLEJOHN ELEMENTARY,PK,1,6,3,6,122,138,16,12%
1420,JEFFERSON COUNTY R-1,5758,MEIKLEJOHN ELEMENTARY,HALF DAY K,1,0,0,1,21,23,2,9%
1420,JEFFERSON COUNTY R-1,5758,MEIKLEJOHN ELEMENTARY,KINDERGARTEN,0,0,0,0,48,48,0,0%
1420,JEFFERSON COUNTY R-1,5758,MEIKLEJOHN ELEMENTARY,1ST,0,0,0,2,65,67,2,3%
1420,JEFFERSON COUNTY R-1,5758,MEIKLEJOHN ELEMENTARY,2ND,0,3,0,2,64,69,5,7%
1420,JEFFERSON COUNTY R-1,5758,MEIKLEJOHN ELEMENTARY,3RD,0,1,1,2,56,60,4,7%
1420,JEFFERSON COUNTY R-1,5758,MEIKLEJOHN ELEMENTARY,4TH,0,1,0,1,39,41,2,5%
1420,JEFFERSON COUNTY R-1,5758,MEIKLEJOHN ELEMENTARY,5TH,0,1,1,4,46,52,6,12%
1420,JEFFERSON COUNTY R-1,5758,MEIKLEJOHN ELEMENTARY,6TH,0,2,1,1,33,37,4,11%
1420,JEFFERSON COUNTY R-1,5758,MEIKLEJOHN ELEMENTARY,SCHOOL TOTAL,2,14,6,19,494,535,41,8%
1420,JEFFERSON COUNTY R-1,5892,MILLER SPECIAL EDUCATION,PK,0,0,0,3,9,12,3,25%
1420,JEFFERSON COUNTY R-1,5892,MILLER SPECIAL EDUCATION,HALF DAY K,0,0,0,3,6,9,3,33%
1420,JEFFERSON COUNTY R-1,5892,MILLER SPECIAL EDUCATION,1ST,0,2,0,4,2,8,6,75%
1420,JEFFERSON COUNTY R-1,5892,MILLER SPECIAL EDUCATION,2ND,0,0,0,4,5,9,4,44%
1420,JEFFERSON COUNTY R-1,5892,MILLER SPECIAL EDUCATION,3RD,0,0,0,2,4,6,2,33%
1420,JEFFERSON COUNTY R-1,5892,MILLER SPECIAL EDUCATION,4TH,0,0,0,3,4,7,3,43%
1420,JEFFERSON COUNTY R-1,5892,MILLER SPECIAL EDUCATION,5TH,0,0,0,2,7,9,2,22%
1420,JEFFERSON COUNTY R-1,5892,MILLER SPECIAL EDUCATION,7TH,0,0,0,1,6,7,1,14%
1420,JEFFERSON COUNTY R-1,5892,MILLER SPECIAL EDUCATION,8TH,0,0,0,1,3,4,1,25%
1420,JEFFERSON COUNTY R-1,5892,MILLER SPECIAL EDUCATION,9TH,0,0,0,1,9,10,1,10%
1420,JEFFERSON COUNTY R-1,5892,MILLER SPECIAL EDUCATION,10TH,0,0,0,0,7,7,0,0%
1420,JEFFERSON COUNTY R-1,5892,MILLER SPECIAL EDUCATION,11TH,0,0,1,2,3,6,3,50%
1420,JEFFERSON COUNTY R-1,5892,MILLER SPECIAL EDUCATION,12TH,1,6,1,16,89,113,24,21%
1420,JEFFERSON COUNTY R-1,5892,MILLER SPECIAL EDUCATION,SCHOOL TOTAL,1,8,2,42,154,207,53,26%
1420,JEFFERSON COUNTY R-1,5944,MITCHELL ELEMENTARY SCHOOL,HALF DAY K,0,1,0,1,26,28,2,7%
1420,JEFFERSON COUNTY R-1,5944,MITCHELL ELEMENTARY SCHOOL,KINDERGARTEN,1,5,1,2,41,50,9,18%
1420,JEFFERSON COUNTY R-1,5944,MITCHELL ELEMENTARY SCHOOL,1ST,0,6,0,4,95,105,10,10%
1420,JEFFERSON COUNTY R-1,5944,MITCHELL ELEMENTARY SCHOOL,2ND,0,12,0,6,76,94,18,19%
1420,JEFFERSON COUNTY R-1,5944,MITCHELL ELEMENTARY SCHOOL,3RD,0,2,0,7,66,75,9,12%
1420,JEFFERSON COUNTY R-1,5944,MITCHELL ELEMENTARY SCHOOL,4TH,0,2,0,4,71,77,6,8%
1420,JEFFERSON COUNTY R-1,5944,MITCHELL ELEMENTARY SCHOOL,5TH,0,5,0,9,67,81,14,17%
1420,JEFFERSON COUNTY R-1,5944,MITCHELL ELEMENTARY SCHOOL,6TH,1,3,1,5,68,78,10,13%
1420,JEFFERSON COUNTY R-1,5944,MITCHELL ELEMENTARY SCHOOL,SCHOOL TOTAL,2,36,2,38,510,588,78,13%
1420,JEFFERSON COUNTY R-1,5972,MOLHOLM ELEMENTARY SCHOOL,PK,0,0,3,40,14,57,43,75%
1420,JEFFERSON COUNTY R-1,5972,MOLHOLM ELEMENTARY SCHOOL,KINDERGARTEN,1,0,6,59,22,88,66,75%
1420,JEFFERSON COUNTY R-1,5972,MOLHOLM ELEMENTARY SCHOOL,1ST,0,0,2,54,17,73,56,77%
1420,JEFFERSON COUNTY R-1,5972,MOLHOLM ELEMENTARY SCHOOL,2ND,2,0,1,52,9,64,55,86%
1420,JEFFERSON COUNTY R-1,5972,MOLHOLM ELEMENTARY SCHOOL,3RD,0,0,1,55,8,64,56,88%
1420,JEFFERSON COUNTY R-1,5972,MOLHOLM ELEMENTARY SCHOOL,4TH,1,0,1,42,13,57,44,77%
1420,JEFFERSON COUNTY R-1,5972,MOLHOLM ELEMENTARY SCHOOL,5TH,1,0,2,50,17,70,53,76%
1420,JEFFERSON COUNTY R-1,5972,MOLHOLM ELEMENTARY SCHOOL,6TH,3,1,3,42,17,66,49,74%
1420,JEFFERSON COUNTY R-1,5972,MOLHOLM ELEMENTARY SCHOOL,SCHOOL TOTAL,8,1,19,394,117,539,422,78%
1420,JEFFERSON COUNTY R-1,5994,MONTESSORI PEAKS CHARTER ACADEMY,PK,0,1,0,0,67,68,1,1%
1420,JEFFERSON COUNTY R-1,5994,MONTESSORI PEAKS CHARTER ACADEMY,HALF DAY K,0,1,0,1,14,16,2,13%
1420,JEFFERSON COUNTY R-1,5994,MONTESSORI PEAKS CHARTER ACADEMY,KINDERGARTEN,0,1,0,2,42,45,3,7%
1420,JEFFERSON COUNTY R-1,5994,MONTESSORI PEAKS CHARTER ACADEMY,1ST,0,4,1,3,63,71,8,11%
1420,JEFFERSON COUNTY R-1,5994,MONTESSORI PEAKS CHARTER ACADEMY,2ND,0,5,2,4,48,59,11,19%
1420,JEFFERSON COUNTY R-1,5994,MONTESSORI PEAKS CHARTER ACADEMY,3RD,0,1,0,4,65,70,5,7%
1420,JEFFERSON COUNTY R-1,5994,MONTESSORI PEAKS CHARTER ACADEMY,4TH,0,2,0,5,52,59,7,12%
1420,JEFFERSON COUNTY R-1,5994,MONTESSORI PEAKS CHARTER ACADEMY,5TH,0,1,0,8,55,64,9,14%
1420,JEFFERSON COUNTY R-1,5994,MONTESSORI PEAKS CHARTER ACADEMY,6TH,0,2,0,8,38,48,10,21%
1420,JEFFERSON COUNTY R-1,5994,MONTESSORI PEAKS CHARTER ACADEMY,7TH,0,0,0,0,4,4,0,0%
1420,JEFFERSON COUNTY R-1,5994,MONTESSORI PEAKS CHARTER ACADEMY,SCHOOL TOTAL,0,18,3,35,448,504,56,11%
1420,JEFFERSON COUNTY R-1,6090,MOORE MIDDLE SCHOOL,7TH,3,11,9,56,165,244,79,32%
1420,JEFFERSON COUNTY R-1,6090,MOORE MIDDLE SCHOOL,8TH,5,11,6,58,210,290,80,28%
1420,JEFFERSON COUNTY R-1,6090,MOORE MIDDLE SCHOOL,SCHOOL TOTAL,8,22,15,114,375,534,159,30%
1420,JEFFERSON COUNTY R-1,6133,MORTENSEN ELEMENTARY SCHOOL,PK,1,2,0,2,31,36,5,14%
1420,JEFFERSON COUNTY R-1,6133,MORTENSEN ELEMENTARY SCHOOL,HALF DAY K,2,2,1,9,33,47,14,30%
1420,JEFFERSON COUNTY R-1,6133,MORTENSEN ELEMENTARY SCHOOL,KINDERGARTEN,1,0,1,2,21,25,4,16%
1420,JEFFERSON COUNTY R-1,6133,MORTENSEN ELEMENTARY SCHOOL,1ST,0,1,5,8,44,58,14,24%
1420,JEFFERSON COUNTY R-1,6133,MORTENSEN ELEMENTARY SCHOOL,2ND,1,4,1,6,55,67,12,18%
1420,JEFFERSON COUNTY R-1,6133,MORTENSEN ELEMENTARY SCHOOL,3RD,2,2,1,8,44,57,13,23%
1420,JEFFERSON COUNTY R-1,6133,MORTENSEN ELEMENTARY SCHOOL,4TH,1,2,2,9,42,56,14,25%
1420,JEFFERSON COUNTY R-1,6133,MORTENSEN ELEMENTARY SCHOOL,5TH,1,3,2,8,56,70,14,20%
1420,JEFFERSON COUNTY R-1,6133,MORTENSEN ELEMENTARY SCHOOL,6TH,2,1,0,9,33,45,12,27%
1420,JEFFERSON COUNTY R-1,6133,MORTENSEN ELEMENTARY SCHOOL,SCHOOL TOTAL,11,17,13,61,359,461,102,22%
1420,JEFFERSON COUNTY R-1,6135,MOUNT CARBON ELEMENTARY SCHOOL,HALF DAY K,0,1,0,2,27,30,3,10%
1420,JEFFERSON COUNTY R-1,6135,MOUNT CARBON ELEMENTARY SCHOOL,KINDERGARTEN,0,2,0,3,21,26,5,19%
1420,JEFFERSON COUNTY R-1,6135,MOUNT CARBON ELEMENTARY SCHOOL,1ST,1,1,2,5,49,58,9,16%
1420,JEFFERSON COUNTY R-1,6135,MOUNT CARBON ELEMENTARY SCHOOL,2ND,0,1,3,9,52,65,13,20%
1420,JEFFERSON COUNTY R-1,6135,MOUNT CARBON ELEMENTARY SCHOOL,3RD,0,1,0,7,45,53,8,15%
1420,JEFFERSON COUNTY R-1,6135,MOUNT CARBON ELEMENTARY SCHOOL,4TH,0,3,1,6,44,54,10,19%
1420,JEFFERSON COUNTY R-1,6135,MOUNT CARBON ELEMENTARY SCHOOL,5TH,0,2,0,7,55,64,9,14%
1420,JEFFERSON COUNTY R-1,6135,MOUNT CARBON ELEMENTARY SCHOOL,6TH,0,2,0,11,39,52,13,25%
1420,JEFFERSON COUNTY R-1,6135,MOUNT CARBON ELEMENTARY SCHOOL,SCHOOL TOTAL,1,13,6,50,332,402,70,17%
1420,JEFFERSON COUNTY R-1,6139,MOUNTAIN PHOENIX COMMUNITY SCHOOL,HALF DAY K,0,1,0,0,3,4,1,25%
1420,JEFFERSON COUNTY R-1,6139,MOUNTAIN PHOENIX COMMUNITY SCHOOL,1ST,0,0,0,0,3,3,0,0%
1420,JEFFERSON COUNTY R-1,6139,MOUNTAIN PHOENIX COMMUNITY SCHOOL,2ND,0,0,0,0,5,5,0,0%
1420,JEFFERSON COUNTY R-1,6139,MOUNTAIN PHOENIX COMMUNITY SCHOOL,3RD,0,0,0,0,4,4,0,0%
1420,JEFFERSON COUNTY R-1,6139,MOUNTAIN PHOENIX COMMUNITY SCHOOL,4TH,0,1,0,0,2,3,1,33%
1420,JEFFERSON COUNTY R-1,6139,MOUNTAIN PHOENIX COMMUNITY SCHOOL,5TH,0,0,0,0,7,7,0,0%
1420,JEFFERSON COUNTY R-1,6139,MOUNTAIN PHOENIX COMMUNITY SCHOOL,6TH,0,0,0,0,3,3,0,0%
1420,JEFFERSON COUNTY R-1,6139,MOUNTAIN PHOENIX COMMUNITY SCHOOL,7TH,0,0,0,0,1,1,0,0%
1420,JEFFERSON COUNTY R-1,6139,MOUNTAIN PHOENIX COMMUNITY SCHOOL,8TH,0,0,0,0,1,1,0,0%
1420,JEFFERSON COUNTY R-1,6139,MOUNTAIN PHOENIX COMMUNITY SCHOOL,SCHOOL TOTAL,0,2,0,0,29,31,2,6%
1420,JEFFERSON COUNTY R-1,6237,NEW AMERICA SCHOOL,9TH,0,2,0,49,2,53,51,96%
1420,JEFFERSON COUNTY R-1,6237,NEW AMERICA SCHOOL,10TH,0,1,2,59,2,64,62,97%
1420,JEFFERSON COUNTY R-1,6237,NEW AMERICA SCHOOL,11TH,0,0,1,64,1,66,65,98%
1420,JEFFERSON COUNTY R-1,6237,NEW AMERICA SCHOOL,12TH,0,0,0,64,4,68,64,94%
1420,JEFFERSON COUNTY R-1,6237,NEW AMERICA SCHOOL,SCHOOL TOTAL,0,3,3,236,9,251,242,96%
1420,JEFFERSON COUNTY R-1,6286,NORMANDY ELEMENTARY SCHOOL,HALF DAY K,1,2,0,3,32,38,6,16%
1420,JEFFERSON COUNTY R-1,6286,NORMANDY ELEMENTARY SCHOOL,KINDERGARTEN,0,3,0,2,45,50,5,10%
1420,JEFFERSON COUNTY R-1,6286,NORMANDY ELEMENTARY SCHOOL,1ST,1,7,1,6,81,96,15,16%
1420,JEFFERSON COUNTY R-1,6286,NORMANDY ELEMENTARY SCHOOL,2ND,0,5,0,7,83,95,12,13%
1420,JEFFERSON COUNTY R-1,6286,NORMANDY ELEMENTARY SCHOOL,3RD,0,5,0,4,103,112,9,8%
1420,JEFFERSON COUNTY R-1,6286,NORMANDY ELEMENTARY SCHOOL,4TH,0,6,2,9,94,111,17,15%
1420,JEFFERSON COUNTY R-1,6286,NORMANDY ELEMENTARY SCHOOL,5TH,1,6,2,8,91,108,17,16%
1420,JEFFERSON COUNTY R-1,6286,NORMANDY ELEMENTARY SCHOOL,6TH,0,1,2,9,86,98,12,12%
1420,JEFFERSON COUNTY R-1,6286,NORMANDY ELEMENTARY SCHOOL,SCHOOL TOTAL,3,35,7,48,615,708,93,13%
1420,JEFFERSON COUNTY R-1,6330,NORTH ARVADA MIDDLE SCHOOL,7TH,3,7,3,82,129,224,95,42%
1420,JEFFERSON COUNTY R-1,6330,NORTH ARVADA MIDDLE SCHOOL,8TH,4,18,6,77,131,236,105,44%
1420,JEFFERSON COUNTY R-1,6330,NORTH ARVADA MIDDLE SCHOOL,SCHOOL TOTAL,7,25,9,159,260,460,200,43%
1420,JEFFERSON COUNTY R-1,6470,OBERON JUNIOR HIGH SCHOOL,7TH,1,9,8,44,324,386,62,16%
1420,JEFFERSON COUNTY R-1,6470,OBERON JUNIOR HIGH SCHOOL,8TH,3,8,8,40,307,366,59,16%
1420,JEFFERSON COUNTY R-1,6470,OBERON JUNIOR HIGH SCHOOL,SCHOOL TOTAL,4,17,16,84,631,752,121,16%
1420,JEFFERSON COUNTY R-1,6474,O'CONNELL MIDDLE SCHOOL,7TH,3,16,6,134,59,218,159,73%
1420,JEFFERSON COUNTY R-1,6474,O'CONNELL MIDDLE SCHOOL,8TH,7,16,8,127,40,198,158,80%
1420,JEFFERSON COUNTY R-1,6474,O'CONNELL MIDDLE SCHOOL,SCHOOL TOTAL,10,32,14,261,99,416,317,76%
1420,JEFFERSON COUNTY R-1,6539,JEFFERSON COUNTY OPEN ELEMENTARY SCHOOL,PK,0,0,1,7,21,29,8,28%
1420,JEFFERSON COUNTY R-1,6539,JEFFERSON COUNTY OPEN ELEMENTARY SCHOOL,HALF DAY K,0,0,0,0,9,9,0,0%
1420,JEFFERSON COUNTY R-1,6539,JEFFERSON COUNTY OPEN ELEMENTARY SCHOOL,KINDERGARTEN,0,0,0,1,13,14,1,7%
1420,JEFFERSON COUNTY R-1,6539,JEFFERSON COUNTY OPEN ELEMENTARY SCHOOL,1ST,0,1,1,5,25,32,7,22%
1420,JEFFERSON COUNTY R-1,6539,JEFFERSON COUNTY OPEN ELEMENTARY SCHOOL,2ND,2,0,0,3,27,32,5,16%
1420,JEFFERSON COUNTY R-1,6539,JEFFERSON COUNTY OPEN ELEMENTARY SCHOOL,3RD,1,0,0,1,23,25,2,8%
1420,JEFFERSON COUNTY R-1,6539,JEFFERSON COUNTY OPEN ELEMENTARY SCHOOL,4TH,2,1,0,6,27,36,9,25%
1420,JEFFERSON COUNTY R-1,6539,JEFFERSON COUNTY OPEN ELEMENTARY SCHOOL,5TH,0,0,0,3,31,34,3,9%
1420,JEFFERSON COUNTY R-1,6539,JEFFERSON COUNTY OPEN ELEMENTARY SCHOOL,6TH,3,0,1,2,21,27,6,22%
1420,JEFFERSON COUNTY R-1,6539,JEFFERSON COUNTY OPEN ELEMENTARY SCHOOL,SCHOOL TOTAL,8,2,3,28,197,238,41,17%
1420,JEFFERSON COUNTY R-1,6541,JEFFERSON COUNTY OPEN SECONDARY,7TH,1,1,1,5,37,45,8,18%
1420,JEFFERSON COUNTY R-1,6541,JEFFERSON COUNTY OPEN SECONDARY,8TH,1,1,1,5,36,44,8,18%
1420,JEFFERSON COUNTY R-1,6541,JEFFERSON COUNTY OPEN SECONDARY,9TH,2,1,0,3,34,40,6,15%
1420,JEFFERSON COUNTY R-1,6541,JEFFERSON COUNTY OPEN SECONDARY,10TH,1,2,1,4,47,55,8,15%
1420,JEFFERSON COUNTY R-1,6541,JEFFERSON COUNTY OPEN SECONDARY,11TH,2,0,0,10,43,55,12,22%
1420,JEFFERSON COUNTY R-1,6541,JEFFERSON COUNTY OPEN SECONDARY,12TH,2,2,3,11,73,91,18,20%
1420,JEFFERSON COUNTY R-1,6541,JEFFERSON COUNTY OPEN SECONDARY,SCHOOL TOTAL,9,7,6,38,270,330,60,18%
1420,JEFFERSON COUNTY R-1,6804,PARMALEE ELEMENTARY SCHOOL,HALF DAY K,0,0,0,2,7,9,2,22%
1420,JEFFERSON COUNTY R-1,6804,PARMALEE ELEMENTARY SCHOOL,KINDERGARTEN,0,0,0,0,17,17,0,0%
1420,JEFFERSON COUNTY R-1,6804,PARMALEE ELEMENTARY SCHOOL,1ST,1,2,0,2,27,32,5,16%
1420,JEFFERSON COUNTY R-1,6804,PARMALEE ELEMENTARY SCHOOL,2ND,0,2,1,0,44,47,3,6%
1420,JEFFERSON COUNTY R-1,6804,PARMALEE ELEMENTARY SCHOOL,3RD,1,1,0,3,33,38,5,13%
1420,JEFFERSON COUNTY R-1,6804,PARMALEE ELEMENTARY SCHOOL,4TH,1,1,0,1,35,38,3,8%
1420,JEFFERSON COUNTY R-1,6804,PARMALEE ELEMENTARY SCHOOL,5TH,1,1,2,0,33,37,4,11%
1420,JEFFERSON COUNTY R-1,6804,PARMALEE ELEMENTARY SCHOOL,SCHOOL TOTAL,4,7,3,8,196,218,22,10%
1420,JEFFERSON COUNTY R-1,6806,PARR ELEMENTARY SCHOOL,PK,0,4,5,33,85,127,42,33%
1420,JEFFERSON COUNTY R-1,6806,PARR ELEMENTARY SCHOOL,KINDERGARTEN,0,1,1,15,20,37,17,46%
1420,JEFFERSON COUNTY R-1,6806,PARR ELEMENTARY SCHOOL,1ST,0,0,1,14,25,40,15,38%
1420,JEFFERSON COUNTY R-1,6806,PARR ELEMENTARY SCHOOL,2ND,1,1,1,15,23,41,18,44%
1420,JEFFERSON COUNTY R-1,6806,PARR ELEMENTARY SCHOOL,3RD,0,0,0,14,23,37,14,38%
1420,JEFFERSON COUNTY R-1,6806,PARR ELEMENTARY SCHOOL,4TH,0,0,2,12,20,34,14,41%
1420,JEFFERSON COUNTY R-1,6806,PARR ELEMENTARY SCHOOL,5TH,0,0,3,8,23,34,11,32%
1420,JEFFERSON COUNTY R-1,6806,PARR ELEMENTARY SCHOOL,6TH,1,1,2,6,24,34,10,29%
1420,JEFFERSON COUNTY R-1,6806,PARR ELEMENTARY SCHOOL,SCHOOL TOTAL,2,7,15,117,243,384,141,37%
1420,JEFFERSON COUNTY R-1,6808,PATTERSON ELEMENTARY SCHOOL,PK,1,15,2,43,114,175,61,35%
1420,JEFFERSON COUNTY R-1,6808,PATTERSON ELEMENTARY SCHOOL,KINDERGARTEN,2,4,1,24,60,91,31,34%
1420,JEFFERSON COUNTY R-1,6808,PATTERSON ELEMENTARY SCHOOL,1ST,5,2,1,30,41,79,38,48%
1420,JEFFERSON COUNTY R-1,6808,PATTERSON ELEMENTARY SCHOOL,2ND,2,5,1,15,38,61,23,38%
1420,JEFFERSON COUNTY R-1,6808,PATTERSON ELEMENTARY SCHOOL,3RD,2,6,2,22,33,65,32,49%
1420,JEFFERSON COUNTY R-1,6808,PATTERSON ELEMENTARY SCHOOL,4TH,1,3,0,12,28,44,16,36%
1420,JEFFERSON COUNTY R-1,6808,PATTERSON ELEMENTARY SCHOOL,5TH,2,4,3,21,27,57,30,53%
1420,JEFFERSON COUNTY R-1,6808,PATTERSON ELEMENTARY SCHOOL,6TH,1,1,0,16,19,37,18,49%
1420,JEFFERSON COUNTY R-1,6808,PATTERSON ELEMENTARY SCHOOL,SCHOOL TOTAL,16,40,10,183,360,609,249,41%
1420,JEFFERSON COUNTY R-1,6828,PECK ELEMENTARY SCHOOL,KINDERGARTEN,1,0,0,11,48,60,12,20%
1420,JEFFERSON COUNTY R-1,6828,PECK ELEMENTARY SCHOOL,1ST,0,4,2,6,55,67,12,18%
1420,JEFFERSON COUNTY R-1,6828,PECK ELEMENTARY SCHOOL,2ND,1,0,1,11,45,58,13,22%
1420,JEFFERSON COUNTY R-1,6828,PECK ELEMENTARY SCHOOL,3RD,0,2,3,12,43,60,17,28%
1420,JEFFERSON COUNTY R-1,6828,PECK ELEMENTARY SCHOOL,4TH,2,2,1,12,45,62,17,27%
1420,JEFFERSON COUNTY R-1,6828,PECK ELEMENTARY SCHOOL,5TH,0,1,0,13,42,56,14,25%
1420,JEFFERSON COUNTY R-1,6828,PECK ELEMENTARY SCHOOL,6TH,2,0,2,9,36,49,13,27%
1420,JEFFERSON COUNTY R-1,6828,PECK ELEMENTARY SCHOOL,SCHOOL TOTAL,6,9,9,74,314,412,98,24%
1420,JEFFERSON COUNTY R-1,6844,PEIFFER ELEMENTARY SCHOOL,HALF DAY K,0,0,1,6,22,29,7,24%
1420,JEFFERSON COUNTY R-1,6844,PEIFFER ELEMENTARY SCHOOL,KINDERGARTEN,0,1,0,3,21,25,4,16%
1420,JEFFERSON COUNTY R-1,6844,PEIFFER ELEMENTARY SCHOOL,1ST,0,1,1,9,45,56,11,20%
1420,JEFFERSON COUNTY R-1,6844,PEIFFER ELEMENTARY SCHOOL,2ND,1,4,0,7,55,67,12,18%
1420,JEFFERSON COUNTY R-1,6844,PEIFFER ELEMENTARY SCHOOL,3RD,0,1,0,7,45,53,8,15%
1420,JEFFERSON COUNTY R-1,6844,PEIFFER ELEMENTARY SCHOOL,4TH,0,1,2,11,47,61,14,23%
1420,JEFFERSON COUNTY R-1,6844,PEIFFER ELEMENTARY SCHOOL,5TH,0,2,1,12,47,62,15,24%
1420,JEFFERSON COUNTY R-1,6844,PEIFFER ELEMENTARY SCHOOL,6TH,0,2,0,10,41,53,12,23%
1420,JEFFERSON COUNTY R-1,6844,PEIFFER ELEMENTARY SCHOOL,SCHOOL TOTAL,1,12,5,65,323,406,83,20%
1420,JEFFERSON COUNTY R-1,6848,PENNINGTON ELEMENTARY SCHOOL,PK,1,0,1,24,22,48,26,54%
1420,JEFFERSON COUNTY R-1,6848,PENNINGTON ELEMENTARY SCHOOL,KINDERGARTEN,1,0,0,13,29,43,14,33%
1420,JEFFERSON COUNTY R-1,6848,PENNINGTON ELEMENTARY SCHOOL,1ST,1,1,0,15,20,37,17,46%
1420,JEFFERSON COUNTY R-1,6848,PENNINGTON ELEMENTARY SCHOOL,2ND,2,0,0,12,16,30,14,47%
1420,JEFFERSON COUNTY R-1,6848,PENNINGTON ELEMENTARY SCHOOL,3RD,1,0,1,22,19,43,24,56%
1420,JEFFERSON COUNTY R-1,6848,PENNINGTON ELEMENTARY SCHOOL,4TH,0,0,1,10,15,26,11,42%
1420,JEFFERSON COUNTY R-1,6848,PENNINGTON ELEMENTARY SCHOOL,5TH,0,0,2,12,11,25,14,56%
1420,JEFFERSON COUNTY R-1,6848,PENNINGTON ELEMENTARY SCHOOL,6TH,0,0,3,11,21,35,14,40%
1420,JEFFERSON COUNTY R-1,6848,PENNINGTON ELEMENTARY SCHOOL,SCHOOL TOTAL,6,1,8,119,153,287,134,47%
1420,JEFFERSON COUNTY R-1,7078,PLEASANT VIEW ELEMENTARY SCHOOL,PK,0,3,0,3,23,29,6,21%
1420,JEFFERSON COUNTY R-1,7078,PLEASANT VIEW ELEMENTARY SCHOOL,KINDERGARTEN,1,0,0,9,35,45,10,22%
1420,JEFFERSON COUNTY R-1,7078,PLEASANT VIEW ELEMENTARY SCHOOL,1ST,1,0,2,7,30,40,10,25%
1420,JEFFERSON COUNTY R-1,7078,PLEASANT VIEW ELEMENTARY SCHOOL,2ND,0,0,0,7,14,21,7,33%
1420,JEFFERSON COUNTY R-1,7078,PLEASANT VIEW ELEMENTARY SCHOOL,3RD,0,0,0,7,24,31,7,23%
1420,JEFFERSON COUNTY R-1,7078,PLEASANT VIEW ELEMENTARY SCHOOL,4TH,0,0,1,8,18,27,9,33%
1420,JEFFERSON COUNTY R-1,7078,PLEASANT VIEW ELEMENTARY SCHOOL,5TH,0,2,0,3,14,19,5,26%
1420,JEFFERSON COUNTY R-1,7078,PLEASANT VIEW ELEMENTARY SCHOOL,6TH,1,0,1,9,13,24,11,46%
1420,JEFFERSON COUNTY R-1,7078,PLEASANT VIEW ELEMENTARY SCHOOL,SCHOOL TOTAL,3,5,4,53,171,236,65,28%
1420,JEFFERSON COUNTY R-1,7114,POMONA HIGH SCHOOL,9TH,3,11,17,76,311,418,107,26%
1420,JEFFERSON COUNTY R-1,7114,POMONA HIGH SCHOOL,10TH,5,9,6,81,286,387,101,26%
1420,JEFFERSON COUNTY R-1,7114,POMONA HIGH SCHOOL,11TH,3,13,15,73,293,397,104,26%
1420,JEFFERSON COUNTY R-1,7114,POMONA HIGH SCHOOL,12TH,7,10,12,65,300,394,94,24%
1420,JEFFERSON COUNTY R-1,7114,POMONA HIGH SCHOOL,SCHOOL TOTAL,18,43,50,295,1190,1596,406,25%
1420,JEFFERSON COUNTY R-1,7128,POWDERHORN ELEMENTARY SCHOOL,HALF DAY K,1,2,1,7,32,43,11,26%
1420,JEFFERSON COUNTY R-1,7128,POWDERHORN ELEMENTARY SCHOOL,KINDERGARTEN,1,5,2,2,36,46,10,22%
1420,JEFFERSON COUNTY R-1,7128,POWDERHORN ELEMENTARY SCHOOL,1ST,2,5,1,9,86,103,17,17%
1420,JEFFERSON COUNTY R-1,7128,POWDERHORN ELEMENTARY SCHOOL,2ND,1,5,2,9,80,97,17,18%
1420,JEFFERSON COUNTY R-1,7128,POWDERHORN ELEMENTARY SCHOOL,3RD,1,3,1,10,84,99,15,15%
1420,JEFFERSON COUNTY R-1,7128,POWDERHORN ELEMENTARY SCHOOL,4TH,0,3,4,8,84,99,15,15%
1420,JEFFERSON COUNTY R-1,7128,POWDERHORN ELEMENTARY SCHOOL,5TH,1,4,1,10,61,77,16,21%
1420,JEFFERSON COUNTY R-1,7128,POWDERHORN ELEMENTARY SCHOOL,6TH,1,5,1,11,81,99,18,18%
1420,JEFFERSON COUNTY R-1,7128,POWDERHORN ELEMENTARY SCHOOL,SCHOOL TOTAL,8,32,13,66,544,663,119,18%
1420,JEFFERSON COUNTY R-1,7190,PROSPECT VALLEY ELEMENTARY SCHOOL,HALF DAY K,0,0,0,9,35,44,9,20%
1420,JEFFERSON COUNTY R-1,7190,PROSPECT VALLEY ELEMENTARY SCHOOL,KINDERGARTEN,1,0,0,1,24,26,2,8%
1420,JEFFERSON COUNTY R-1,7190,PROSPECT VALLEY ELEMENTARY SCHOOL,1ST,1,4,0,11,50,66,16,24%
1420,JEFFERSON COUNTY R-1,7190,PROSPECT VALLEY ELEMENTARY SCHOOL,2ND,1,0,0,7,58,66,8,12%
1420,JEFFERSON COUNTY R-1,7190,PROSPECT VALLEY ELEMENTARY SCHOOL,3RD,2,3,1,8,52,66,14,21%
1420,JEFFERSON COUNTY R-1,7190,PROSPECT VALLEY ELEMENTARY SCHOOL,4TH,1,2,0,11,57,71,14,20%
1420,JEFFERSON COUNTY R-1,7190,PROSPECT VALLEY ELEMENTARY SCHOOL,5TH,2,3,1,9,62,77,15,19%
1420,JEFFERSON COUNTY R-1,7190,PROSPECT VALLEY ELEMENTARY SCHOOL,6TH,2,3,0,15,59,79,20,25%
1420,JEFFERSON COUNTY R-1,7190,PROSPECT VALLEY ELEMENTARY SCHOOL,SCHOOL TOTAL,10,15,2,71,397,495,98,20%
1420,JEFFERSON COUNTY R-1,7238,RALSTON ELEMENTARY SCHOOL,HALF DAY K,1,0,0,1,15,17,2,12%
1420,JEFFERSON COUNTY R-1,7238,RALSTON ELEMENTARY SCHOOL,KINDERGARTEN,0,2,0,0,34,36,2,6%
1420,JEFFERSON COUNTY R-1,7238,RALSTON ELEMENTARY SCHOOL,1ST,1,4,0,1,46,52,6,12%
1420,JEFFERSON COUNTY R-1,7238,RALSTON ELEMENTARY SCHOOL,2ND,0,5,0,1,41,47,6,13%
1420,JEFFERSON COUNTY R-1,7238,RALSTON ELEMENTARY SCHOOL,3RD,0,1,0,1,42,44,2,5%
1420,JEFFERSON COUNTY R-1,7238,RALSTON ELEMENTARY SCHOOL,4TH,0,1,0,3,49,53,4,8%
1420,JEFFERSON COUNTY R-1,7238,RALSTON ELEMENTARY SCHOOL,5TH,0,2,0,1,42,45,3,7%
1420,JEFFERSON COUNTY R-1,7238,RALSTON ELEMENTARY SCHOOL,6TH,0,0,0,1,36,37,1,3%
1420,JEFFERSON COUNTY R-1,7238,RALSTON ELEMENTARY SCHOOL,SCHOOL TOTAL,2,15,0,9,305,331,26,8%
1420,JEFFERSON COUNTY R-1,7239,RALSTON VALLEY SENIOR HIGH SCHOOL,9TH,2,17,8,31,385,443,58,13%
1420,JEFFERSON COUNTY R-1,7239,RALSTON VALLEY SENIOR HIGH SCHOOL,10TH,5,13,4,29,380,431,51,12%
1420,JEFFERSON COUNTY R-1,7239,RALSTON VALLEY SENIOR HIGH SCHOOL,11TH,3,7,5,31,361,407,46,11%
1420,JEFFERSON COUNTY R-1,7239,RALSTON VALLEY SENIOR HIGH SCHOOL,12TH,3,9,2,31,349,394,45,11%
1420,JEFFERSON COUNTY R-1,7239,RALSTON VALLEY SENIOR HIGH SCHOOL,SCHOOL TOTAL,13,46,19,122,1475,1675,200,12%
1420,JEFFERSON COUNTY R-1,7282,RED ROCKS ELEMENTARY SCHOOL,HALF DAY K,0,2,0,1,43,46,3,7%
1420,JEFFERSON COUNTY R-1,7282,RED ROCKS ELEMENTARY SCHOOL,1ST,0,1,0,4,46,51,5,10%
1420,JEFFERSON COUNTY R-1,7282,RED ROCKS ELEMENTARY SCHOOL,2ND,0,4,0,1,39,44,5,11%
1420,JEFFERSON COUNTY R-1,7282,RED ROCKS ELEMENTARY SCHOOL,3RD,0,2,1,2,41,46,5,11%
1420,JEFFERSON COUNTY R-1,7282,RED ROCKS ELEMENTARY SCHOOL,4TH,0,5,0,2,40,47,7,15%
1420,JEFFERSON COUNTY R-1,7282,RED ROCKS ELEMENTARY SCHOOL,5TH,0,1,1,1,33,36,3,8%
1420,JEFFERSON COUNTY R-1,7282,RED ROCKS ELEMENTARY SCHOOL,6TH,0,1,1,2,40,44,4,9%
1420,JEFFERSON COUNTY R-1,7282,RED ROCKS ELEMENTARY SCHOOL,SCHOOL TOTAL,0,16,3,13,282,314,32,10%
1420,JEFFERSON COUNTY R-1,7462,ROCKY MOUNTAIN ACADEMY OF EVERGREEN,PK,0,2,2,0,41,45,4,9%
1420,JEFFERSON COUNTY R-1,7462,ROCKY MOUNTAIN ACADEMY OF EVERGREEN,KINDERGARTEN,0,3,0,1,34,38,4,11%
1420,JEFFERSON COUNTY R-1,7462,ROCKY MOUNTAIN ACADEMY OF EVERGREEN,1ST,0,2,0,0,46,48,2,4%
1420,JEFFERSON COUNTY R-1,7462,ROCKY MOUNTAIN ACADEMY OF EVERGREEN,2ND,0,1,0,1,44,46,2,4%
1420,JEFFERSON COUNTY R-1,7462,ROCKY MOUNTAIN ACADEMY OF EVERGREEN,3RD,1,3,1,1,44,50,6,12%
1420,JEFFERSON COUNTY R-1,7462,ROCKY MOUNTAIN ACADEMY OF EVERGREEN,4TH,0,2,0,0,48,50,2,4%
1420,JEFFERSON COUNTY R-1,7462,ROCKY MOUNTAIN ACADEMY OF EVERGREEN,5TH,1,1,1,1,31,35,4,11%
1420,JEFFERSON COUNTY R-1,7462,ROCKY MOUNTAIN ACADEMY OF EVERGREEN,6TH,1,3,0,1,36,41,5,12%
1420,JEFFERSON COUNTY R-1,7462,ROCKY MOUNTAIN ACADEMY OF EVERGREEN,7TH,0,0,1,3,34,38,4,11%
1420,JEFFERSON COUNTY R-1,7462,ROCKY MOUNTAIN ACADEMY OF EVERGREEN,8TH,0,0,0,0,42,42,0,0%
1420,JEFFERSON COUNTY R-1,7462,ROCKY MOUNTAIN ACADEMY OF EVERGREEN,SCHOOL TOTAL,3,17,5,8,400,433,33,8%
1420,JEFFERSON COUNTY R-1,7483,ROONEY RANCH ELEMENTARY SCHOOL,HALF DAY K,1,1,2,1,15,20,5,25%
1420,JEFFERSON COUNTY R-1,7483,ROONEY RANCH ELEMENTARY SCHOOL,KINDERGARTEN,0,1,0,2,21,24,3,13%
1420,JEFFERSON COUNTY R-1,7483,ROONEY RANCH ELEMENTARY SCHOOL,1ST,1,2,1,5,70,79,9,11%
1420,JEFFERSON COUNTY R-1,7483,ROONEY RANCH ELEMENTARY SCHOOL,2ND,2,6,0,8,48,64,16,25%
1420,JEFFERSON COUNTY R-1,7483,ROONEY RANCH ELEMENTARY SCHOOL,3RD,1,1,0,1,47,50,3,6%
1420,JEFFERSON COUNTY R-1,7483,ROONEY RANCH ELEMENTARY SCHOOL,4TH,0,5,0,8,43,56,13,23%
1420,JEFFERSON COUNTY R-1,7483,ROONEY RANCH ELEMENTARY SCHOOL,5TH,0,2,2,3,60,67,7,10%
1420,JEFFERSON COUNTY R-1,7483,ROONEY RANCH ELEMENTARY SCHOOL,6TH,2,3,1,7,43,56,13,23%
1420,JEFFERSON COUNTY R-1,7483,ROONEY RANCH ELEMENTARY SCHOOL,SCHOOL TOTAL,7,21,6,35,347,416,69,17%
1420,JEFFERSON COUNTY R-1,7520,RUSSELL ELEMENTARY SCHOOL,KINDERGARTEN,2,2,0,22,22,48,26,54%
1420,JEFFERSON COUNTY R-1,7520,RUSSELL ELEMENTARY SCHOOL,1ST,0,1,1,21,21,44,23,52%
1420,JEFFERSON COUNTY R-1,7520,RUSSELL ELEMENTARY SCHOOL,2ND,1,1,3,14,23,42,19,45%
1420,JEFFERSON COUNTY R-1,7520,RUSSELL ELEMENTARY SCHOOL,3RD,1,2,1,15,16,35,19,54%
1420,JEFFERSON COUNTY R-1,7520,RUSSELL ELEMENTARY SCHOOL,4TH,1,3,1,14,18,37,19,51%
1420,JEFFERSON COUNTY R-1,7520,RUSSELL ELEMENTARY SCHOOL,5TH,1,1,2,17,14,35,21,60%
1420,JEFFERSON COUNTY R-1,7520,RUSSELL ELEMENTARY SCHOOL,6TH,0,4,1,14,17,36,19,53%
1420,JEFFERSON COUNTY R-1,7520,RUSSELL ELEMENTARY SCHOOL,SCHOOL TOTAL,6,14,9,117,131,277,146,53%
1420,JEFFERSON COUNTY R-1,7529,RYAN ELEMENTARY SCHOOL,HALF DAY K,2,4,0,2,25,33,8,24%
1420,JEFFERSON COUNTY R-1,7529,RYAN ELEMENTARY SCHOOL,KINDERGARTEN,0,7,1,7,34,49,15,31%
1420,JEFFERSON COUNTY R-1,7529,RYAN ELEMENTARY SCHOOL,1ST,0,10,0,13,68,91,23,25%
1420,JEFFERSON COUNTY R-1,7529,RYAN ELEMENTARY SCHOOL,2ND,0,17,1,12,59,89,30,34%
1420,JEFFERSON COUNTY R-1,7529,RYAN ELEMENTARY SCHOOL,3RD,0,17,3,6,64,90,26,29%
1420,JEFFERSON COUNTY R-1,7529,RYAN ELEMENTARY SCHOOL,4TH,1,10,2,17,49,79,30,38%
1420,JEFFERSON COUNTY R-1,7529,RYAN ELEMENTARY SCHOOL,5TH,1,11,0,7,59,78,19,24%
1420,JEFFERSON COUNTY R-1,7529,RYAN ELEMENTARY SCHOOL,6TH,1,9,2,15,38,65,27,42%
1420,JEFFERSON COUNTY R-1,7529,RYAN ELEMENTARY SCHOOL,SCHOOL TOTAL,5,85,9,79,396,574,178,31%
1420,JEFFERSON COUNTY R-1,7701,COLLEGIATE ACADEMY OF COLORADO,HALF DAY K,0,0,0,2,11,13,2,15%
1420,JEFFERSON COUNTY R-1,7701,COLLEGIATE ACADEMY OF COLORADO,KINDERGARTEN,0,1,0,0,13,14,1,7%
1420,JEFFERSON COUNTY R-1,7701,COLLEGIATE ACADEMY OF COLORADO,1ST,0,1,1,3,30,35,5,14%
1420,JEFFERSON COUNTY R-1,7701,COLLEGIATE ACADEMY OF COLORADO,2ND,0,3,0,5,29,37,8,22%
1420,JEFFERSON COUNTY R-1,7701,COLLEGIATE ACADEMY OF COLORADO,3RD,0,2,0,7,30,39,9,23%
1420,JEFFERSON COUNTY R-1,7701,COLLEGIATE ACADEMY OF COLORADO,4TH,0,2,0,2,21,25,4,16%
1420,JEFFERSON COUNTY R-1,7701,COLLEGIATE ACADEMY OF COLORADO,5TH,0,2,0,5,36,43,7,16%
1420,JEFFERSON COUNTY R-1,7701,COLLEGIATE ACADEMY OF COLORADO,6TH,0,1,1,2,27,31,4,13%
1420,JEFFERSON COUNTY R-1,7701,COLLEGIATE ACADEMY OF COLORADO,7TH,1,2,0,2,32,37,5,14%
1420,JEFFERSON COUNTY R-1,7701,COLLEGIATE ACADEMY OF COLORADO,8TH,1,1,0,6,35,43,8,19%
1420,JEFFERSON COUNTY R-1,7701,COLLEGIATE ACADEMY OF COLORADO,9TH,0,2,0,5,35,42,7,17%
1420,JEFFERSON COUNTY R-1,7701,COLLEGIATE ACADEMY OF COLORADO,10TH,2,0,1,5,46,54,8,15%
1420,JEFFERSON COUNTY R-1,7701,COLLEGIATE ACADEMY OF COLORADO,11TH,0,0,0,2,34,36,2,6%
1420,JEFFERSON COUNTY R-1,7701,COLLEGIATE ACADEMY OF COLORADO,12TH,1,1,0,7,38,47,9,19%
1420,JEFFERSON COUNTY R-1,7701,COLLEGIATE ACADEMY OF COLORADO,SCHOOL TOTAL,5,18,3,53,417,496,79,16%
1420,JEFFERSON COUNTY R-1,7708,SECREST ELEMENTARY SCHOOL,KINDERGARTEN,0,0,1,14,32,47,15,32%
1420,JEFFERSON COUNTY R-1,7708,SECREST ELEMENTARY SCHOOL,1ST,0,3,2,16,28,49,21,43%
1420,JEFFERSON COUNTY R-1,7708,SECREST ELEMENTARY SCHOOL,2ND,0,2,4,16,30,52,22,42%
1420,JEFFERSON COUNTY R-1,7708,SECREST ELEMENTARY SCHOOL,3RD,0,1,1,16,41,59,18,31%
1420,JEFFERSON COUNTY R-1,7708,SECREST ELEMENTARY SCHOOL,4TH,0,1,2,14,29,46,17,37%
1420,JEFFERSON COUNTY R-1,7708,SECREST ELEMENTARY SCHOOL,5TH,1,1,0,14,36,52,16,31%
1420,JEFFERSON COUNTY R-1,7708,SECREST ELEMENTARY SCHOOL,6TH,0,1,1,12,31,45,14,31%
1420,JEFFERSON COUNTY R-1,7708,SECREST ELEMENTARY SCHOOL,SCHOOL TOTAL,1,9,11,102,227,350,123,35%
1420,JEFFERSON COUNTY R-1,7753,SEMPER ELEMENTARY SCHOOL,HALF DAY K,0,2,0,6,24,32,8,25%
1420,JEFFERSON COUNTY R-1,7753,SEMPER ELEMENTARY SCHOOL,KINDERGARTEN,0,0,0,2,22,24,2,8%
1420,JEFFERSON COUNTY R-1,7753,SEMPER ELEMENTARY SCHOOL,1ST,1,7,1,10,39,58,19,33%
1420,JEFFERSON COUNTY R-1,7753,SEMPER ELEMENTARY SCHOOL,2ND,1,7,0,11,44,63,19,30%
1420,JEFFERSON COUNTY R-1,7753,SEMPER ELEMENTARY SCHOOL,3RD,1,5,3,9,51,69,18,26%
1420,JEFFERSON COUNTY R-1,7753,SEMPER ELEMENTARY SCHOOL,4TH,0,5,3,15,35,58,23,40%
1420,JEFFERSON COUNTY R-1,7753,SEMPER ELEMENTARY SCHOOL,5TH,0,3,4,12,56,75,19,25%
1420,JEFFERSON COUNTY R-1,7753,SEMPER ELEMENTARY SCHOOL,6TH,0,4,1,7,43,55,12,22%
1420,JEFFERSON COUNTY R-1,7753,SEMPER ELEMENTARY SCHOOL,SCHOOL TOTAL,3,33,12,72,314,434,120,28%
1420,JEFFERSON COUNTY R-1,7780,SHAFFER ELEMENTARY SCHOOL,HALF DAY K,0,1,0,3,46,50,4,8%
1420,JEFFERSON COUNTY R-1,7780,SHAFFER ELEMENTARY SCHOOL,KINDERGARTEN,1,3,0,3,60,67,7,10%
1420,JEFFERSON COUNTY R-1,7780,SHAFFER ELEMENTARY SCHOOL,1ST,0,1,0,7,102,110,8,7%
1420,JEFFERSON COUNTY R-1,7780,SHAFFER ELEMENTARY SCHOOL,2ND,0,3,1,5,110,119,9,8%
1420,JEFFERSON COUNTY R-1,7780,SHAFFER ELEMENTARY SCHOOL,3RD,1,1,0,3,101,106,5,5%
1420,JEFFERSON COUNTY R-1,7780,SHAFFER ELEMENTARY SCHOOL,4TH,2,2,2,3,90,99,9,9%
1420,JEFFERSON COUNTY R-1,7780,SHAFFER ELEMENTARY SCHOOL,5TH,0,1,0,3,90,94,4,4%
1420,JEFFERSON COUNTY R-1,7780,SHAFFER ELEMENTARY SCHOOL,SCHOOL TOTAL,4,12,3,27,599,645,46,7%
1420,JEFFERSON COUNTY R-1,7833,SHELTON ELEMENTARY SCHOOL,KINDERGARTEN,0,1,0,4,53,58,5,9%
1420,JEFFERSON COUNTY R-1,7833,SHELTON ELEMENTARY SCHOOL,1ST,0,0,0,4,61,65,4,6%
1420,JEFFERSON COUNTY R-1,7833,SHELTON ELEMENTARY SCHOOL,2ND,0,4,0,2,47,53,6,11%
1420,JEFFERSON COUNTY R-1,7833,SHELTON ELEMENTARY SCHOOL,3RD,0,1,1,3,39,44,5,11%
1420,JEFFERSON COUNTY R-1,7833,SHELTON ELEMENTARY SCHOOL,4TH,0,4,1,14,48,67,19,28%
1420,JEFFERSON COUNTY R-1,7833,SHELTON ELEMENTARY SCHOOL,5TH,0,1,0,7,47,55,8,15%
1420,JEFFERSON COUNTY R-1,7833,SHELTON ELEMENTARY SCHOOL,6TH,0,2,0,9,56,67,11,16%
1420,JEFFERSON COUNTY R-1,7833,SHELTON ELEMENTARY SCHOOL,SCHOOL TOTAL,0,13,2,43,351,409,58,14%
1420,JEFFERSON COUNTY R-1,7870,SIERRA ELEMENTARY SCHOOL,HALF DAY K,0,2,1,3,37,43,6,14%
1420,JEFFERSON COUNTY R-1,7870,SIERRA ELEMENTARY SCHOOL,KINDERGARTEN,1,0,0,2,22,25,3,12%
1420,JEFFERSON COUNTY R-1,7870,SIERRA ELEMENTARY SCHOOL,1ST,0,5,2,9,64,80,16,20%
1420,JEFFERSON COUNTY R-1,7870,SIERRA ELEMENTARY SCHOOL,2ND,0,2,2,8,69,81,12,15%
1420,JEFFERSON COUNTY R-1,7870,SIERRA ELEMENTARY SCHOOL,3RD,2,5,1,6,66,80,14,18%
1420,JEFFERSON COUNTY R-1,7870,SIERRA ELEMENTARY SCHOOL,4TH,0,2,4,9,79,94,15,16%
1420,JEFFERSON COUNTY R-1,7870,SIERRA ELEMENTARY SCHOOL,5TH,1,3,0,13,61,78,17,22%
1420,JEFFERSON COUNTY R-1,7870,SIERRA ELEMENTARY SCHOOL,6TH,1,3,2,5,68,79,11,14%
1420,JEFFERSON COUNTY R-1,7870,SIERRA ELEMENTARY SCHOOL,SCHOOL TOTAL,5,22,12,55,466,560,94,17%
1420,JEFFERSON COUNTY R-1,7962,SLATER ELEMENTARY SCHOOL,PK,0,1,1,15,15,32,17,53%
1420,JEFFERSON COUNTY R-1,7962,SLATER ELEMENTARY SCHOOL,KINDERGARTEN,2,0,2,13,24,41,17,41%
1420,JEFFERSON COUNTY R-1,7962,SLATER ELEMENTARY SCHOOL,1ST,1,1,2,16,22,42,20,48%
1420,JEFFERSON COUNTY R-1,7962,SLATER ELEMENTARY SCHOOL,2ND,1,1,1,14,21,38,17,45%
1420,JEFFERSON COUNTY R-1,7962,SLATER ELEMENTARY SCHOOL,3RD,1,0,5,22,29,57,28,49%
1420,JEFFERSON COUNTY R-1,7962,SLATER ELEMENTARY SCHOOL,4TH,1,0,2,13,19,35,16,46%
1420,JEFFERSON COUNTY R-1,7962,SLATER ELEMENTARY SCHOOL,5TH,0,1,5,16,25,47,22,47%
1420,JEFFERSON COUNTY R-1,7962,SLATER ELEMENTARY SCHOOL,6TH,1,3,4,15,16,39,23,59%
1420,JEFFERSON COUNTY R-1,7962,SLATER ELEMENTARY SCHOOL,SCHOOL TOTAL,7,7,22,124,171,331,160,48%
1420,JEFFERSON COUNTY R-1,8036,SOBESKY ACADEMY,1ST,0,0,0,0,1,1,0,0%
1420,JEFFERSON COUNTY R-1,8036,SOBESKY ACADEMY,2ND,0,0,1,0,3,4,1,25%
1420,JEFFERSON COUNTY R-1,8036,SOBESKY ACADEMY,3RD,0,0,0,0,2,2,0,0%
1420,JEFFERSON COUNTY R-1,8036,SOBESKY ACADEMY,4TH,0,0,0,1,4,5,1,20%
1420,JEFFERSON COUNTY R-1,8036,SOBESKY ACADEMY,5TH,0,0,0,1,5,6,1,17%
1420,JEFFERSON COUNTY R-1,8036,SOBESKY ACADEMY,6TH,0,0,1,0,5,6,1,17%
1420,JEFFERSON COUNTY R-1,8036,SOBESKY ACADEMY,7TH,0,0,1,2,5,8,3,38%
1420,JEFFERSON COUNTY R-1,8036,SOBESKY ACADEMY,8TH,0,0,0,3,8,11,3,27%
1420,JEFFERSON COUNTY R-1,8036,SOBESKY ACADEMY,9TH,1,0,2,4,16,23,7,30%
1420,JEFFERSON COUNTY R-1,8036,SOBESKY ACADEMY,10TH,0,0,2,0,5,7,2,29%
1420,JEFFERSON COUNTY R-1,8036,SOBESKY ACADEMY,11TH,0,0,0,1,6,7,1,14%
1420,JEFFERSON COUNTY R-1,8036,SOBESKY ACADEMY,12TH,1,0,0,1,2,4,2,50%
1420,JEFFERSON COUNTY R-1,8036,SOBESKY ACADEMY,SCHOOL TOTAL,2,0,7,13,62,84,22,26%
1420,JEFFERSON COUNTY R-1,8090,DEANE ELEMENTARY SCHOOL,KINDERGARTEN,0,3,1,47,15,66,51,77%
1420,JEFFERSON COUNTY R-1,8090,DEANE ELEMENTARY SCHOOL,1ST,1,3,0,50,17,71,54,76%
1420,JEFFERSON COUNTY R-1,8090,DEANE ELEMENTARY SCHOOL,2ND,1,2,2,52,16,73,57,78%
1420,JEFFERSON COUNTY R-1,8090,DEANE ELEMENTARY SCHOOL,3RD,1,3,5,45,17,71,54,76%
1420,JEFFERSON COUNTY R-1,8090,DEANE ELEMENTARY SCHOOL,4TH,0,2,1,34,11,48,37,77%
1420,JEFFERSON COUNTY R-1,8090,DEANE ELEMENTARY SCHOOL,5TH,2,3,4,43,16,68,52,76%
1420,JEFFERSON COUNTY R-1,8090,DEANE ELEMENTARY SCHOOL,6TH,1,5,4,40,14,64,50,78%
1420,JEFFERSON COUNTY R-1,8090,DEANE ELEMENTARY SCHOOL,SCHOOL TOTAL,6,21,17,311,106,461,355,77%
1420,JEFFERSON COUNTY R-1,8102,SOUTH LAKEWOOD ELEMENTARY SCHOOL,HALF DAY K,0,0,0,0,1,1,0,0%
1420,JEFFERSON COUNTY R-1,8102,SOUTH LAKEWOOD ELEMENTARY SCHOOL,KINDERGARTEN,1,2,0,15,50,68,18,26%
1420,JEFFERSON COUNTY R-1,8102,SOUTH LAKEWOOD ELEMENTARY SCHOOL,1ST,6,1,4,32,52,95,43,45%
1420,JEFFERSON COUNTY R-1,8102,SOUTH LAKEWOOD ELEMENTARY SCHOOL,2ND,2,2,1,22,46,73,27,37%
1420,JEFFERSON COUNTY R-1,8102,SOUTH LAKEWOOD ELEMENTARY SCHOOL,3RD,0,3,4,14,56,77,21,27%
1420,JEFFERSON COUNTY R-1,8102,SOUTH LAKEWOOD ELEMENTARY SCHOOL,4TH,5,2,1,21,56,85,29,34%
1420,JEFFERSON COUNTY R-1,8102,SOUTH LAKEWOOD ELEMENTARY SCHOOL,5TH,2,1,3,21,49,76,27,36%
1420,JEFFERSON COUNTY R-1,8102,SOUTH LAKEWOOD ELEMENTARY SCHOOL,6TH,2,0,5,21,43,71,28,39%
1420,JEFFERSON COUNTY R-1,8102,SOUTH LAKEWOOD ELEMENTARY SCHOOL,SCHOOL TOTAL,18,11,18,146,353,546,193,35%
1420,JEFFERSON COUNTY R-1,8209,STANDLEY LAKE HIGH SCHOOL,9TH,7,33,7,55,282,384,102,27%
1420,JEFFERSON COUNTY R-1,8209,STANDLEY LAKE HIGH SCHOOL,10TH,5,26,5,63,298,397,99,25%
1420,JEFFERSON COUNTY R-1,8209,STANDLEY LAKE HIGH SCHOOL,11TH,3,33,11,49,290,386,96,25%
1420,JEFFERSON COUNTY R-1,8209,STANDLEY LAKE HIGH SCHOOL,12TH,5,34,8,48,273,368,95,26%
1420,JEFFERSON COUNTY R-1,8209,STANDLEY LAKE HIGH SCHOOL,SCHOOL TOTAL,20,126,31,215,1143,1535,392,26%
1420,JEFFERSON COUNTY R-1,8248,STEIN ELEMENTARY SCHOOL,PK,1,2,1,63,15,82,67,82%
1420,JEFFERSON COUNTY R-1,8248,STEIN ELEMENTARY SCHOOL,KINDERGARTEN,1,0,3,80,12,96,84,88%
1420,JEFFERSON COUNTY R-1,8248,STEIN ELEMENTARY SCHOOL,1ST,1,1,4,82,24,112,88,79%
1420,JEFFERSON COUNTY R-1,8248,STEIN ELEMENTARY SCHOOL,2ND,2,0,5,76,9,92,83,90%
1420,JEFFERSON COUNTY R-1,8248,STEIN ELEMENTARY SCHOOL,3RD,2,3,3,95,14,117,103,88%
1420,JEFFERSON COUNTY R-1,8248,STEIN ELEMENTARY SCHOOL,4TH,2,0,1,68,8,79,71,90%
1420,JEFFERSON COUNTY R-1,8248,STEIN ELEMENTARY SCHOOL,5TH,2,0,5,64,13,84,71,85%
1420,JEFFERSON COUNTY R-1,8248,STEIN ELEMENTARY SCHOOL,6TH,4,1,3,69,10,87,77,89%
1420,JEFFERSON COUNTY R-1,8248,STEIN ELEMENTARY SCHOOL,SCHOOL TOTAL,15,7,25,597,105,749,644,86%
1420,JEFFERSON COUNTY R-1,8272,STEVENS ELEMENTARY SCHOOL,KINDERGARTEN,1,0,2,13,36,52,16,31%
1420,JEFFERSON COUNTY R-1,8272,STEVENS ELEMENTARY SCHOOL,1ST,0,1,2,38,18,59,41,69%
1420,JEFFERSON COUNTY R-1,8272,STEVENS ELEMENTARY SCHOOL,2ND,0,1,5,22,15,43,28,65%
1420,JEFFERSON COUNTY R-1,8272,STEVENS ELEMENTARY SCHOOL,3RD,1,1,1,31,17,51,34,67%
1420,JEFFERSON COUNTY R-1,8272,STEVENS ELEMENTARY SCHOOL,4TH,0,1,4,26,22,53,31,58%
1420,JEFFERSON COUNTY R-1,8272,STEVENS ELEMENTARY SCHOOL,5TH,2,3,2,28,26,61,35,57%
1420,JEFFERSON COUNTY R-1,8272,STEVENS ELEMENTARY SCHOOL,6TH,1,1,4,29,32,67,35,52%
1420,JEFFERSON COUNTY R-1,8272,STEVENS ELEMENTARY SCHOOL,SCHOOL TOTAL,5,8,20,187,166,386,220,57%
1420,JEFFERSON COUNTY R-1,8276,STOBER ELEMENTARY SCHOOL,KINDERGARTEN,0,0,2,13,31,46,15,33%
1420,JEFFERSON COUNTY R-1,8276,STOBER ELEMENTARY SCHOOL,1ST,2,1,2,5,40,50,10,20%
1420,JEFFERSON COUNTY R-1,8276,STOBER ELEMENTARY SCHOOL,2ND,1,1,0,10,32,44,12,27%
1420,JEFFERSON COUNTY R-1,8276,STOBER ELEMENTARY SCHOOL,3RD,1,1,0,10,23,35,12,34%
1420,JEFFERSON COUNTY R-1,8276,STOBER ELEMENTARY SCHOOL,4TH,0,2,1,11,29,43,14,33%
1420,JEFFERSON COUNTY R-1,8276,STOBER ELEMENTARY SCHOOL,5TH,0,1,1,10,29,41,12,29%
1420,JEFFERSON COUNTY R-1,8276,STOBER ELEMENTARY SCHOOL,6TH,0,2,1,9,29,41,12,29%
1420,JEFFERSON COUNTY R-1,8276,STOBER ELEMENTARY SCHOOL,SCHOOL TOTAL,4,8,7,68,213,300,87,29%
1420,JEFFERSON COUNTY R-1,8280,STONY CREEK ELEMENTARY SCHOOL,PK,0,4,1,15,81,101,20,20%
1420,JEFFERSON COUNTY R-1,8280,STONY CREEK ELEMENTARY SCHOOL,HALF DAY K,1,3,0,6,34,44,10,23%
1420,JEFFERSON COUNTY R-1,8280,STONY CREEK ELEMENTARY SCHOOL,KINDERGARTEN,0,1,0,1,24,26,2,8%
1420,JEFFERSON COUNTY R-1,8280,STONY CREEK ELEMENTARY SCHOOL,1ST,0,2,0,18,65,85,20,24%
1420,JEFFERSON COUNTY R-1,8280,STONY CREEK ELEMENTARY SCHOOL,2ND,0,4,0,8,57,69,12,17%
1420,JEFFERSON COUNTY R-1,8280,STONY CREEK ELEMENTARY SCHOOL,3RD,1,6,2,3,77,89,12,13%
1420,JEFFERSON COUNTY R-1,8280,STONY CREEK ELEMENTARY SCHOOL,4TH,3,2,0,14,87,106,19,18%
1420,JEFFERSON COUNTY R-1,8280,STONY CREEK ELEMENTARY SCHOOL,5TH,1,4,3,11,71,90,19,21%
1420,JEFFERSON COUNTY R-1,8280,STONY CREEK ELEMENTARY SCHOOL,6TH,0,4,1,14,70,89,19,21%
1420,JEFFERSON COUNTY R-1,8280,STONY CREEK ELEMENTARY SCHOOL,SCHOOL TOTAL,6,30,7,90,566,699,133,19%
1420,JEFFERSON COUNTY R-1,8300,STOTT ELEMENTARY SCHOOL,PK,1,6,0,4,40,51,11,22%
1420,JEFFERSON COUNTY R-1,8300,STOTT ELEMENTARY SCHOOL,HALF DAY K,0,0,0,7,21,28,7,25%
1420,JEFFERSON COUNTY R-1,8300,STOTT ELEMENTARY SCHOOL,KINDERGARTEN,1,1,0,2,22,26,4,15%
1420,JEFFERSON COUNTY R-1,8300,STOTT ELEMENTARY SCHOOL,1ST,0,2,2,6,26,36,10,28%
1420,JEFFERSON COUNTY R-1,8300,STOTT ELEMENTARY SCHOOL,2ND,0,1,0,7,27,35,8,23%
1420,JEFFERSON COUNTY R-1,8300,STOTT ELEMENTARY SCHOOL,3RD,1,1,1,7,32,42,10,24%
1420,JEFFERSON COUNTY R-1,8300,STOTT ELEMENTARY SCHOOL,4TH,1,4,4,4,30,43,13,30%
1420,JEFFERSON COUNTY R-1,8300,STOTT ELEMENTARY SCHOOL,5TH,1,0,3,12,35,51,16,31%
1420,JEFFERSON COUNTY R-1,8300,STOTT ELEMENTARY SCHOOL,6TH,2,1,1,4,35,43,8,19%
1420,JEFFERSON COUNTY R-1,8300,STOTT ELEMENTARY SCHOOL,SCHOOL TOTAL,7,16,11,53,268,355,87,25%
1420,JEFFERSON COUNTY R-1,8381,SUMMIT RIDGE MIDDLE SCHOOL,7TH,4,12,7,47,342,412,70,17%
1420,JEFFERSON COUNTY R-1,8381,SUMMIT RIDGE MIDDLE SCHOOL,8TH,6,15,8,41,338,408,70,17%
1420,JEFFERSON COUNTY R-1,8381,SUMMIT RIDGE MIDDLE SCHOOL,SCHOOL TOTAL,10,27,15,88,680,820,140,17%
1420,JEFFERSON COUNTY R-1,8432,SWANSON ELEMENTARY SCHOOL,PK,2,5,2,28,50,87,37,43%
1420,JEFFERSON COUNTY R-1,8432,SWANSON ELEMENTARY SCHOOL,KINDERGARTEN,4,8,0,31,26,69,43,62%
1420,JEFFERSON COUNTY R-1,8432,SWANSON ELEMENTARY SCHOOL,1ST,0,6,1,29,34,70,36,51%
1420,JEFFERSON COUNTY R-1,8432,SWANSON ELEMENTARY SCHOOL,2ND,0,5,2,19,25,51,26,51%
1420,JEFFERSON COUNTY R-1,8432,SWANSON ELEMENTARY SCHOOL,3RD,0,4,2,31,23,60,37,62%
1420,JEFFERSON COUNTY R-1,8432,SWANSON ELEMENTARY SCHOOL,4TH,0,4,3,32,27,66,39,59%
1420,JEFFERSON COUNTY R-1,8432,SWANSON ELEMENTARY SCHOOL,5TH,2,4,1,29,34,70,36,51%
1420,JEFFERSON COUNTY R-1,8432,SWANSON ELEMENTARY SCHOOL,6TH,2,5,2,23,38,70,32,46%
1420,JEFFERSON COUNTY R-1,8432,SWANSON ELEMENTARY SCHOOL,SCHOOL TOTAL,10,41,13,222,257,543,286,53%
1420,JEFFERSON COUNTY R-1,8458,JOHN AND KAREN LITZ PRESCHOOL,PK,0,2,0,5,77,84,7,8%
1420,JEFFERSON COUNTY R-1,8458,JOHN AND KAREN LITZ PRESCHOOL,SCHOOL TOTAL,0,2,0,5,77,84,7,8%
1420,JEFFERSON COUNTY R-1,8834,THOMSON ELEMENTARY SCHOOL,KINDERGARTEN,2,3,0,18,34,57,23,40%
1420,JEFFERSON COUNTY R-1,8834,THOMSON ELEMENTARY SCHOOL,1ST,1,4,4,19,24,52,28,54%
1420,JEFFERSON COUNTY R-1,8834,THOMSON ELEMENTARY SCHOOL,2ND,1,3,0,20,33,57,24,42%
1420,JEFFERSON COUNTY R-1,8834,THOMSON ELEMENTARY SCHOOL,3RD,1,0,2,24,43,70,27,39%
1420,JEFFERSON COUNTY R-1,8834,THOMSON ELEMENTARY SCHOOL,4TH,4,2,1,25,42,74,32,43%
1420,JEFFERSON COUNTY R-1,8834,THOMSON ELEMENTARY SCHOOL,5TH,3,3,3,20,37,66,29,44%
1420,JEFFERSON COUNTY R-1,8834,THOMSON ELEMENTARY SCHOOL,6TH,0,2,0,19,32,53,21,40%
1420,JEFFERSON COUNTY R-1,8834,THOMSON ELEMENTARY SCHOOL,SCHOOL TOTAL,12,17,10,145,245,429,184,43%
1420,JEFFERSON COUNTY R-1,9008,UTE MEADOWS ELEMENTARY SCHOOL,HALF DAY K,0,0,0,1,19,20,1,5%
1420,JEFFERSON COUNTY R-1,9008,UTE MEADOWS ELEMENTARY SCHOOL,KINDERGARTEN,0,0,0,2,22,24,2,8%
1420,JEFFERSON COUNTY R-1,9008,UTE MEADOWS ELEMENTARY SCHOOL,1ST,0,0,0,4,60,64,4,6%
1420,JEFFERSON COUNTY R-1,9008,UTE MEADOWS ELEMENTARY SCHOOL,2ND,0,2,1,3,64,70,6,9%
1420,JEFFERSON COUNTY R-1,9008,UTE MEADOWS ELEMENTARY SCHOOL,3RD,0,1,0,2,45,48,3,6%
1420,JEFFERSON COUNTY R-1,9008,UTE MEADOWS ELEMENTARY SCHOOL,4TH,0,3,1,6,60,70,10,14%
1420,JEFFERSON COUNTY R-1,9008,UTE MEADOWS ELEMENTARY SCHOOL,5TH,0,1,1,5,54,61,7,11%
1420,JEFFERSON COUNTY R-1,9008,UTE MEADOWS ELEMENTARY SCHOOL,6TH,0,2,2,3,62,69,7,10%
1420,JEFFERSON COUNTY R-1,9008,UTE MEADOWS ELEMENTARY SCHOOL,SCHOOL TOTAL,0,9,5,26,386,426,40,9%
1420,JEFFERSON COUNTY R-1,9052,VAN ARSDALE ELEMENTARY SCHOOL,HALF DAY K,1,1,0,6,34,42,8,19%
1420,JEFFERSON COUNTY R-1,9052,VAN ARSDALE ELEMENTARY SCHOOL,KINDERGARTEN,0,0,0,0,24,24,0,0%
1420,JEFFERSON COUNTY R-1,9052,VAN ARSDALE ELEMENTARY SCHOOL,1ST,1,2,1,8,63,75,12,16%
1420,JEFFERSON COUNTY R-1,9052,VAN ARSDALE ELEMENTARY SCHOOL,2ND,0,0,1,5,58,64,6,9%
1420,JEFFERSON COUNTY R-1,9052,VAN ARSDALE ELEMENTARY SCHOOL,3RD,1,0,0,8,76,85,9,11%
1420,JEFFERSON COUNTY R-1,9052,VAN ARSDALE ELEMENTARY SCHOOL,4TH,0,0,0,12,73,85,12,14%
1420,JEFFERSON COUNTY R-1,9052,VAN ARSDALE ELEMENTARY SCHOOL,5TH,1,1,1,10,78,91,13,14%
1420,JEFFERSON COUNTY R-1,9052,VAN ARSDALE ELEMENTARY SCHOOL,6TH,3,1,2,9,63,78,15,19%
1420,JEFFERSON COUNTY R-1,9052,VAN ARSDALE ELEMENTARY SCHOOL,SCHOOL TOTAL,7,5,5,58,469,544,75,14%
1420,JEFFERSON COUNTY R-1,9058,VANDERHOOF ELEMENTARY SCHOOL,HALF DAY K,0,1,0,5,33,39,6,15%
1420,JEFFERSON COUNTY R-1,9058,VANDERHOOF ELEMENTARY SCHOOL,KINDERGARTEN,0,1,0,0,24,25,1,4%
1420,JEFFERSON COUNTY R-1,9058,VANDERHOOF ELEMENTARY SCHOOL,1ST,0,3,1,3,53,60,7,12%
1420,JEFFERSON COUNTY R-1,9058,VANDERHOOF ELEMENTARY SCHOOL,2ND,0,1,0,6,75,82,7,9%
1420,JEFFERSON COUNTY R-1,9058,VANDERHOOF ELEMENTARY SCHOOL,3RD,0,2,1,6,66,75,9,12%
1420,JEFFERSON COUNTY R-1,9058,VANDERHOOF ELEMENTARY SCHOOL,4TH,0,2,0,11,82,95,13,14%
1420,JEFFERSON COUNTY R-1,9058,VANDERHOOF ELEMENTARY SCHOOL,5TH,1,1,0,10,74,86,12,14%
1420,JEFFERSON COUNTY R-1,9058,VANDERHOOF ELEMENTARY SCHOOL,6TH,0,1,1,13,73,88,15,17%
1420,JEFFERSON COUNTY R-1,9058,VANDERHOOF ELEMENTARY SCHOOL,SCHOOL TOTAL,1,12,3,54,480,550,70,13%
1420,JEFFERSON COUNTY R-1,9154,VIVIAN ELEMENTARY SCHOOL,PK,0,1,0,9,37,47,10,21%
1420,JEFFERSON COUNTY R-1,9154,VIVIAN ELEMENTARY SCHOOL,KINDERGARTEN,0,0,1,11,18,30,12,40%
1420,JEFFERSON COUNTY R-1,9154,VIVIAN ELEMENTARY SCHOOL,1ST,1,0,0,10,17,28,11,39%
1420,JEFFERSON COUNTY R-1,9154,VIVIAN ELEMENTARY SCHOOL,2ND,0,0,1,9,11,21,10,48%
1420,JEFFERSON COUNTY R-1,9154,VIVIAN ELEMENTARY SCHOOL,3RD,1,2,2,7,15,27,12,44%
1420,JEFFERSON COUNTY R-1,9154,VIVIAN ELEMENTARY SCHOOL,4TH,2,1,2,8,14,27,13,48%
1420,JEFFERSON COUNTY R-1,9154,VIVIAN ELEMENTARY SCHOOL,5TH,1,0,1,13,21,36,15,42%
1420,JEFFERSON COUNTY R-1,9154,VIVIAN ELEMENTARY SCHOOL,6TH,2,2,2,8,22,36,14,39%
1420,JEFFERSON COUNTY R-1,9154,VIVIAN ELEMENTARY SCHOOL,SCHOOL TOTAL,7,6,9,75,155,252,97,38%
1420,JEFFERSON COUNTY R-1,9232,WARDER ELEMENTARY SCHOOL,KINDERGARTEN,0,2,4,10,31,47,16,34%
1420,JEFFERSON COUNTY R-1,9232,WARDER ELEMENTARY SCHOOL,1ST,2,1,2,9,27,41,14,34%
1420,JEFFERSON COUNTY R-1,9232,WARDER ELEMENTARY SCHOOL,2ND,2,0,4,12,34,52,18,35%
1420,JEFFERSON COUNTY R-1,9232,WARDER ELEMENTARY SCHOOL,3RD,2,3,1,10,30,46,16,35%
1420,JEFFERSON COUNTY R-1,9232,WARDER ELEMENTARY SCHOOL,4TH,0,0,3,17,33,53,20,38%
1420,JEFFERSON COUNTY R-1,9232,WARDER ELEMENTARY SCHOOL,5TH,2,3,0,15,33,53,20,38%
1420,JEFFERSON COUNTY R-1,9232,WARDER ELEMENTARY SCHOOL,6TH,1,2,4,11,28,46,18,39%
1420,JEFFERSON COUNTY R-1,9232,WARDER ELEMENTARY SCHOOL,SCHOOL TOTAL,9,11,18,84,216,338,122,36%
1420,JEFFERSON COUNTY R-1,9234,WARREN OCCUPATION TECHNICAL CENTER,11TH,0,0,0,0,15,15,0,0%
1420,JEFFERSON COUNTY R-1,9234,WARREN OCCUPATION TECHNICAL CENTER,12TH,0,1,0,1,22,24,2,8%
1420,JEFFERSON COUNTY R-1,9234,WARREN OCCUPATION TECHNICAL CENTER,SCHOOL TOTAL,0,1,0,1,37,39,2,5%
1420,JEFFERSON COUNTY R-1,9245,WARREN TECH NORTH,11TH,0,0,0,1,3,4,1,25%
1420,JEFFERSON COUNTY R-1,9245,WARREN TECH NORTH,12TH,0,0,0,0,2,2,0,0%
1420,JEFFERSON COUNTY R-1,9245,WARREN TECH NORTH,SCHOOL TOTAL,0,0,0,1,5,6,1,17%
1420,JEFFERSON COUNTY R-1,9299,WAYNE CARLE MIDDLE SCHOOL,7TH,0,4,5,22,132,163,31,19%
1420,JEFFERSON COUNTY R-1,9299,WAYNE CARLE MIDDLE SCHOOL,8TH,0,8,3,28,136,175,39,22%
1420,JEFFERSON COUNTY R-1,9299,WAYNE CARLE MIDDLE SCHOOL,SCHOOL TOTAL,0,12,8,50,268,338,70,21%
1420,JEFFERSON COUNTY R-1,9328,WEBER ELEMENTARY SCHOOL,HALF DAY K,0,0,2,5,27,34,7,21%
1420,JEFFERSON COUNTY R-1,9328,WEBER ELEMENTARY SCHOOL,KINDERGARTEN,0,1,0,4,20,25,5,20%
1420,JEFFERSON COUNTY R-1,9328,WEBER ELEMENTARY SCHOOL,1ST,1,0,0,6,42,49,7,14%
1420,JEFFERSON COUNTY R-1,9328,WEBER ELEMENTARY SCHOOL,2ND,1,3,2,6,45,57,12,21%
1420,JEFFERSON COUNTY R-1,9328,WEBER ELEMENTARY SCHOOL,3RD,1,1,0,9,49,60,11,18%
1420,JEFFERSON COUNTY R-1,9328,WEBER ELEMENTARY SCHOOL,4TH,3,1,0,13,69,86,17,20%
1420,JEFFERSON COUNTY R-1,9328,WEBER ELEMENTARY SCHOOL,5TH,0,1,2,12,53,68,15,22%
1420,JEFFERSON COUNTY R-1,9328,WEBER ELEMENTARY SCHOOL,6TH,1,2,0,16,60,79,19,24%
1420,JEFFERSON COUNTY R-1,9328,WEBER ELEMENTARY SCHOOL,SCHOOL TOTAL,7,9,6,71,365,458,93,20%
1420,JEFFERSON COUNTY R-1,9342,WELCHESTER ELEMENTARY SCHOOL,KINDERGARTEN,0,2,0,7,35,44,9,20%
1420,JEFFERSON COUNTY R-1,9342,WELCHESTER ELEMENTARY SCHOOL,1ST,2,5,3,14,24,48,24,50%
1420,JEFFERSON COUNTY R-1,9342,WELCHESTER ELEMENTARY SCHOOL,2ND,1,1,0,7,31,40,9,23%
1420,JEFFERSON COUNTY R-1,9342,WELCHESTER ELEMENTARY SCHOOL,3RD,2,2,3,7,35,49,14,29%
1420,JEFFERSON COUNTY R-1,9342,WELCHESTER ELEMENTARY SCHOOL,4TH,3,2,2,6,30,43,13,30%
1420,JEFFERSON COUNTY R-1,9342,WELCHESTER ELEMENTARY SCHOOL,5TH,0,6,2,10,20,38,18,47%
1420,JEFFERSON COUNTY R-1,9342,WELCHESTER ELEMENTARY SCHOOL,6TH,3,1,4,12,29,49,20,41%
1420,JEFFERSON COUNTY R-1,9342,WELCHESTER ELEMENTARY SCHOOL,SCHOOL TOTAL,11,19,14,63,204,311,107,34%
1420,JEFFERSON COUNTY R-1,9412,WESTGATE ELEMENTARY SCHOOL,KINDERGARTEN,1,5,3,22,56,87,31,36%
1420,JEFFERSON COUNTY R-1,9412,WESTGATE ELEMENTARY SCHOOL,1ST,0,4,2,28,50,84,34,40%
1420,JEFFERSON COUNTY R-1,9412,WESTGATE ELEMENTARY SCHOOL,2ND,0,4,3,30,45,82,37,45%
1420,JEFFERSON COUNTY R-1,9412,WESTGATE ELEMENTARY SCHOOL,3RD,1,4,1,30,56,92,36,39%
1420,JEFFERSON COUNTY R-1,9412,WESTGATE ELEMENTARY SCHOOL,4TH,1,3,5,22,53,84,31,37%
1420,JEFFERSON COUNTY R-1,9412,WESTGATE ELEMENTARY SCHOOL,5TH,1,3,4,22,64,94,30,32%
1420,JEFFERSON COUNTY R-1,9412,WESTGATE ELEMENTARY SCHOOL,6TH,2,1,1,28,52,84,32,38%
1420,JEFFERSON COUNTY R-1,9412,WESTGATE ELEMENTARY SCHOOL,SCHOOL TOTAL,6,24,19,182,376,607,231,38%
1420,JEFFERSON COUNTY R-1,9424,WEST JEFFERSON ELEMENTARY SCHOOL,PK,1,1,1,3,85,91,6,7%
1420,JEFFERSON COUNTY R-1,9424,WEST JEFFERSON ELEMENTARY SCHOOL,HALF DAY K,0,0,0,0,12,12,0,0%
1420,JEFFERSON COUNTY R-1,9424,WEST JEFFERSON ELEMENTARY SCHOOL,KINDERGARTEN,0,0,0,2,21,23,2,9%
1420,JEFFERSON COUNTY R-1,9424,WEST JEFFERSON ELEMENTARY SCHOOL,1ST,1,3,0,2,48,54,6,11%
1420,JEFFERSON COUNTY R-1,9424,WEST JEFFERSON ELEMENTARY SCHOOL,2ND,0,0,0,1,37,38,1,3%
1420,JEFFERSON COUNTY R-1,9424,WEST JEFFERSON ELEMENTARY SCHOOL,3RD,1,1,1,2,26,31,5,16%
1420,JEFFERSON COUNTY R-1,9424,WEST JEFFERSON ELEMENTARY SCHOOL,4TH,0,1,0,5,43,49,6,12%
1420,JEFFERSON COUNTY R-1,9424,WEST JEFFERSON ELEMENTARY SCHOOL,5TH,0,1,1,3,59,64,5,8%
1420,JEFFERSON COUNTY R-1,9424,WEST JEFFERSON ELEMENTARY SCHOOL,SCHOOL TOTAL,3,7,3,18,331,362,31,9%
1420,JEFFERSON COUNTY R-1,9427,WOODROW WILSON CHARTER ACADEMY,HALF DAY K,0,0,0,3,28,31,3,10%
1420,JEFFERSON COUNTY R-1,9427,WOODROW WILSON CHARTER ACADEMY,KINDERGARTEN,1,1,1,3,32,38,6,16%
1420,JEFFERSON COUNTY R-1,9427,WOODROW WILSON CHARTER ACADEMY,1ST,1,4,0,3,68,76,8,11%
1420,JEFFERSON COUNTY R-1,9427,WOODROW WILSON CHARTER ACADEMY,2ND,0,1,2,5,63,71,8,11%
1420,JEFFERSON COUNTY R-1,9427,WOODROW WILSON CHARTER ACADEMY,3RD,1,1,2,3,61,68,7,10%
1420,JEFFERSON COUNTY R-1,9427,WOODROW WILSON CHARTER ACADEMY,4TH,1,4,0,4,55,64,9,14%
1420,JEFFERSON COUNTY R-1,9427,WOODROW WILSON CHARTER ACADEMY,5TH,1,0,0,6,51,58,7,12%
1420,JEFFERSON COUNTY R-1,9427,WOODROW WILSON CHARTER ACADEMY,6TH,0,1,0,10,50,61,11,18%
1420,JEFFERSON COUNTY R-1,9427,WOODROW WILSON CHARTER ACADEMY,7TH,2,1,1,4,34,42,8,19%
1420,JEFFERSON COUNTY R-1,9427,WOODROW WILSON CHARTER ACADEMY,8TH,0,0,1,0,29,30,1,3%
1420,JEFFERSON COUNTY R-1,9427,WOODROW WILSON CHARTER ACADEMY,SCHOOL TOTAL,7,13,7,41,471,539,68,13%
1420,JEFFERSON COUNTY R-1,9428,WEST JEFFERSON MIDDLE SCHOOL,6TH,1,4,1,4,153,163,10,6%
1420,JEFFERSON COUNTY R-1,9428,WEST JEFFERSON MIDDLE SCHOOL,7TH,2,3,0,5,200,210,10,5%
1420,JEFFERSON COUNTY R-1,9428,WEST JEFFERSON MIDDLE SCHOOL,8TH,4,3,2,11,184,204,20,10%
1420,JEFFERSON COUNTY R-1,9428,WEST JEFFERSON MIDDLE SCHOOL,SCHOOL TOTAL,7,10,3,20,537,577,40,7%
1420,JEFFERSON COUNTY R-1,9429,WEST WOODS ELEMENTARY SCHOOL,HALF DAY K,0,2,0,0,23,25,2,8%
1420,JEFFERSON COUNTY R-1,9429,WEST WOODS ELEMENTARY SCHOOL,KINDERGARTEN,0,3,0,3,41,47,6,13%
1420,JEFFERSON COUNTY R-1,9429,WEST WOODS ELEMENTARY SCHOOL,1ST,0,2,0,3,87,92,5,5%
1420,JEFFERSON COUNTY R-1,9429,WEST WOODS ELEMENTARY SCHOOL,2ND,0,6,0,5,77,88,11,13%
1420,JEFFERSON COUNTY R-1,9429,WEST WOODS ELEMENTARY SCHOOL,3RD,0,3,0,5,79,87,8,9%
1420,JEFFERSON COUNTY R-1,9429,WEST WOODS ELEMENTARY SCHOOL,4TH,1,3,0,11,96,111,15,14%
1420,JEFFERSON COUNTY R-1,9429,WEST WOODS ELEMENTARY SCHOOL,5TH,2,3,0,7,83,95,12,13%
1420,JEFFERSON COUNTY R-1,9429,WEST WOODS ELEMENTARY SCHOOL,6TH,0,4,0,3,107,114,7,6%
1420,JEFFERSON COUNTY R-1,9429,WEST WOODS ELEMENTARY SCHOOL,SCHOOL TOTAL,3,26,0,37,593,659,66,10%
1420,JEFFERSON COUNTY R-1,9432,DENNISON ELEMENTARY SCHOOL,HALF DAY K,3,3,0,3,31,40,9,23%
1420,JEFFERSON COUNTY R-1,9432,DENNISON ELEMENTARY SCHOOL,KINDERGARTEN,1,5,1,8,33,48,15,31%
1420,JEFFERSON COUNTY R-1,9432,DENNISON ELEMENTARY SCHOOL,1ST,0,4,1,17,66,88,22,25%
1420,JEFFERSON COUNTY R-1,9432,DENNISON ELEMENTARY SCHOOL,2ND,2,9,0,8,69,88,19,22%
1420,JEFFERSON COUNTY R-1,9432,DENNISON ELEMENTARY SCHOOL,3RD,4,6,2,13,67,92,25,27%
1420,JEFFERSON COUNTY R-1,9432,DENNISON ELEMENTARY SCHOOL,4TH,1,7,0,6,76,90,14,16%
1420,JEFFERSON COUNTY R-1,9432,DENNISON ELEMENTARY SCHOOL,5TH,0,6,0,11,73,90,17,19%
1420,JEFFERSON COUNTY R-1,9432,DENNISON ELEMENTARY SCHOOL,6TH,2,8,1,6,73,90,17,19%
1420,JEFFERSON COUNTY R-1,9432,DENNISON ELEMENTARY SCHOOL,SCHOOL TOTAL,13,48,5,72,488,626,138,22%
1420,JEFFERSON COUNTY R-1,9490,WESTRIDGE ELEMENTARY SCHOOL,PK,0,7,1,15,79,102,23,23%
1420,JEFFERSON COUNTY R-1,9490,WESTRIDGE ELEMENTARY SCHOOL,HALF DAY K,0,2,0,7,32,41,9,22%
1420,JEFFERSON COUNTY R-1,9490,WESTRIDGE ELEMENTARY SCHOOL,KINDERGARTEN,1,0,0,5,18,24,6,25%
1420,JEFFERSON COUNTY R-1,9490,WESTRIDGE ELEMENTARY SCHOOL,1ST,0,5,1,4,61,71,10,14%
1420,JEFFERSON COUNTY R-1,9490,WESTRIDGE ELEMENTARY SCHOOL,2ND,0,2,1,6,57,66,9,14%
1420,JEFFERSON COUNTY R-1,9490,WESTRIDGE ELEMENTARY SCHOOL,3RD,1,6,0,9,63,79,16,20%
1420,JEFFERSON COUNTY R-1,9490,WESTRIDGE ELEMENTARY SCHOOL,4TH,0,2,0,6,57,65,8,12%
1420,JEFFERSON COUNTY R-1,9490,WESTRIDGE ELEMENTARY SCHOOL,5TH,0,5,0,9,65,79,14,18%
1420,JEFFERSON COUNTY R-1,9490,WESTRIDGE ELEMENTARY SCHOOL,6TH,1,7,2,11,55,76,21,28%
1420,JEFFERSON COUNTY R-1,9490,WESTRIDGE ELEMENTARY SCHOOL,SCHOOL TOTAL,3,36,5,72,487,603,116,19%
1420,JEFFERSON COUNTY R-1,9506,WHEAT RIDGE MIDDLE SCHOOL,7TH,3,0,6,132,43,184,141,77%
1420,JEFFERSON COUNTY R-1,9506,WHEAT RIDGE MIDDLE SCHOOL,8TH,6,0,13,131,51,201,150,75%
1420,JEFFERSON COUNTY R-1,9506,WHEAT RIDGE MIDDLE SCHOOL,SCHOOL TOTAL,9,0,19,263,94,385,291,76%
1420,JEFFERSON COUNTY R-1,9510,WHEAT RIDGE HIGH SCHOOL,9TH,6,10,6,95,241,358,117,33%
1420,JEFFERSON COUNTY R-1,9510,WHEAT RIDGE HIGH SCHOOL,10TH,6,7,6,85,236,340,104,31%
1420,JEFFERSON COUNTY R-1,9510,WHEAT RIDGE HIGH SCHOOL,11TH,2,8,4,75,229,318,89,28%
1420,JEFFERSON COUNTY R-1,9510,WHEAT RIDGE HIGH SCHOOL,12TH,3,5,6,42,204,260,56,22%
1420,JEFFERSON COUNTY R-1,9510,WHEAT RIDGE HIGH SCHOOL,SCHOOL TOTAL,17,30,22,297,910,1276,366,29%
1420,JEFFERSON COUNTY R-1,9638,WILMORE DAVIS ELEMENTARY SCHOOL,KINDERGARTEN,0,3,0,18,30,51,21,41%
1420,JEFFERSON COUNTY R-1,9638,WILMORE DAVIS ELEMENTARY SCHOOL,1ST,1,0,1,17,20,39,19,49%
1420,JEFFERSON COUNTY R-1,9638,WILMORE DAVIS ELEMENTARY SCHOOL,2ND,0,0,0,16,26,42,16,38%
1420,JEFFERSON COUNTY R-1,9638,WILMORE DAVIS ELEMENTARY SCHOOL,3RD,1,0,0,11,30,42,12,29%
1420,JEFFERSON COUNTY R-1,9638,WILMORE DAVIS ELEMENTARY SCHOOL,4TH,1,1,1,12,26,41,15,37%
1420,JEFFERSON COUNTY R-1,9638,WILMORE DAVIS ELEMENTARY SCHOOL,5TH,1,1,2,15,33,52,19,37%
1420,JEFFERSON COUNTY R-1,9638,WILMORE DAVIS ELEMENTARY SCHOOL,6TH,0,0,1,16,24,41,17,41%
1420,JEFFERSON COUNTY R-1,9638,WILMORE DAVIS ELEMENTARY SCHOOL,SCHOOL TOTAL,4,5,5,105,189,308,119,39%
1420,JEFFERSON COUNTY R-1,9648,WILMOT ELEMENTARY SCHOOL,PK,0,1,2,2,70,75,5,7%
1420,JEFFERSON COUNTY R-1,9648,WILMOT ELEMENTARY SCHOOL,HALF DAY K,0,0,0,0,21,21,0,0%
1420,JEFFERSON COUNTY R-1,9648,WILMOT ELEMENTARY SCHOOL,KINDERGARTEN,1,1,0,0,39,41,2,5%
1420,JEFFERSON COUNTY R-1,9648,WILMOT ELEMENTARY SCHOOL,1ST,1,1,0,1,55,58,3,5%
1420,JEFFERSON COUNTY R-1,9648,WILMOT ELEMENTARY SCHOOL,2ND,0,1,1,1,52,55,3,5%
1420,JEFFERSON COUNTY R-1,9648,WILMOT ELEMENTARY SCHOOL,3RD,1,2,0,1,56,60,4,7%
1420,JEFFERSON COUNTY R-1,9648,WILMOT ELEMENTARY SCHOOL,4TH,1,1,0,0,62,64,2,3%
1420,JEFFERSON COUNTY R-1,9648,WILMOT ELEMENTARY SCHOOL,5TH,1,3,0,2,61,67,6,9%
1420,JEFFERSON COUNTY R-1,9648,WILMOT ELEMENTARY SCHOOL,SCHOOL TOTAL,5,10,3,7,416,441,25,6%
1420,JEFFERSON COUNTY R-1,9678,WITT ELEMENTARY SCHOOL,PK,1,0,1,6,46,54,8,15%
1420,JEFFERSON COUNTY R-1,9678,WITT ELEMENTARY SCHOOL,KINDERGARTEN,1,4,1,13,30,49,19,39%
1420,JEFFERSON COUNTY R-1,9678,WITT ELEMENTARY SCHOOL,1ST,0,1,2,10,38,51,13,25%
1420,JEFFERSON COUNTY R-1,9678,WITT ELEMENTARY SCHOOL,2ND,1,0,0,10,32,43,11,26%
1420,JEFFERSON COUNTY R-1,9678,WITT ELEMENTARY SCHOOL,3RD,1,2,0,10,39,52,13,25%
1420,JEFFERSON COUNTY R-1,9678,WITT ELEMENTARY SCHOOL,4TH,1,1,1,9,47,59,12,20%
1420,JEFFERSON COUNTY R-1,9678,WITT ELEMENTARY SCHOOL,5TH,1,1,1,6,41,50,9,18%
1420,JEFFERSON COUNTY R-1,9678,WITT ELEMENTARY SCHOOL,6TH,1,0,2,11,46,60,14,23%
1420,JEFFERSON COUNTY R-1,9678,WITT ELEMENTARY SCHOOL,SCHOOL TOTAL,7,9,8,75,319,418,99,24%
1420,JEFFERSON COUNTY R-1,9800,ZERGER ELEMENTARY SCHOOL,KINDERGARTEN,1,4,2,12,36,55,19,35%
1420,JEFFERSON COUNTY R-1,9800,ZERGER ELEMENTARY SCHOOL,1ST,0,1,2,10,26,39,13,33%
1420,JEFFERSON COUNTY R-1,9800,ZERGER ELEMENTARY SCHOOL,2ND,0,1,1,10,34,46,12,26%
1420,JEFFERSON COUNTY R-1,9800,ZERGER ELEMENTARY SCHOOL,3RD,1,1,4,8,27,41,14,34%
1420,JEFFERSON COUNTY R-1,9800,ZERGER ELEMENTARY SCHOOL,4TH,0,2,0,7,23,32,9,28%
1420,JEFFERSON COUNTY R-1,9800,ZERGER ELEMENTARY SCHOOL,5TH,0,2,0,6,28,36,8,22%
1420,JEFFERSON COUNTY R-1,9800,ZERGER ELEMENTARY SCHOOL,6TH,1,1,1,9,27,39,12,31%
1420,JEFFERSON COUNTY R-1,9800,ZERGER ELEMENTARY SCHOOL,SCHOOL TOTAL,3,12,10,62,201,288,87,30%
1420,JEFFERSON COUNTY R-1,,DISTRICT TOTAL,,1083,3392,1695,16677,63403,86250,22847,26%
1430,EADS RE-1,2328,EADS ELEMENTARY SCHOOL,PK,0,0,0,2,12,14,2,14%
1430,EADS RE-1,2328,EADS ELEMENTARY SCHOOL,KINDERGARTEN,0,0,0,1,11,12,1,8%
1430,EADS RE-1,2328,EADS ELEMENTARY SCHOOL,1ST,0,1,0,1,12,14,2,14%
1430,EADS RE-1,2328,EADS ELEMENTARY SCHOOL,2ND,1,0,0,3,8,12,4,33%
1430,EADS RE-1,2328,EADS ELEMENTARY SCHOOL,3RD,0,0,0,0,9,9,0,0%
1430,EADS RE-1,2328,EADS ELEMENTARY SCHOOL,4TH,0,0,0,2,11,13,2,15%
1430,EADS RE-1,2328,EADS ELEMENTARY SCHOOL,5TH,0,0,0,1,13,14,1,7%
1430,EADS RE-1,2328,EADS ELEMENTARY SCHOOL,SCHOOL TOTAL,1,1,0,10,76,88,12,14%
1430,EADS RE-1,2332,EADS MIDDLE SCHOOL,6TH,0,0,1,1,8,10,2,20%
1430,EADS RE-1,2332,EADS MIDDLE SCHOOL,7TH,0,0,1,1,11,13,2,15%
1430,EADS RE-1,2332,EADS MIDDLE SCHOOL,8TH,0,1,1,0,10,12,2,17%
1430,EADS RE-1,2332,EADS MIDDLE SCHOOL,SCHOOL TOTAL,0,1,3,2,29,35,6,17%
1430,EADS RE-1,2336,EADS HIGH SCHOOL,9TH,0,0,0,2,18,20,2,10%
1430,EADS RE-1,2336,EADS HIGH SCHOOL,10TH,1,0,0,3,11,15,4,27%
1430,EADS RE-1,2336,EADS HIGH SCHOOL,11TH,0,0,0,1,14,15,1,7%
1430,EADS RE-1,2336,EADS HIGH SCHOOL,12TH,0,0,0,0,16,16,0,0%
1430,EADS RE-1,2336,EADS HIGH SCHOOL,SCHOOL TOTAL,1,0,0,6,59,66,7,11%
1430,EADS RE-1,,DISTRICT TOTAL,,2,2,3,18,164,189,25,13%
1440,PLAINVIEW RE-2,6992,PLAINVIEW ELEMENTARY SCHOOL,PK,0,0,0,0,7,7,0,0%
1440,PLAINVIEW RE-2,6992,PLAINVIEW ELEMENTARY SCHOOL,KINDERGARTEN,0,0,0,0,5,5,0,0%
1440,PLAINVIEW RE-2,6992,PLAINVIEW ELEMENTARY SCHOOL,1ST,0,0,0,0,4,4,0,0%
1440,PLAINVIEW RE-2,6992,PLAINVIEW ELEMENTARY SCHOOL,2ND,0,0,0,1,9,10,1,10%
1440,PLAINVIEW RE-2,6992,PLAINVIEW ELEMENTARY SCHOOL,3RD,0,0,0,0,10,10,0,0%
1440,PLAINVIEW RE-2,6992,PLAINVIEW ELEMENTARY SCHOOL,4TH,0,0,0,0,6,6,0,0%
1440,PLAINVIEW RE-2,6992,PLAINVIEW ELEMENTARY SCHOOL,5TH,0,0,0,0,7,7,0,0%
1440,PLAINVIEW RE-2,6992,PLAINVIEW ELEMENTARY SCHOOL,SCHOOL TOTAL,0,0,0,1,48,49,1,2%
1440,PLAINVIEW RE-2,7009,PLAINVIEW JUNIOR-SENIOR HIGH SCHOOL,6TH,0,0,0,0,3,3,0,0%
1440,PLAINVIEW RE-2,7009,PLAINVIEW JUNIOR-SENIOR HIGH SCHOOL,7TH,0,0,0,1,5,6,1,17%
1440,PLAINVIEW RE-2,7009,PLAINVIEW JUNIOR-SENIOR HIGH SCHOOL,8TH,0,0,0,0,5,5,0,0%
1440,PLAINVIEW RE-2,7009,PLAINVIEW JUNIOR-SENIOR HIGH SCHOOL,9TH,0,0,0,1,3,4,1,25%
1440,PLAINVIEW RE-2,7009,PLAINVIEW JUNIOR-SENIOR HIGH SCHOOL,10TH,0,0,0,1,6,7,1,14%
1440,PLAINVIEW RE-2,7009,PLAINVIEW JUNIOR-SENIOR HIGH SCHOOL,11TH,0,0,0,0,4,4,0,0%
1440,PLAINVIEW RE-2,7009,PLAINVIEW JUNIOR-SENIOR HIGH SCHOOL,12TH,0,0,0,1,4,5,1,20%
1440,PLAINVIEW RE-2,7009,PLAINVIEW JUNIOR-SENIOR HIGH SCHOOL,SCHOOL TOTAL,0,0,0,4,30,34,4,12%
1440,PLAINVIEW RE-2,,DISTRICT TOTAL,,0,0,0,5,78,83,5,6%
1450,ARRIBA-FLAGLER C-20,2956,FLAGLER ELEMENTARY SCHOOL,PK,0,0,0,0,18,18,0,0%
1450,ARRIBA-FLAGLER C-20,2956,FLAGLER ELEMENTARY SCHOOL,KINDERGARTEN,0,0,0,0,10,10,0,0%
1450,ARRIBA-FLAGLER C-20,2956,FLAGLER ELEMENTARY SCHOOL,1ST,0,0,0,0,17,17,0,0%
1450,ARRIBA-FLAGLER C-20,2956,FLAGLER ELEMENTARY SCHOOL,2ND,0,0,0,0,8,8,0,0%
1450,ARRIBA-FLAGLER C-20,2956,FLAGLER ELEMENTARY SCHOOL,3RD,0,0,0,0,11,11,0,0%
1450,ARRIBA-FLAGLER C-20,2956,FLAGLER ELEMENTARY SCHOOL,4TH,0,0,0,0,11,11,0,0%
1450,ARRIBA-FLAGLER C-20,2956,FLAGLER ELEMENTARY SCHOOL,5TH,0,2,0,0,10,12,2,17%
1450,ARRIBA-FLAGLER C-20,2956,FLAGLER ELEMENTARY SCHOOL,6TH,0,2,0,1,14,17,3,18%
1450,ARRIBA-FLAGLER C-20,2956,FLAGLER ELEMENTARY SCHOOL,SCHOOL TOTAL,0,4,0,1,99,104,5,5%
1450,ARRIBA-FLAGLER C-20,2958,FLAGLER MIDDLE SCHOOL,7TH,0,0,0,0,7,7,0,0%
1450,ARRIBA-FLAGLER C-20,2958,FLAGLER MIDDLE SCHOOL,8TH,0,0,1,0,5,6,1,17%
1450,ARRIBA-FLAGLER C-20,2958,FLAGLER MIDDLE SCHOOL,SCHOOL TOTAL,0,0,1,0,12,13,1,8%
1450,ARRIBA-FLAGLER C-20,2960,FLAGLER SENIOR HIGH SCHOOL,9TH,0,0,0,0,8,8,0,0%
1450,ARRIBA-FLAGLER C-20,2960,FLAGLER SENIOR HIGH SCHOOL,10TH,0,0,0,0,12,12,0,0%
1450,ARRIBA-FLAGLER C-20,2960,FLAGLER SENIOR HIGH SCHOOL,11TH,0,0,0,1,14,15,1,7%
1450,ARRIBA-FLAGLER C-20,2960,FLAGLER SENIOR HIGH SCHOOL,12TH,0,0,0,1,12,13,1,8%
1450,ARRIBA-FLAGLER C-20,2960,FLAGLER SENIOR HIGH SCHOOL,SCHOOL TOTAL,0,0,0,2,46,48,2,4%
1450,ARRIBA-FLAGLER C-20,,DISTRICT TOTAL,,0,4,1,3,157,165,8,5%
1460,HI-PLAINS R-23,7746,HI PLAINS UNDIVIDED HIGH SCHOOL,7TH,0,0,0,2,8,10,2,20%
1460,HI-PLAINS R-23,7746,HI PLAINS UNDIVIDED HIGH SCHOOL,8TH,0,0,0,0,11,11,0,0%
1460,HI-PLAINS R-23,7746,HI PLAINS UNDIVIDED HIGH SCHOOL,9TH,0,0,0,1,13,14,1,7%
1460,HI-PLAINS R-23,7746,HI PLAINS UNDIVIDED HIGH SCHOOL,10TH,0,0,0,0,6,6,0,0%
1460,HI-PLAINS R-23,7746,HI PLAINS UNDIVIDED HIGH SCHOOL,11TH,0,0,0,3,10,13,3,23%
1460,HI-PLAINS R-23,7746,HI PLAINS UNDIVIDED HIGH SCHOOL,12TH,0,0,0,2,12,14,2,14%
1460,HI-PLAINS R-23,7746,HI PLAINS UNDIVIDED HIGH SCHOOL,SCHOOL TOTAL,0,0,0,8,60,68,8,12%
1460,HI-PLAINS R-23,9164,HI PLAINS ELEMENTARY SCHOOL,PK,0,0,0,2,7,9,2,22%
1460,HI-PLAINS R-23,9164,HI PLAINS ELEMENTARY SCHOOL,KINDERGARTEN,0,0,1,1,4,6,2,33%
1460,HI-PLAINS R-23,9164,HI PLAINS ELEMENTARY SCHOOL,1ST,0,0,1,0,6,7,1,14%
1460,HI-PLAINS R-23,9164,HI PLAINS ELEMENTARY SCHOOL,2ND,0,0,0,0,1,1,0,0%
1460,HI-PLAINS R-23,9164,HI PLAINS ELEMENTARY SCHOOL,3RD,0,1,0,1,3,5,2,40%
1460,HI-PLAINS R-23,9164,HI PLAINS ELEMENTARY SCHOOL,4TH,0,0,0,1,5,6,1,17%
1460,HI-PLAINS R-23,9164,HI PLAINS ELEMENTARY SCHOOL,5TH,0,1,1,0,9,11,2,18%
1460,HI-PLAINS R-23,9164,HI PLAINS ELEMENTARY SCHOOL,6TH,0,0,0,2,7,9,2,22%
1460,HI-PLAINS R-23,9164,HI PLAINS ELEMENTARY SCHOOL,SCHOOL TOTAL,0,2,3,7,42,54,12,22%
1460,HI-PLAINS R-23,,DISTRICT TOTAL,,0,2,3,15,102,122,20,16%
1480,STRATTON R-4,8342,STRATTON ELEMENTARY SCHOOL,PK,0,1,0,4,30,35,5,14%
1480,STRATTON R-4,8342,STRATTON ELEMENTARY SCHOOL,KINDERGARTEN,0,1,0,1,10,12,2,17%
1480,STRATTON R-4,8342,STRATTON ELEMENTARY SCHOOL,1ST,2,0,0,2,6,10,4,40%
1480,STRATTON R-4,8342,STRATTON ELEMENTARY SCHOOL,2ND,0,1,0,2,5,8,3,38%
1480,STRATTON R-4,8342,STRATTON ELEMENTARY SCHOOL,3RD,0,0,0,2,20,22,2,9%
1480,STRATTON R-4,8342,STRATTON ELEMENTARY SCHOOL,4TH,0,0,0,2,7,9,2,22%
1480,STRATTON R-4,8342,STRATTON ELEMENTARY SCHOOL,5TH,0,0,0,3,11,14,3,21%
1480,STRATTON R-4,8342,STRATTON ELEMENTARY SCHOOL,SCHOOL TOTAL,2,3,0,16,89,110,21,19%
1480,STRATTON R-4,8351,STRATTON MIDDLE SCHOOL,6TH,0,0,0,2,8,10,2,20%
1480,STRATTON R-4,8351,STRATTON MIDDLE SCHOOL,7TH,0,0,0,3,11,14,3,21%
1480,STRATTON R-4,8351,STRATTON MIDDLE SCHOOL,8TH,0,0,0,1,13,14,1,7%
1480,STRATTON R-4,8351,STRATTON MIDDLE SCHOOL,SCHOOL TOTAL,0,0,0,6,32,38,6,16%
1480,STRATTON R-4,8354,STRATTON SENIOR HIGH SCHOOL,9TH,0,0,0,3,8,11,3,27%
1480,STRATTON R-4,8354,STRATTON SENIOR HIGH SCHOOL,10TH,0,0,0,4,10,14,4,29%
1480,STRATTON R-4,8354,STRATTON SENIOR HIGH SCHOOL,11TH,0,0,0,3,18,21,3,14%
1480,STRATTON R-4,8354,STRATTON SENIOR HIGH SCHOOL,12TH,0,0,0,0,15,15,0,0%
1480,STRATTON R-4,8354,STRATTON SENIOR HIGH SCHOOL,SCHOOL TOTAL,0,0,0,10,51,61,10,16%
1480,STRATTON R-4,,DISTRICT TOTAL,,2,3,0,32,172,209,37,18%
1490,BETHUNE R-5,0832,BETHUNE ELEMENTARY SCHOOL,PK,0,0,0,2,2,4,2,50%
1490,BETHUNE R-5,0832,BETHUNE ELEMENTARY SCHOOL,KINDERGARTEN,0,0,0,3,5,8,3,38%
1490,BETHUNE R-5,0832,BETHUNE ELEMENTARY SCHOOL,1ST,0,0,0,2,5,7,2,29%
1490,BETHUNE R-5,0832,BETHUNE ELEMENTARY SCHOOL,2ND,0,0,0,6,7,13,6,46%
1490,BETHUNE R-5,0832,BETHUNE ELEMENTARY SCHOOL,3RD,0,0,0,4,4,8,4,50%
1490,BETHUNE R-5,0832,BETHUNE ELEMENTARY SCHOOL,4TH,0,0,0,2,4,6,2,33%
1490,BETHUNE R-5,0832,BETHUNE ELEMENTARY SCHOOL,5TH,0,1,0,3,5,9,4,44%
1490,BETHUNE R-5,0832,BETHUNE ELEMENTARY SCHOOL,6TH,0,0,0,5,4,9,5,56%
1490,BETHUNE R-5,0832,BETHUNE ELEMENTARY SCHOOL,SCHOOL TOTAL,0,1,0,27,36,64,28,44%
1490,BETHUNE R-5,0842,BETHUNE JUNIOR-SENIOR HIGH SCHOOL,7TH,0,0,0,4,5,9,4,44%
1490,BETHUNE R-5,0842,BETHUNE JUNIOR-SENIOR HIGH SCHOOL,8TH,0,0,0,3,10,13,3,23%
1490,BETHUNE R-5,0842,BETHUNE JUNIOR-SENIOR HIGH SCHOOL,9TH,0,0,0,0,8,8,0,0%
1490,BETHUNE R-5,0842,BETHUNE JUNIOR-SENIOR HIGH SCHOOL,10TH,0,0,0,3,6,9,3,33%
1490,BETHUNE R-5,0842,BETHUNE JUNIOR-SENIOR HIGH SCHOOL,11TH,0,0,0,2,8,10,2,20%
1490,BETHUNE R-5,0842,BETHUNE JUNIOR-SENIOR HIGH SCHOOL,12TH,0,0,0,4,9,13,4,31%
1490,BETHUNE R-5,0842,BETHUNE JUNIOR-SENIOR HIGH SCHOOL,SCHOOL TOTAL,0,0,0,16,46,62,16,26%
1490,BETHUNE R-5,,DISTRICT TOTAL,,0,1,0,43,82,126,44,35%
1500,BURLINGTON RE-6J,1144,BURLINGTON ELEMENTARY SCHOOL,PK,0,0,4,46,38,88,50,57%
1500,BURLINGTON RE-6J,1144,BURLINGTON ELEMENTARY SCHOOL,KINDERGARTEN,0,1,1,17,39,58,19,33%
1500,BURLINGTON RE-6J,1144,BURLINGTON ELEMENTARY SCHOOL,1ST,1,0,0,16,27,44,17,39%
1500,BURLINGTON RE-6J,1144,BURLINGTON ELEMENTARY SCHOOL,2ND,1,1,0,22,22,46,24,52%
1500,BURLINGTON RE-6J,1144,BURLINGTON ELEMENTARY SCHOOL,3RD,0,0,0,22,37,59,22,37%
1500,BURLINGTON RE-6J,1144,BURLINGTON ELEMENTARY SCHOOL,4TH,1,0,0,31,40,72,32,44%
1500,BURLINGTON RE-6J,1144,BURLINGTON ELEMENTARY SCHOOL,SCHOOL TOTAL,3,2,5,154,203,367,164,45%
1500,BURLINGTON RE-6J,1150,BURLINGTON MIDDLE SCHOOL,5TH,1,0,1,16,39,57,18,32%
1500,BURLINGTON RE-6J,1150,BURLINGTON MIDDLE SCHOOL,6TH,0,0,1,11,38,50,12,24%
1500,BURLINGTON RE-6J,1150,BURLINGTON MIDDLE SCHOOL,7TH,0,0,0,20,35,55,20,36%
1500,BURLINGTON RE-6J,1150,BURLINGTON MIDDLE SCHOOL,8TH,0,0,0,17,39,56,17,30%
1500,BURLINGTON RE-6J,1150,BURLINGTON MIDDLE SCHOOL,SCHOOL TOTAL,1,0,2,64,151,218,67,31%
1500,BURLINGTON RE-6J,1152,BURLINGTON HIGH SCHOOL,9TH,0,1,2,18,34,55,21,38%
1500,BURLINGTON RE-6J,1152,BURLINGTON HIGH SCHOOL,10TH,1,0,0,22,39,62,23,37%
1500,BURLINGTON RE-6J,1152,BURLINGTON HIGH SCHOOL,11TH,0,1,0,22,46,69,23,33%
1500,BURLINGTON RE-6J,1152,BURLINGTON HIGH SCHOOL,12TH,1,0,1,14,32,48,16,33%
1500,BURLINGTON RE-6J,1152,BURLINGTON HIGH SCHOOL,SCHOOL TOTAL,2,2,3,76,151,234,83,35%
1500,BURLINGTON RE-6J,,DISTRICT TOTAL,,6,4,10,294,505,819,314,38%
1510,LAKE COUNTY R-1,4901,LAKE COUNTY MIDDLE SCHOOL,5TH,0,1,1,66,18,86,68,79%
1510,LAKE COUNTY R-1,4901,LAKE COUNTY MIDDLE SCHOOL,6TH,2,0,0,65,21,88,67,76%
1510,LAKE COUNTY R-1,4901,LAKE COUNTY MIDDLE SCHOOL,7TH,0,0,0,50,28,78,50,64%
1510,LAKE COUNTY R-1,4901,LAKE COUNTY MIDDLE SCHOOL,8TH,1,0,0,57,26,84,58,69%
1510,LAKE COUNTY R-1,4901,LAKE COUNTY MIDDLE SCHOOL,SCHOOL TOTAL,3,1,1,238,93,336,243,72%
1510,LAKE COUNTY R-1,4904,LAKE COUNTY HIGH SCHOOL,9TH,0,0,0,48,22,70,48,69%
1510,LAKE COUNTY R-1,4904,LAKE COUNTY HIGH SCHOOL,10TH,1,0,0,36,25,62,37,60%
1510,LAKE COUNTY R-1,4904,LAKE COUNTY HIGH SCHOOL,11TH,0,0,0,50,26,76,50,66%
1510,LAKE COUNTY R-1,4904,LAKE COUNTY HIGH SCHOOL,12TH,0,1,0,53,25,79,54,68%
1510,LAKE COUNTY R-1,4904,LAKE COUNTY HIGH SCHOOL,SCHOOL TOTAL,1,1,0,187,98,287,189,66%
1510,LAKE COUNTY R-1,8804,PITTS ELEMENTARY SCHOOL,PK,0,1,1,78,49,129,80,62%
1510,LAKE COUNTY R-1,8804,PITTS ELEMENTARY SCHOOL,KINDERGARTEN,0,0,0,61,34,95,61,64%
1510,LAKE COUNTY R-1,8804,PITTS ELEMENTARY SCHOOL,SCHOOL TOTAL,0,1,1,139,83,224,141,63%
1510,LAKE COUNTY R-1,9486,WESTPARK ELEMENTARY SCHOOL,1ST,0,0,0,59,30,89,59,66%
1510,LAKE COUNTY R-1,9486,WESTPARK ELEMENTARY SCHOOL,2ND,0,0,0,73,31,104,73,70%
1510,LAKE COUNTY R-1,9486,WESTPARK ELEMENTARY SCHOOL,3RD,1,0,0,73,19,93,74,80%
1510,LAKE COUNTY R-1,9486,WESTPARK ELEMENTARY SCHOOL,4TH,1,0,0,48,26,75,49,65%
1510,LAKE COUNTY R-1,9486,WESTPARK ELEMENTARY SCHOOL,SCHOOL TOTAL,2,0,0,253,106,361,255,71%
1510,LAKE COUNTY R-1,,DISTRICT TOTAL,,6,3,2,817,380,1208,828,69%
1520,DURANGO 9-R,0225,ANIMAS VALLEY ELEMENTARY SCHOOL,PK,0,0,0,7,8,15,7,47%
1520,DURANGO 9-R,0225,ANIMAS VALLEY ELEMENTARY SCHOOL,KINDERGARTEN,4,0,1,6,33,44,11,25%
1520,DURANGO 9-R,0225,ANIMAS VALLEY ELEMENTARY SCHOOL,1ST,2,1,2,8,30,43,13,30%
1520,DURANGO 9-R,0225,ANIMAS VALLEY ELEMENTARY SCHOOL,2ND,3,0,0,3,32,38,6,16%
1520,DURANGO 9-R,0225,ANIMAS VALLEY ELEMENTARY SCHOOL,3RD,2,0,0,2,44,48,4,8%
1520,DURANGO 9-R,0225,ANIMAS VALLEY ELEMENTARY SCHOOL,4TH,2,0,2,5,32,41,9,22%
1520,DURANGO 9-R,0225,ANIMAS VALLEY ELEMENTARY SCHOOL,5TH,1,0,0,8,39,48,9,19%
1520,DURANGO 9-R,0225,ANIMAS VALLEY ELEMENTARY SCHOOL,SCHOOL TOTAL,14,1,5,39,218,277,59,21%
1520,DURANGO 9-R,2318,DURANGO HIGH SCHOOL,9TH,21,3,2,47,246,319,73,23%
1520,DURANGO 9-R,2318,DURANGO HIGH SCHOOL,10TH,12,6,4,46,273,341,68,20%
1520,DURANGO 9-R,2318,DURANGO HIGH SCHOOL,11TH,21,2,3,56,284,366,82,22%
1520,DURANGO 9-R,2318,DURANGO HIGH SCHOOL,12TH,19,8,1,44,295,367,72,20%
1520,DURANGO 9-R,2318,DURANGO HIGH SCHOOL,SCHOOL TOTAL,73,19,10,193,1098,1393,295,21%
1520,DURANGO 9-R,3012,FLORIDA MESA ELEMENTARY SCHOOL,PK,3,0,1,3,8,15,7,47%
1520,DURANGO 9-R,3012,FLORIDA MESA ELEMENTARY SCHOOL,KINDERGARTEN,3,3,1,11,27,45,18,40%
1520,DURANGO 9-R,3012,FLORIDA MESA ELEMENTARY SCHOOL,1ST,2,0,0,14,46,62,16,26%
1520,DURANGO 9-R,3012,FLORIDA MESA ELEMENTARY SCHOOL,2ND,3,1,0,5,42,51,9,18%
1520,DURANGO 9-R,3012,FLORIDA MESA ELEMENTARY SCHOOL,3RD,6,1,1,9,29,46,17,37%
1520,DURANGO 9-R,3012,FLORIDA MESA ELEMENTARY SCHOOL,4TH,5,0,0,11,28,44,16,36%
1520,DURANGO 9-R,3012,FLORIDA MESA ELEMENTARY SCHOOL,5TH,2,0,1,7,40,50,10,20%
1520,DURANGO 9-R,3012,FLORIDA MESA ELEMENTARY SCHOOL,SCHOOL TOTAL,24,5,4,60,220,313,93,30%
1520,DURANGO 9-R,3050,FORT LEWIS MESA ELEMENTARY SCHOOL,PK,0,0,0,0,16,16,0,0%
1520,DURANGO 9-R,3050,FORT LEWIS MESA ELEMENTARY SCHOOL,KINDERGARTEN,0,0,0,1,14,15,1,7%
1520,DURANGO 9-R,3050,FORT LEWIS MESA ELEMENTARY SCHOOL,1ST,1,0,0,0,26,27,1,4%
1520,DURANGO 9-R,3050,FORT LEWIS MESA ELEMENTARY SCHOOL,2ND,0,0,0,0,23,23,0,0%
1520,DURANGO 9-R,3050,FORT LEWIS MESA ELEMENTARY SCHOOL,3RD,1,0,0,0,24,25,1,4%
1520,DURANGO 9-R,3050,FORT LEWIS MESA ELEMENTARY SCHOOL,4TH,0,0,0,1,21,22,1,5%
1520,DURANGO 9-R,3050,FORT LEWIS MESA ELEMENTARY SCHOOL,5TH,2,0,0,7,29,38,9,24%
1520,DURANGO 9-R,3050,FORT LEWIS MESA ELEMENTARY SCHOOL,SCHOOL TOTAL,4,0,0,9,153,166,13,8%
1520,DURANGO 9-R,5888,MILLER MIDDLE SCHOOL,6TH,6,1,2,27,130,166,36,22%
1520,DURANGO 9-R,5888,MILLER MIDDLE SCHOOL,7TH,6,2,3,12,139,162,23,14%
1520,DURANGO 9-R,5888,MILLER MIDDLE SCHOOL,8TH,9,5,2,21,132,169,37,22%
1520,DURANGO 9-R,5888,MILLER MIDDLE SCHOOL,SCHOOL TOTAL,21,8,7,60,401,497,96,19%
1520,DURANGO 9-R,6222,NEEDHAM ELEMENTARY SCHOOL,PK,2,0,0,5,8,15,7,47%
1520,DURANGO 9-R,6222,NEEDHAM ELEMENTARY SCHOOL,KINDERGARTEN,3,2,0,11,59,75,16,21%
1520,DURANGO 9-R,6222,NEEDHAM ELEMENTARY SCHOOL,1ST,4,2,0,8,64,78,14,18%
1520,DURANGO 9-R,6222,NEEDHAM ELEMENTARY SCHOOL,2ND,3,1,0,9,64,77,13,17%
1520,DURANGO 9-R,6222,NEEDHAM ELEMENTARY SCHOOL,3RD,5,1,0,8,55,69,14,20%
1520,DURANGO 9-R,6222,NEEDHAM ELEMENTARY SCHOOL,4TH,2,0,0,5,46,53,7,13%
1520,DURANGO 9-R,6222,NEEDHAM ELEMENTARY SCHOOL,5TH,10,1,2,8,59,80,21,26%
1520,DURANGO 9-R,6222,NEEDHAM ELEMENTARY SCHOOL,SCHOOL TOTAL,29,7,2,54,355,447,92,21%
1520,DURANGO 9-R,6738,PARK ELEMENTARY SCHOOL,PK,5,0,0,12,11,28,17,61%
1520,DURANGO 9-R,6738,PARK ELEMENTARY SCHOOL,KINDERGARTEN,6,3,2,14,38,63,25,40%
1520,DURANGO 9-R,6738,PARK ELEMENTARY SCHOOL,1ST,8,3,2,18,45,76,31,41%
1520,DURANGO 9-R,6738,PARK ELEMENTARY SCHOOL,2ND,3,2,1,12,44,62,18,29%
1520,DURANGO 9-R,6738,PARK ELEMENTARY SCHOOL,3RD,10,3,1,22,44,80,36,45%
1520,DURANGO 9-R,6738,PARK ELEMENTARY SCHOOL,4TH,12,1,0,16,42,71,29,41%
1520,DURANGO 9-R,6738,PARK ELEMENTARY SCHOOL,5TH,6,1,2,7,40,56,16,29%
1520,DURANGO 9-R,6738,PARK ELEMENTARY SCHOOL,SCHOOL TOTAL,50,13,8,101,264,436,172,39%
1520,DURANGO 9-R,7402,RIVERVIEW ELEMENTARY SCHOOL,PK,1,0,0,1,13,15,2,13%
1520,DURANGO 9-R,7402,RIVERVIEW ELEMENTARY SCHOOL,KINDERGARTEN,2,1,1,4,60,68,8,12%
1520,DURANGO 9-R,7402,RIVERVIEW ELEMENTARY SCHOOL,1ST,5,0,1,12,64,82,18,22%
1520,DURANGO 9-R,7402,RIVERVIEW ELEMENTARY SCHOOL,2ND,4,1,0,8,77,90,13,14%
1520,DURANGO 9-R,7402,RIVERVIEW ELEMENTARY SCHOOL,3RD,4,2,0,3,62,71,9,13%
1520,DURANGO 9-R,7402,RIVERVIEW ELEMENTARY SCHOOL,4TH,1,1,1,11,58,72,14,19%
1520,DURANGO 9-R,7402,RIVERVIEW ELEMENTARY SCHOOL,5TH,4,0,1,7,76,88,12,14%
1520,DURANGO 9-R,7402,RIVERVIEW ELEMENTARY SCHOOL,SCHOOL TOTAL,21,5,4,46,410,486,76,16%
1520,DURANGO 9-R,7994,ESCALANTE MIDDLE SCHOOL,6TH,12,2,4,30,138,186,48,26%
1520,DURANGO 9-R,7994,ESCALANTE MIDDLE SCHOOL,7TH,5,5,5,35,124,174,50,29%
1520,DURANGO 9-R,7994,ESCALANTE MIDDLE SCHOOL,8TH,13,4,5,30,127,179,52,29%
1520,DURANGO 9-R,7994,ESCALANTE MIDDLE SCHOOL,SCHOOL TOTAL,30,11,14,95,389,539,150,28%
1520,DURANGO 9-R,8388,SUNNYSIDE ELEMENTARY SCHOOL,PK,0,0,0,4,10,14,4,29%
1520,DURANGO 9-R,8388,SUNNYSIDE ELEMENTARY SCHOOL,KINDERGARTEN,0,0,0,2,14,16,2,13%
1520,DURANGO 9-R,8388,SUNNYSIDE ELEMENTARY SCHOOL,1ST,1,0,0,6,17,24,7,29%
1520,DURANGO 9-R,8388,SUNNYSIDE ELEMENTARY SCHOOL,2ND,1,0,0,4,16,21,5,24%
1520,DURANGO 9-R,8388,SUNNYSIDE ELEMENTARY SCHOOL,3RD,1,0,0,5,16,22,6,27%
1520,DURANGO 9-R,8388,SUNNYSIDE ELEMENTARY SCHOOL,4TH,1,0,0,5,22,28,6,21%
1520,DURANGO 9-R,8388,SUNNYSIDE ELEMENTARY SCHOOL,5TH,0,0,0,1,17,18,1,6%
1520,DURANGO 9-R,8388,SUNNYSIDE ELEMENTARY SCHOOL,SCHOOL TOTAL,4,0,0,27,112,143,31,22%
1520,DURANGO 9-R,,DISTRICT TOTAL,,270,69,54,684,3620,4697,1077,23%
1530,BAYFIELD 10 JT-R,0632,BAYFIELD ELEMENTARY SCHOOL,PK,0,0,1,5,16,22,6,27%
1530,BAYFIELD 10 JT-R,0632,BAYFIELD ELEMENTARY SCHOOL,KINDERGARTEN,6,0,1,7,104,118,14,12%
1530,BAYFIELD 10 JT-R,0632,BAYFIELD ELEMENTARY SCHOOL,1ST,4,0,0,4,102,110,8,7%
1530,BAYFIELD 10 JT-R,0632,BAYFIELD ELEMENTARY SCHOOL,2ND,4,0,0,8,81,93,12,13%
1530,BAYFIELD 10 JT-R,0632,BAYFIELD ELEMENTARY SCHOOL,3RD,3,0,0,15,96,114,18,16%
1530,BAYFIELD 10 JT-R,0632,BAYFIELD ELEMENTARY SCHOOL,4TH,7,0,0,7,92,106,14,13%
1530,BAYFIELD 10 JT-R,0632,BAYFIELD ELEMENTARY SCHOOL,5TH,9,0,0,13,80,102,22,22%
1530,BAYFIELD 10 JT-R,0632,BAYFIELD ELEMENTARY SCHOOL,SCHOOL TOTAL,33,0,2,59,571,665,94,14%
1530,BAYFIELD 10 JT-R,0636,BAYFIELD MIDDLE SCHOOL,6TH,8,1,0,9,89,107,18,17%
1530,BAYFIELD 10 JT-R,0636,BAYFIELD MIDDLE SCHOOL,7TH,7,2,1,10,84,104,20,19%
1530,BAYFIELD 10 JT-R,0636,BAYFIELD MIDDLE SCHOOL,8TH,6,2,1,6,77,92,15,16%
1530,BAYFIELD 10 JT-R,0636,BAYFIELD MIDDLE SCHOOL,SCHOOL TOTAL,21,5,2,25,250,303,53,17%
1530,BAYFIELD 10 JT-R,0640,BAYFIELD HIGH SCHOOL,9TH,7,1,1,7,117,133,16,12%
1530,BAYFIELD 10 JT-R,0640,BAYFIELD HIGH SCHOOL,10TH,7,0,0,6,80,93,13,14%
1530,BAYFIELD 10 JT-R,0640,BAYFIELD HIGH SCHOOL,11TH,8,1,1,6,95,111,16,14%
1530,BAYFIELD 10 JT-R,0640,BAYFIELD HIGH SCHOOL,12TH,4,2,1,8,86,101,15,15%
1530,BAYFIELD 10 JT-R,0640,BAYFIELD HIGH SCHOOL,SCHOOL TOTAL,26,4,3,27,378,438,60,14%
1530,BAYFIELD 10 JT-R,,DISTRICT TOTAL,,80,9,7,111,1199,1406,207,15%
1540,IGNACIO 11 JT,4179,IGNACIO ACADEMY,9TH,2,0,0,1,2,5,3,60%
1540,IGNACIO 11 JT,4179,IGNACIO ACADEMY,10TH,1,0,0,0,2,3,1,33%
1540,IGNACIO 11 JT,4179,IGNACIO ACADEMY,11TH,0,0,0,2,2,4,2,50%
1540,IGNACIO 11 JT,4179,IGNACIO ACADEMY,12TH,1,0,0,0,1,2,1,50%
1540,IGNACIO 11 JT,4179,IGNACIO ACADEMY,SCHOOL TOTAL,4,0,0,3,7,14,7,50%
1540,IGNACIO 11 JT,4250,IGNACIO ELEMENTARY SCHOOL,KINDERGARTEN,27,0,0,13,20,60,40,67%
1540,IGNACIO 11 JT,4250,IGNACIO ELEMENTARY SCHOOL,1ST,29,1,0,16,23,69,46,67%
1540,IGNACIO 11 JT,4250,IGNACIO ELEMENTARY SCHOOL,2ND,19,0,1,12,27,59,32,54%
1540,IGNACIO 11 JT,4250,IGNACIO ELEMENTARY SCHOOL,3RD,22,0,0,14,25,61,36,59%
1540,IGNACIO 11 JT,4250,IGNACIO ELEMENTARY SCHOOL,SCHOOL TOTAL,97,1,1,55,95,249,154,62%
1540,IGNACIO 11 JT,4252,IGNACIO INTERMEDIATE SCHOOL,4TH,25,0,1,19,22,67,45,67%
1540,IGNACIO 11 JT,4252,IGNACIO INTERMEDIATE SCHOOL,5TH,19,0,0,18,19,56,37,66%
1540,IGNACIO 11 JT,4252,IGNACIO INTERMEDIATE SCHOOL,6TH,18,1,1,8,22,50,28,56%
1540,IGNACIO 11 JT,4252,IGNACIO INTERMEDIATE SCHOOL,SCHOOL TOTAL,62,1,2,45,63,173,110,64%
1540,IGNACIO 11 JT,4254,IGNACIO JUNIOR HIGH SCHOOL,7TH,25,0,1,4,26,56,30,54%
1540,IGNACIO 11 JT,4254,IGNACIO JUNIOR HIGH SCHOOL,8TH,23,0,2,7,20,52,32,62%
1540,IGNACIO 11 JT,4254,IGNACIO JUNIOR HIGH SCHOOL,SCHOOL TOTAL,48,0,3,11,46,108,62,57%
1540,IGNACIO 11 JT,4258,IGNACIO HIGH SCHOOL,9TH,46,0,1,11,25,83,58,70%
1540,IGNACIO 11 JT,4258,IGNACIO HIGH SCHOOL,10TH,29,0,1,13,19,62,43,69%
1540,IGNACIO 11 JT,4258,IGNACIO HIGH SCHOOL,11TH,21,0,0,8,23,52,29,56%
1540,IGNACIO 11 JT,4258,IGNACIO HIGH SCHOOL,12TH,22,0,1,11,22,56,34,61%
1540,IGNACIO 11 JT,4258,IGNACIO HIGH SCHOOL,SCHOOL TOTAL,118,0,3,43,89,253,164,65%
1540,IGNACIO 11 JT,,DISTRICT TOTAL,,329,2,9,157,300,797,497,62%
1550,POUDRE R-1,0146,RIDGEVIEW CLASSICAL CHARTER SCHOOLS,HALF DAY K,0,2,0,7,51,60,9,15%
1550,POUDRE R-1,0146,RIDGEVIEW CLASSICAL CHARTER SCHOOLS,1ST,0,2,4,8,49,63,14,22%
1550,POUDRE R-1,0146,RIDGEVIEW CLASSICAL CHARTER SCHOOLS,2ND,0,5,4,6,45,60,15,25%
1550,POUDRE R-1,0146,RIDGEVIEW CLASSICAL CHARTER SCHOOLS,3RD,1,3,2,3,52,61,9,15%
1550,POUDRE R-1,0146,RIDGEVIEW CLASSICAL CHARTER SCHOOLS,4TH,2,3,2,5,48,60,12,20%
1550,POUDRE R-1,0146,RIDGEVIEW CLASSICAL CHARTER SCHOOLS,5TH,0,5,1,3,51,60,9,15%
1550,POUDRE R-1,0146,RIDGEVIEW CLASSICAL CHARTER SCHOOLS,6TH,1,2,2,3,52,60,8,13%
1550,POUDRE R-1,0146,RIDGEVIEW CLASSICAL CHARTER SCHOOLS,7TH,0,8,5,2,58,73,15,21%
1550,POUDRE R-1,0146,RIDGEVIEW CLASSICAL CHARTER SCHOOLS,8TH,1,5,0,1,53,60,7,12%
1550,POUDRE R-1,0146,RIDGEVIEW CLASSICAL CHARTER SCHOOLS,9TH,0,6,4,5,50,65,15,23%
1550,POUDRE R-1,0146,RIDGEVIEW CLASSICAL CHARTER SCHOOLS,10TH,0,5,2,5,50,62,12,19%
1550,POUDRE R-1,0146,RIDGEVIEW CLASSICAL CHARTER SCHOOLS,11TH,0,1,0,5,48,54,6,11%
1550,POUDRE R-1,0146,RIDGEVIEW CLASSICAL CHARTER SCHOOLS,12TH,0,2,2,2,43,49,6,12%
1550,POUDRE R-1,0146,RIDGEVIEW CLASSICAL CHARTER SCHOOLS,SCHOOL TOTAL,5,49,28,55,650,787,137,17%
1550,POUDRE R-1,0477,ZACH ELEMENTARY SCHOOL,HALF DAY K,1,2,0,4,37,44,7,16%
1550,POUDRE R-1,0477,ZACH ELEMENTARY SCHOOL,KINDERGARTEN,0,5,0,2,56,63,7,11%
1550,POUDRE R-1,0477,ZACH ELEMENTARY SCHOOL,1ST,0,2,0,4,75,81,6,7%
1550,POUDRE R-1,0477,ZACH ELEMENTARY SCHOOL,2ND,0,6,1,4,83,94,11,12%
1550,POUDRE R-1,0477,ZACH ELEMENTARY SCHOOL,3RD,0,9,1,1,100,111,11,10%
1550,POUDRE R-1,0477,ZACH ELEMENTARY SCHOOL,4TH,0,6,3,4,95,108,13,12%
1550,POUDRE R-1,0477,ZACH ELEMENTARY SCHOOL,5TH,0,5,2,6,95,108,13,12%
1550,POUDRE R-1,0477,ZACH ELEMENTARY SCHOOL,SCHOOL TOTAL,1,35,7,25,541,609,68,11%
1550,POUDRE R-1,0490,BACON ELEMENTARY SCHOOL,PK,2,9,2,5,29,47,18,38%
1550,POUDRE R-1,0490,BACON ELEMENTARY SCHOOL,HALF DAY K,0,0,0,2,20,22,2,9%
1550,POUDRE R-1,0490,BACON ELEMENTARY SCHOOL,KINDERGARTEN,1,4,0,4,55,64,9,14%
1550,POUDRE R-1,0490,BACON ELEMENTARY SCHOOL,1ST,0,1,1,2,66,70,4,6%
1550,POUDRE R-1,0490,BACON ELEMENTARY SCHOOL,2ND,0,4,2,1,71,78,7,9%
1550,POUDRE R-1,0490,BACON ELEMENTARY SCHOOL,3RD,1,3,1,4,67,76,9,12%
1550,POUDRE R-1,0490,BACON ELEMENTARY SCHOOL,4TH,1,1,2,3,52,59,7,12%
1550,POUDRE R-1,0490,BACON ELEMENTARY SCHOOL,5TH,0,4,2,4,54,64,10,16%
1550,POUDRE R-1,0490,BACON ELEMENTARY SCHOOL,SCHOOL TOTAL,5,26,10,25,414,480,66,14%
1550,POUDRE R-1,0498,BETHKE ELEMENTARY SCHOOL,HALF DAY K,0,0,0,3,14,17,3,18%
1550,POUDRE R-1,0498,BETHKE ELEMENTARY SCHOOL,KINDERGARTEN,0,3,0,1,39,43,4,9%
1550,POUDRE R-1,0498,BETHKE ELEMENTARY SCHOOL,1ST,0,4,0,4,52,60,8,13%
1550,POUDRE R-1,0498,BETHKE ELEMENTARY SCHOOL,2ND,0,2,0,1,54,57,3,5%
1550,POUDRE R-1,0498,BETHKE ELEMENTARY SCHOOL,3RD,0,4,0,2,45,51,6,12%
1550,POUDRE R-1,0498,BETHKE ELEMENTARY SCHOOL,4TH,1,2,0,0,46,49,3,6%
1550,POUDRE R-1,0498,BETHKE ELEMENTARY SCHOOL,5TH,0,2,0,4,40,46,6,13%
1550,POUDRE R-1,0498,BETHKE ELEMENTARY SCHOOL,SCHOOL TOTAL,1,17,0,15,290,323,33,10%
1550,POUDRE R-1,0550,BARTON PREKINDERGARTEN,PK,3,12,6,108,156,285,129,45%
1550,POUDRE R-1,0550,BARTON PREKINDERGARTEN,SCHOOL TOTAL,3,12,6,108,156,285,129,45%
1550,POUDRE R-1,0612,BAUDER ELEMENTARY SCHOOL,PK,2,1,1,12,31,47,16,34%
1550,POUDRE R-1,0612,BAUDER ELEMENTARY SCHOOL,HALF DAY K,1,0,1,3,18,23,5,22%
1550,POUDRE R-1,0612,BAUDER ELEMENTARY SCHOOL,KINDERGARTEN,0,1,2,8,25,36,11,31%
1550,POUDRE R-1,0612,BAUDER ELEMENTARY SCHOOL,1ST,0,0,0,10,45,55,10,18%
1550,POUDRE R-1,0612,BAUDER ELEMENTARY SCHOOL,2ND,0,1,3,9,45,58,13,22%
1550,POUDRE R-1,0612,BAUDER ELEMENTARY SCHOOL,3RD,1,0,4,6,43,54,11,20%
1550,POUDRE R-1,0612,BAUDER ELEMENTARY SCHOOL,4TH,1,2,3,8,33,47,14,30%
1550,POUDRE R-1,0612,BAUDER ELEMENTARY SCHOOL,5TH,1,1,2,9,36,49,13,27%
1550,POUDRE R-1,0612,BAUDER ELEMENTARY SCHOOL,SCHOOL TOTAL,6,6,16,65,276,369,93,25%
1550,POUDRE R-1,0678,BEATTIE ELEMENTARY SCHOOL,PK,0,1,3,6,12,22,10,45%
1550,POUDRE R-1,0678,BEATTIE ELEMENTARY SCHOOL,HALF DAY K,0,0,0,2,21,23,2,9%
1550,POUDRE R-1,0678,BEATTIE ELEMENTARY SCHOOL,KINDERGARTEN,2,2,1,3,24,32,8,25%
1550,POUDRE R-1,0678,BEATTIE ELEMENTARY SCHOOL,1ST,0,0,2,8,36,46,10,22%
1550,POUDRE R-1,0678,BEATTIE ELEMENTARY SCHOOL,2ND,1,3,1,9,26,40,14,35%
1550,POUDRE R-1,0678,BEATTIE ELEMENTARY SCHOOL,3RD,0,1,3,6,40,50,10,20%
1550,POUDRE R-1,0678,BEATTIE ELEMENTARY SCHOOL,4TH,2,3,0,8,40,53,13,25%
1550,POUDRE R-1,0678,BEATTIE ELEMENTARY SCHOOL,5TH,0,5,2,7,31,45,14,31%
1550,POUDRE R-1,0678,BEATTIE ELEMENTARY SCHOOL,SCHOOL TOTAL,5,15,12,49,230,311,81,26%
1550,POUDRE R-1,0766,BENNETT ELEMENTARY SCHOOL,HALF DAY K,0,3,1,4,16,24,8,33%
1550,POUDRE R-1,0766,BENNETT ELEMENTARY SCHOOL,KINDERGARTEN,1,5,3,9,51,69,18,26%
1550,POUDRE R-1,0766,BENNETT ELEMENTARY SCHOOL,1ST,0,8,4,5,55,72,17,24%
1550,POUDRE R-1,0766,BENNETT ELEMENTARY SCHOOL,2ND,0,6,2,7,58,73,15,21%
1550,POUDRE R-1,0766,BENNETT ELEMENTARY SCHOOL,3RD,0,3,3,8,56,70,14,20%
1550,POUDRE R-1,0766,BENNETT ELEMENTARY SCHOOL,4TH,1,6,4,6,55,72,17,24%
1550,POUDRE R-1,0766,BENNETT ELEMENTARY SCHOOL,5TH,0,5,3,8,58,74,16,22%
1550,POUDRE R-1,0766,BENNETT ELEMENTARY SCHOOL,SCHOOL TOTAL,2,36,20,47,349,454,105,23%
1550,POUDRE R-1,0892,BLEVINS MIDDLE SCHOOL,6TH,2,3,9,26,142,182,40,22%
1550,POUDRE R-1,0892,BLEVINS MIDDLE SCHOOL,7TH,3,8,6,35,140,192,52,27%
1550,POUDRE R-1,0892,BLEVINS MIDDLE SCHOOL,8TH,3,3,9,32,130,177,47,27%
1550,POUDRE R-1,0892,BLEVINS MIDDLE SCHOOL,SCHOOL TOTAL,8,14,24,93,412,551,139,25%
1550,POUDRE R-1,0898,BOLTZ MIDDLE SCHOOL,6TH,2,7,3,34,178,224,46,21%
1550,POUDRE R-1,0898,BOLTZ MIDDLE SCHOOL,7TH,4,10,1,31,143,189,46,24%
1550,POUDRE R-1,0898,BOLTZ MIDDLE SCHOOL,8TH,4,5,6,44,169,228,59,26%
1550,POUDRE R-1,0898,BOLTZ MIDDLE SCHOOL,SCHOOL TOTAL,10,22,10,109,490,641,151,24%
1550,POUDRE R-1,1186,CACHE LA POUDRE ELEMENTARY SCHOOL,PK,0,0,0,6,19,25,6,24%
1550,POUDRE R-1,1186,CACHE LA POUDRE ELEMENTARY SCHOOL,HALF DAY K,0,0,0,0,19,19,0,0%
1550,POUDRE R-1,1186,CACHE LA POUDRE ELEMENTARY SCHOOL,KINDERGARTEN,1,1,0,6,28,36,8,22%
1550,POUDRE R-1,1186,CACHE LA POUDRE ELEMENTARY SCHOOL,1ST,2,0,0,4,45,51,6,12%
1550,POUDRE R-1,1186,CACHE LA POUDRE ELEMENTARY SCHOOL,2ND,0,0,0,4,36,40,4,10%
1550,POUDRE R-1,1186,CACHE LA POUDRE ELEMENTARY SCHOOL,3RD,0,0,0,9,41,50,9,18%
1550,POUDRE R-1,1186,CACHE LA POUDRE ELEMENTARY SCHOOL,4TH,1,0,1,1,41,44,3,7%
1550,POUDRE R-1,1186,CACHE LA POUDRE ELEMENTARY SCHOOL,5TH,1,0,0,5,50,56,6,11%
1550,POUDRE R-1,1186,CACHE LA POUDRE ELEMENTARY SCHOOL,SCHOOL TOTAL,5,1,1,35,279,321,42,13%
1550,POUDRE R-1,1190,CACHE LA POUDRE MIDDLE SCHOOL,6TH,1,4,0,9,106,120,14,12%
1550,POUDRE R-1,1190,CACHE LA POUDRE MIDDLE SCHOOL,7TH,1,1,2,19,106,129,23,18%
1550,POUDRE R-1,1190,CACHE LA POUDRE MIDDLE SCHOOL,8TH,3,2,1,5,105,116,11,9%
1550,POUDRE R-1,1190,CACHE LA POUDRE MIDDLE SCHOOL,SCHOOL TOTAL,5,7,3,33,317,365,48,13%
1550,POUDRE R-1,2298,DUNN ELEMENTARY SCHOOL,HALF DAY K,0,3,0,3,12,18,6,33%
1550,POUDRE R-1,2298,DUNN ELEMENTARY SCHOOL,KINDERGARTEN,0,10,5,3,30,48,18,38%
1550,POUDRE R-1,2298,DUNN ELEMENTARY SCHOOL,1ST,0,10,3,10,42,65,23,35%
1550,POUDRE R-1,2298,DUNN ELEMENTARY SCHOOL,2ND,0,9,1,11,53,74,21,28%
1550,POUDRE R-1,2298,DUNN ELEMENTARY SCHOOL,3RD,0,8,2,9,51,70,19,27%
1550,POUDRE R-1,2298,DUNN ELEMENTARY SCHOOL,4TH,0,9,1,11,47,68,21,31%
1550,POUDRE R-1,2298,DUNN ELEMENTARY SCHOOL,5TH,0,9,2,2,55,68,13,19%
1550,POUDRE R-1,2298,DUNN ELEMENTARY SCHOOL,SCHOOL TOTAL,0,58,14,49,290,411,121,29%
1550,POUDRE R-1,3046,FORT COLLINS HIGH SCHOOL,9TH,3,14,15,103,317,452,135,30%
1550,POUDRE R-1,3046,FORT COLLINS HIGH SCHOOL,10TH,7,18,17,100,356,498,142,29%
1550,POUDRE R-1,3046,FORT COLLINS HIGH SCHOOL,11TH,2,8,12,91,288,401,113,28%
1550,POUDRE R-1,3046,FORT COLLINS HIGH SCHOOL,12TH,4,15,7,60,290,376,86,23%
1550,POUDRE R-1,3046,FORT COLLINS HIGH SCHOOL,SCHOOL TOTAL,16,55,51,354,1251,1727,476,28%
1550,POUDRE R-1,3105,FOSSIL RIDGE HIGH SCHOOL,9TH,4,15,7,40,440,506,66,13%
1550,POUDRE R-1,3105,FOSSIL RIDGE HIGH SCHOOL,10TH,4,10,1,25,357,397,40,10%
1550,POUDRE R-1,3105,FOSSIL RIDGE HIGH SCHOOL,11TH,3,14,7,33,402,459,57,12%
1550,POUDRE R-1,3105,FOSSIL RIDGE HIGH SCHOOL,12TH,1,12,4,31,337,385,48,12%
1550,POUDRE R-1,3105,FOSSIL RIDGE HIGH SCHOOL,SCHOOL TOTAL,12,51,19,129,1536,1747,211,12%
1550,POUDRE R-1,3760,CENTENNIAL HIGH SCHOOL,10TH,0,0,0,4,12,16,4,25%
1550,POUDRE R-1,3760,CENTENNIAL HIGH SCHOOL,11TH,1,0,1,13,38,53,15,28%
1550,POUDRE R-1,3760,CENTENNIAL HIGH SCHOOL,12TH,0,2,1,20,55,78,23,29%
1550,POUDRE R-1,3760,CENTENNIAL HIGH SCHOOL,SCHOOL TOTAL,1,2,2,37,105,147,42,29%
1550,POUDRE R-1,3787,HARRIS BILINGUAL ELEMENTARY SCHOOL,PK,0,0,0,26,0,26,26,100%
1550,POUDRE R-1,3787,HARRIS BILINGUAL ELEMENTARY SCHOOL,KINDERGARTEN,0,0,1,36,15,52,37,71%
1550,POUDRE R-1,3787,HARRIS BILINGUAL ELEMENTARY SCHOOL,1ST,1,1,0,36,14,52,38,73%
1550,POUDRE R-1,3787,HARRIS BILINGUAL ELEMENTARY SCHOOL,2ND,0,0,0,32,19,51,32,63%
1550,POUDRE R-1,3787,HARRIS BILINGUAL ELEMENTARY SCHOOL,3RD,0,0,1,33,17,51,34,67%
1550,POUDRE R-1,3787,HARRIS BILINGUAL ELEMENTARY SCHOOL,4TH,0,0,0,31,17,48,31,65%
1550,POUDRE R-1,3787,HARRIS BILINGUAL ELEMENTARY SCHOOL,5TH,0,0,1,28,17,46,29,63%
1550,POUDRE R-1,3787,HARRIS BILINGUAL ELEMENTARY SCHOOL,SCHOOL TOTAL,1,1,3,222,99,326,227,70%
1550,POUDRE R-1,3791,LAB ELEMENTARY SCHOOL FOR CREATIVE LEARNING,HALF DAY K,0,0,1,1,12,14,2,14%
1550,POUDRE R-1,3791,LAB ELEMENTARY SCHOOL FOR CREATIVE LEARNING,1ST,0,0,0,0,15,15,0,0%
1550,POUDRE R-1,3791,LAB ELEMENTARY SCHOOL FOR CREATIVE LEARNING,2ND,0,1,0,0,17,18,1,6%
1550,POUDRE R-1,3791,LAB ELEMENTARY SCHOOL FOR CREATIVE LEARNING,3RD,0,0,0,2,13,15,2,13%
1550,POUDRE R-1,3791,LAB ELEMENTARY SCHOOL FOR CREATIVE LEARNING,4TH,0,0,0,1,17,18,1,6%
1550,POUDRE R-1,3791,LAB ELEMENTARY SCHOOL FOR CREATIVE LEARNING,5TH,0,0,0,2,17,19,2,11%
1550,POUDRE R-1,3791,LAB ELEMENTARY SCHOOL FOR CREATIVE LEARNING,6TH,0,0,0,0,14,14,0,0%
1550,POUDRE R-1,3791,LAB ELEMENTARY SCHOOL FOR CREATIVE LEARNING,SCHOOL TOTAL,0,1,1,6,105,113,8,7%
1550,POUDRE R-1,4282,IRISH ELEMENTARY SCHOOL,PK,2,2,2,55,17,78,61,78%
1550,POUDRE R-1,4282,IRISH ELEMENTARY SCHOOL,KINDERGARTEN,1,1,0,56,14,72,58,81%
1550,POUDRE R-1,4282,IRISH ELEMENTARY SCHOOL,1ST,1,0,3,45,17,66,49,74%
1550,POUDRE R-1,4282,IRISH ELEMENTARY SCHOOL,2ND,0,0,1,41,20,62,42,68%
1550,POUDRE R-1,4282,IRISH ELEMENTARY SCHOOL,3RD,1,0,2,33,8,44,36,82%
1550,POUDRE R-1,4282,IRISH ELEMENTARY SCHOOL,4TH,1,0,1,35,13,50,37,74%
1550,POUDRE R-1,4282,IRISH ELEMENTARY SCHOOL,5TH,4,0,2,30,7,43,36,84%
1550,POUDRE R-1,4282,IRISH ELEMENTARY SCHOOL,SCHOOL TOTAL,10,3,11,295,96,415,319,77%
1550,POUDRE R-1,4456,JOHNSON ELEMENTARY SCHOOL,HALF DAY K,0,2,0,7,31,40,9,23%
1550,POUDRE R-1,4456,JOHNSON ELEMENTARY SCHOOL,KINDERGARTEN,1,1,1,12,31,46,15,33%
1550,POUDRE R-1,4456,JOHNSON ELEMENTARY SCHOOL,1ST,1,4,1,17,49,72,23,32%
1550,POUDRE R-1,4456,JOHNSON ELEMENTARY SCHOOL,2ND,0,4,1,9,64,78,14,18%
1550,POUDRE R-1,4456,JOHNSON ELEMENTARY SCHOOL,3RD,3,5,0,18,54,80,26,33%
1550,POUDRE R-1,4456,JOHNSON ELEMENTARY SCHOOL,4TH,0,1,1,14,62,78,16,21%
1550,POUDRE R-1,4456,JOHNSON ELEMENTARY SCHOOL,5TH,3,2,1,12,68,86,18,21%
1550,POUDRE R-1,4456,JOHNSON ELEMENTARY SCHOOL,SCHOOL TOTAL,8,19,5,89,359,480,121,25%
1550,POUDRE R-1,4698,KINARD CORE KNOWLEDGE MIDDLE SCHOOL,6TH,1,29,4,7,222,263,41,16%
1550,POUDRE R-1,4698,KINARD CORE KNOWLEDGE MIDDLE SCHOOL,7TH,1,23,1,7,243,275,32,12%
1550,POUDRE R-1,4698,KINARD CORE KNOWLEDGE MIDDLE SCHOOL,8TH,2,16,3,13,228,262,34,13%
1550,POUDRE R-1,4698,KINARD CORE KNOWLEDGE MIDDLE SCHOOL,SCHOOL TOTAL,4,68,8,27,693,800,107,13%
1550,POUDRE R-1,4793,KRUSE ELEMENTARY SCHOOL,HALF DAY K,0,1,1,0,23,25,2,8%
1550,POUDRE R-1,4793,KRUSE ELEMENTARY SCHOOL,KINDERGARTEN,0,2,1,2,53,58,5,9%
1550,POUDRE R-1,4793,KRUSE ELEMENTARY SCHOOL,1ST,1,4,0,6,65,76,11,14%
1550,POUDRE R-1,4793,KRUSE ELEMENTARY SCHOOL,2ND,1,5,3,2,60,71,11,15%
1550,POUDRE R-1,4793,KRUSE ELEMENTARY SCHOOL,3RD,0,3,3,5,75,86,11,13%
1550,POUDRE R-1,4793,KRUSE ELEMENTARY SCHOOL,4TH,1,5,2,5,64,77,13,17%
1550,POUDRE R-1,4793,KRUSE ELEMENTARY SCHOOL,5TH,0,2,1,11,61,75,14,19%
1550,POUDRE R-1,4793,KRUSE ELEMENTARY SCHOOL,SCHOOL TOTAL,3,22,11,31,401,468,67,14%
1550,POUDRE R-1,5014,LAUREL ELEMENTARY SCHOOL,KINDERGARTEN,0,3,5,23,51,82,31,38%
1550,POUDRE R-1,5014,LAUREL ELEMENTARY SCHOOL,1ST,0,3,3,27,38,71,33,46%
1550,POUDRE R-1,5014,LAUREL ELEMENTARY SCHOOL,2ND,0,1,6,26,30,63,33,52%
1550,POUDRE R-1,5014,LAUREL ELEMENTARY SCHOOL,3RD,0,0,4,23,24,51,27,53%
1550,POUDRE R-1,5014,LAUREL ELEMENTARY SCHOOL,4TH,0,1,2,20,19,42,23,55%
1550,POUDRE R-1,5014,LAUREL ELEMENTARY SCHOOL,5TH,0,2,1,21,22,46,24,52%
1550,POUDRE R-1,5014,LAUREL ELEMENTARY SCHOOL,SCHOOL TOTAL,0,10,21,140,184,355,171,48%
1550,POUDRE R-1,5068,LESHER MIDDLE SCHOOL,6TH,1,11,8,60,136,216,80,37%
1550,POUDRE R-1,5068,LESHER MIDDLE SCHOOL,7TH,4,11,7,44,162,228,66,29%
1550,POUDRE R-1,5068,LESHER MIDDLE SCHOOL,8TH,5,9,3,48,158,223,65,29%
1550,POUDRE R-1,5068,LESHER MIDDLE SCHOOL,SCHOOL TOTAL,10,31,18,152,456,667,211,32%
1550,POUDRE R-1,5120,LIBERTY COMMON CHARTER SCHOOL,HALF DAY K,0,2,0,1,35,38,3,8%
1550,POUDRE R-1,5120,LIBERTY COMMON CHARTER SCHOOL,KINDERGARTEN,0,3,0,0,14,17,3,18%
1550,POUDRE R-1,5120,LIBERTY COMMON CHARTER SCHOOL,1ST,0,5,0,5,52,62,10,16%
1550,POUDRE R-1,5120,LIBERTY COMMON CHARTER SCHOOL,2ND,0,3,0,5,50,58,8,14%
1550,POUDRE R-1,5120,LIBERTY COMMON CHARTER SCHOOL,3RD,0,0,2,1,55,58,3,5%
1550,POUDRE R-1,5120,LIBERTY COMMON CHARTER SCHOOL,4TH,2,7,0,1,48,58,10,17%
1550,POUDRE R-1,5120,LIBERTY COMMON CHARTER SCHOOL,5TH,0,3,1,4,52,60,8,13%
1550,POUDRE R-1,5120,LIBERTY COMMON CHARTER SCHOOL,6TH,0,9,2,5,62,78,16,21%
1550,POUDRE R-1,5120,LIBERTY COMMON CHARTER SCHOOL,7TH,0,3,0,2,57,62,5,8%
1550,POUDRE R-1,5120,LIBERTY COMMON CHARTER SCHOOL,8TH,0,8,2,1,47,58,11,19%
1550,POUDRE R-1,5120,LIBERTY COMMON CHARTER SCHOOL,9TH,1,0,0,1,33,35,2,6%
1550,POUDRE R-1,5120,LIBERTY COMMON CHARTER SCHOOL,SCHOOL TOTAL,3,43,7,26,505,584,79,14%
1550,POUDRE R-1,5168,LINCOLN MIDDLE SCHOOL,6TH,3,4,5,81,63,156,93,60%
1550,POUDRE R-1,5168,LINCOLN MIDDLE SCHOOL,7TH,5,3,1,68,59,136,77,57%
1550,POUDRE R-1,5168,LINCOLN MIDDLE SCHOOL,8TH,2,6,3,70,65,146,81,55%
1550,POUDRE R-1,5168,LINCOLN MIDDLE SCHOOL,SCHOOL TOTAL,10,13,9,219,187,438,251,57%
1550,POUDRE R-1,5196,LINTON ELEMENTARY SCHOOL,PK,0,0,1,19,11,31,20,65%
1550,POUDRE R-1,5196,LINTON ELEMENTARY SCHOOL,HALF DAY K,0,3,1,1,19,24,5,21%
1550,POUDRE R-1,5196,LINTON ELEMENTARY SCHOOL,KINDERGARTEN,0,0,0,21,19,40,21,53%
1550,POUDRE R-1,5196,LINTON ELEMENTARY SCHOOL,1ST,0,1,0,29,45,75,30,40%
1550,POUDRE R-1,5196,LINTON ELEMENTARY SCHOOL,2ND,0,1,1,11,63,76,13,17%
1550,POUDRE R-1,5196,LINTON ELEMENTARY SCHOOL,3RD,0,0,2,16,48,66,18,27%
1550,POUDRE R-1,5196,LINTON ELEMENTARY SCHOOL,4TH,1,3,1,14,53,72,19,26%
1550,POUDRE R-1,5196,LINTON ELEMENTARY SCHOOL,5TH,0,0,1,17,45,63,18,29%
1550,POUDRE R-1,5196,LINTON ELEMENTARY SCHOOL,SCHOOL TOTAL,1,8,7,128,303,447,144,32%
1550,POUDRE R-1,5234,LIVERMORE ELEMENTARY SCHOOL,KINDERGARTEN,0,0,0,0,3,3,0,0%
1550,POUDRE R-1,5234,LIVERMORE ELEMENTARY SCHOOL,1ST,1,0,0,0,8,9,1,11%
1550,POUDRE R-1,5234,LIVERMORE ELEMENTARY SCHOOL,2ND,1,1,0,0,7,9,2,22%
1550,POUDRE R-1,5234,LIVERMORE ELEMENTARY SCHOOL,3RD,0,0,0,0,3,3,0,0%
1550,POUDRE R-1,5234,LIVERMORE ELEMENTARY SCHOOL,4TH,0,0,0,0,13,13,0,0%
1550,POUDRE R-1,5234,LIVERMORE ELEMENTARY SCHOOL,5TH,0,1,0,0,6,7,1,14%
1550,POUDRE R-1,5234,LIVERMORE ELEMENTARY SCHOOL,SCHOOL TOTAL,2,2,0,0,40,44,4,9%
1550,POUDRE R-1,5292,LOPEZ ELEMENTARY SCHOOL,HALF DAY K,0,1,0,3,20,24,4,17%
1550,POUDRE R-1,5292,LOPEZ ELEMENTARY SCHOOL,KINDERGARTEN,0,2,3,8,27,40,13,33%
1550,POUDRE R-1,5292,LOPEZ ELEMENTARY SCHOOL,1ST,2,1,4,4,48,59,11,19%
1550,POUDRE R-1,5292,LOPEZ ELEMENTARY SCHOOL,2ND,1,1,1,5,45,53,8,15%
1550,POUDRE R-1,5292,LOPEZ ELEMENTARY SCHOOL,3RD,0,5,7,4,53,69,16,23%
1550,POUDRE R-1,5292,LOPEZ ELEMENTARY SCHOOL,4TH,0,4,3,13,51,71,20,28%
1550,POUDRE R-1,5292,LOPEZ ELEMENTARY SCHOOL,5TH,0,1,0,4,50,55,5,9%
1550,POUDRE R-1,5292,LOPEZ ELEMENTARY SCHOOL,SCHOOL TOTAL,3,15,18,41,294,371,77,21%
1550,POUDRE R-1,5688,MCGRAW ELEMENTARY SCHOOL,PK,0,2,1,6,13,22,9,41%
1550,POUDRE R-1,5688,MCGRAW ELEMENTARY SCHOOL,KINDERGARTEN,0,3,0,8,76,87,11,13%
1550,POUDRE R-1,5688,MCGRAW ELEMENTARY SCHOOL,1ST,0,4,0,3,79,86,7,8%
1550,POUDRE R-1,5688,MCGRAW ELEMENTARY SCHOOL,2ND,1,4,1,4,58,68,10,15%
1550,POUDRE R-1,5688,MCGRAW ELEMENTARY SCHOOL,3RD,1,2,0,3,60,66,6,9%
1550,POUDRE R-1,5688,MCGRAW ELEMENTARY SCHOOL,4TH,0,4,2,6,67,79,12,15%
1550,POUDRE R-1,5688,MCGRAW ELEMENTARY SCHOOL,5TH,2,2,0,5,67,76,9,12%
1550,POUDRE R-1,5688,MCGRAW ELEMENTARY SCHOOL,SCHOOL TOTAL,4,21,4,35,420,484,64,13%
1550,POUDRE R-1,6078,MOORE ELEMENTARY SCHOOL,PK,2,6,3,13,30,54,24,44%
1550,POUDRE R-1,6078,MOORE ELEMENTARY SCHOOL,KINDERGARTEN,0,4,3,6,20,33,13,39%
1550,POUDRE R-1,6078,MOORE ELEMENTARY SCHOOL,1ST,0,1,1,8,33,43,10,23%
1550,POUDRE R-1,6078,MOORE ELEMENTARY SCHOOL,2ND,1,1,3,10,13,28,15,54%
1550,POUDRE R-1,6078,MOORE ELEMENTARY SCHOOL,3RD,0,3,1,16,18,38,20,53%
1550,POUDRE R-1,6078,MOORE ELEMENTARY SCHOOL,4TH,2,4,1,12,29,48,19,40%
1550,POUDRE R-1,6078,MOORE ELEMENTARY SCHOOL,5TH,1,1,4,9,18,33,15,45%
1550,POUDRE R-1,6078,MOORE ELEMENTARY SCHOOL,SCHOOL TOTAL,6,20,16,74,161,277,116,42%
1550,POUDRE R-1,6476,O'DEA ELEMENTARY SCHOOL,PK,0,0,0,4,17,21,4,19%
1550,POUDRE R-1,6476,O'DEA ELEMENTARY SCHOOL,HALF DAY K,0,1,1,5,21,28,7,25%
1550,POUDRE R-1,6476,O'DEA ELEMENTARY SCHOOL,KINDERGARTEN,0,0,0,5,17,22,5,23%
1550,POUDRE R-1,6476,O'DEA ELEMENTARY SCHOOL,1ST,0,0,2,9,45,56,11,20%
1550,POUDRE R-1,6476,O'DEA ELEMENTARY SCHOOL,2ND,1,4,4,8,44,61,17,28%
1550,POUDRE R-1,6476,O'DEA ELEMENTARY SCHOOL,3RD,1,0,4,9,39,53,14,26%
1550,POUDRE R-1,6476,O'DEA ELEMENTARY SCHOOL,4TH,1,1,1,13,39,55,16,29%
1550,POUDRE R-1,6476,O'DEA ELEMENTARY SCHOOL,5TH,1,1,3,11,36,52,16,31%
1550,POUDRE R-1,6476,O'DEA ELEMENTARY SCHOOL,SCHOOL TOTAL,4,7,15,64,258,348,90,26%
1550,POUDRE R-1,6482,OLANDER ELEMENTARY SCHOOL,PK,1,0,0,13,16,30,14,47%
1550,POUDRE R-1,6482,OLANDER ELEMENTARY SCHOOL,HALF DAY K,0,0,1,6,22,29,7,24%
1550,POUDRE R-1,6482,OLANDER ELEMENTARY SCHOOL,KINDERGARTEN,0,1,0,5,40,46,6,13%
1550,POUDRE R-1,6482,OLANDER ELEMENTARY SCHOOL,1ST,0,0,0,12,49,61,12,20%
1550,POUDRE R-1,6482,OLANDER ELEMENTARY SCHOOL,2ND,0,5,1,3,49,58,9,16%
1550,POUDRE R-1,6482,OLANDER ELEMENTARY SCHOOL,3RD,1,1,0,6,49,57,8,14%
1550,POUDRE R-1,6482,OLANDER ELEMENTARY SCHOOL,4TH,0,1,0,8,40,49,9,18%
1550,POUDRE R-1,6482,OLANDER ELEMENTARY SCHOOL,5TH,1,1,1,3,42,48,6,13%
1550,POUDRE R-1,6482,OLANDER ELEMENTARY SCHOOL,SCHOOL TOTAL,3,9,3,56,307,378,71,19%
1550,POUDRE R-1,7104,POLARIS EXPEDITIONARY LEARNING SCHOOL,6TH,0,1,0,3,18,22,4,18%
1550,POUDRE R-1,7104,POLARIS EXPEDITIONARY LEARNING SCHOOL,7TH,0,0,0,2,21,23,2,9%
1550,POUDRE R-1,7104,POLARIS EXPEDITIONARY LEARNING SCHOOL,8TH,0,0,0,4,31,35,4,11%
1550,POUDRE R-1,7104,POLARIS EXPEDITIONARY LEARNING SCHOOL,9TH,0,0,0,4,29,33,4,12%
1550,POUDRE R-1,7104,POLARIS EXPEDITIONARY LEARNING SCHOOL,10TH,0,0,0,2,33,35,2,6%
1550,POUDRE R-1,7104,POLARIS EXPEDITIONARY LEARNING SCHOOL,11TH,1,2,0,8,28,39,11,28%
1550,POUDRE R-1,7104,POLARIS EXPEDITIONARY LEARNING SCHOOL,12TH,2,0,0,2,17,21,4,19%
1550,POUDRE R-1,7104,POLARIS EXPEDITIONARY LEARNING SCHOOL,SCHOOL TOTAL,3,3,0,25,177,208,31,15%
1550,POUDRE R-1,7124,POUDRE HIGH SCHOOL,9TH,6,23,6,96,365,496,131,26%
1550,POUDRE R-1,7124,POUDRE HIGH SCHOOL,10TH,8,17,9,115,374,523,149,28%
1550,POUDRE R-1,7124,POUDRE HIGH SCHOOL,11TH,4,13,7,79,356,459,103,22%
1550,POUDRE R-1,7124,POUDRE HIGH SCHOOL,12TH,6,16,15,74,319,430,111,26%
1550,POUDRE R-1,7124,POUDRE HIGH SCHOOL,SCHOOL TOTAL,24,69,37,364,1414,1908,494,26%
1550,POUDRE R-1,7127,POUDRE TRANSITION CENTER,9TH,0,0,1,6,2,9,7,78%
1550,POUDRE R-1,7127,POUDRE TRANSITION CENTER,10TH,0,0,1,4,10,15,5,33%
1550,POUDRE R-1,7127,POUDRE TRANSITION CENTER,11TH,0,0,0,5,6,11,5,45%
1550,POUDRE R-1,7127,POUDRE TRANSITION CENTER,12TH,0,0,1,4,3,8,5,63%
1550,POUDRE R-1,7127,POUDRE TRANSITION CENTER,SCHOOL TOTAL,0,0,3,19,21,43,22,51%
1550,POUDRE R-1,7161,PRESTON MIDDLE SCHOOL,6TH,0,7,3,16,231,257,26,10%
1550,POUDRE R-1,7161,PRESTON MIDDLE SCHOOL,7TH,2,4,5,12,197,220,23,10%
1550,POUDRE R-1,7161,PRESTON MIDDLE SCHOOL,8TH,1,5,6,21,236,269,33,12%
1550,POUDRE R-1,7161,PRESTON MIDDLE SCHOOL,SCHOOL TOTAL,3,16,14,49,664,746,82,11%
1550,POUDRE R-1,7198,PSD ONLINE ACADEMY,6TH,0,0,0,0,1,1,0,0%
1550,POUDRE R-1,7198,PSD ONLINE ACADEMY,7TH,0,0,0,0,1,1,0,0%
1550,POUDRE R-1,7198,PSD ONLINE ACADEMY,8TH,0,0,0,1,5,6,1,17%
1550,POUDRE R-1,7198,PSD ONLINE ACADEMY,9TH,1,0,0,0,5,6,1,17%
1550,POUDRE R-1,7198,PSD ONLINE ACADEMY,10TH,1,0,0,1,10,12,2,17%
1550,POUDRE R-1,7198,PSD ONLINE ACADEMY,11TH,0,0,0,2,7,9,2,22%
1550,POUDRE R-1,7198,PSD ONLINE ACADEMY,12TH,0,0,0,3,4,7,3,43%
1550,POUDRE R-1,7198,PSD ONLINE ACADEMY,SCHOOL TOTAL,2,0,0,7,33,42,9,21%
1550,POUDRE R-1,7218,PUTNAM ELEMENTARY SCHOOL,PK,0,0,0,16,11,27,16,59%
1550,POUDRE R-1,7218,PUTNAM ELEMENTARY SCHOOL,KINDERGARTEN,1,0,2,24,23,50,27,54%
1550,POUDRE R-1,7218,PUTNAM ELEMENTARY SCHOOL,1ST,0,0,2,28,25,55,30,55%
1550,POUDRE R-1,7218,PUTNAM ELEMENTARY SCHOOL,2ND,2,2,1,28,24,57,33,58%
1550,POUDRE R-1,7218,PUTNAM ELEMENTARY SCHOOL,3RD,0,0,1,37,22,60,38,63%
1550,POUDRE R-1,7218,PUTNAM ELEMENTARY SCHOOL,4TH,1,3,0,32,22,58,36,62%
1550,POUDRE R-1,7218,PUTNAM ELEMENTARY SCHOOL,5TH,0,1,0,21,20,42,22,52%
1550,POUDRE R-1,7218,PUTNAM ELEMENTARY SCHOOL,SCHOOL TOTAL,4,6,6,186,147,349,202,58%
1550,POUDRE R-1,7290,RED FEATHER LAKES ELEMENTARY SCHOOL,HALF DAY K,0,0,0,0,6,6,0,0%
1550,POUDRE R-1,7290,RED FEATHER LAKES ELEMENTARY SCHOOL,1ST,0,0,0,0,3,3,0,0%
1550,POUDRE R-1,7290,RED FEATHER LAKES ELEMENTARY SCHOOL,2ND,0,0,0,0,6,6,0,0%
1550,POUDRE R-1,7290,RED FEATHER LAKES ELEMENTARY SCHOOL,3RD,0,0,0,0,6,6,0,0%
1550,POUDRE R-1,7290,RED FEATHER LAKES ELEMENTARY SCHOOL,4TH,0,0,1,1,2,4,2,50%
1550,POUDRE R-1,7290,RED FEATHER LAKES ELEMENTARY SCHOOL,5TH,0,0,2,0,8,10,2,20%
1550,POUDRE R-1,7290,RED FEATHER LAKES ELEMENTARY SCHOOL,SCHOOL TOTAL,0,0,3,1,31,35,4,11%
1550,POUDRE R-1,7325,RICE ELEMENTARY SCHOOL,PK,1,0,1,6,36,44,8,18%
1550,POUDRE R-1,7325,RICE ELEMENTARY SCHOOL,HALF DAY K,1,0,1,2,25,29,4,14%
1550,POUDRE R-1,7325,RICE ELEMENTARY SCHOOL,KINDERGARTEN,0,0,2,11,25,38,13,34%
1550,POUDRE R-1,7325,RICE ELEMENTARY SCHOOL,1ST,0,0,2,9,44,55,11,20%
1550,POUDRE R-1,7325,RICE ELEMENTARY SCHOOL,2ND,0,0,0,8,61,69,8,12%
1550,POUDRE R-1,7325,RICE ELEMENTARY SCHOOL,3RD,0,0,0,4,46,50,4,8%
1550,POUDRE R-1,7325,RICE ELEMENTARY SCHOOL,4TH,1,0,2,9,36,48,12,25%
1550,POUDRE R-1,7325,RICE ELEMENTARY SCHOOL,5TH,1,0,0,6,33,40,7,18%
1550,POUDRE R-1,7325,RICE ELEMENTARY SCHOOL,SCHOOL TOTAL,4,0,8,55,306,373,67,18%
1550,POUDRE R-1,7350,RIFFENBURGH ELEMENTARY SCHOOL,HALF DAY K,1,1,1,2,24,29,5,17%
1550,POUDRE R-1,7350,RIFFENBURGH ELEMENTARY SCHOOL,KINDERGARTEN,1,2,1,3,14,21,7,33%
1550,POUDRE R-1,7350,RIFFENBURGH ELEMENTARY SCHOOL,1ST,0,1,3,3,39,46,7,15%
1550,POUDRE R-1,7350,RIFFENBURGH ELEMENTARY SCHOOL,2ND,2,1,1,3,36,43,7,16%
1550,POUDRE R-1,7350,RIFFENBURGH ELEMENTARY SCHOOL,3RD,2,2,1,5,45,55,10,18%
1550,POUDRE R-1,7350,RIFFENBURGH ELEMENTARY SCHOOL,4TH,0,2,2,3,45,52,7,13%
1550,POUDRE R-1,7350,RIFFENBURGH ELEMENTARY SCHOOL,5TH,0,1,1,8,34,44,10,23%
1550,POUDRE R-1,7350,RIFFENBURGH ELEMENTARY SCHOOL,SCHOOL TOTAL,6,10,10,27,237,290,53,18%
1550,POUDRE R-1,7470,ROCKY MOUNTAIN HIGH SCHOOL,9TH,9,6,17,63,389,484,95,20%
1550,POUDRE R-1,7470,ROCKY MOUNTAIN HIGH SCHOOL,10TH,9,13,14,68,422,526,104,20%
1550,POUDRE R-1,7470,ROCKY MOUNTAIN HIGH SCHOOL,11TH,3,5,13,72,419,512,93,18%
1550,POUDRE R-1,7470,ROCKY MOUNTAIN HIGH SCHOOL,12TH,7,13,14,55,511,600,89,15%
1550,POUDRE R-1,7470,ROCKY MOUNTAIN HIGH SCHOOL,SCHOOL TOTAL,28,37,58,258,1741,2122,381,18%
1550,POUDRE R-1,7834,SHEPARDSON ELEMENTARY SCHOOL,PK,0,2,3,10,18,33,15,45%
1550,POUDRE R-1,7834,SHEPARDSON ELEMENTARY SCHOOL,HALF DAY K,0,1,0,3,17,21,4,19%
1550,POUDRE R-1,7834,SHEPARDSON ELEMENTARY SCHOOL,KINDERGARTEN,0,1,0,3,19,23,4,17%
1550,POUDRE R-1,7834,SHEPARDSON ELEMENTARY SCHOOL,1ST,0,3,2,2,41,48,7,15%
1550,POUDRE R-1,7834,SHEPARDSON ELEMENTARY SCHOOL,2ND,0,3,5,3,33,44,11,25%
1550,POUDRE R-1,7834,SHEPARDSON ELEMENTARY SCHOOL,3RD,1,1,3,6,59,70,11,16%
1550,POUDRE R-1,7834,SHEPARDSON ELEMENTARY SCHOOL,4TH,1,2,1,4,59,67,8,12%
1550,POUDRE R-1,7834,SHEPARDSON ELEMENTARY SCHOOL,5TH,3,2,2,3,45,55,10,18%
1550,POUDRE R-1,7834,SHEPARDSON ELEMENTARY SCHOOL,SCHOOL TOTAL,5,15,16,34,291,361,70,19%
1550,POUDRE R-1,8318,STOVE PRAIRIE ELEMENTARY SCHOOL,KINDERGARTEN,0,1,0,0,4,5,1,20%
1550,POUDRE R-1,8318,STOVE PRAIRIE ELEMENTARY SCHOOL,1ST,1,0,0,0,8,9,1,11%
1550,POUDRE R-1,8318,STOVE PRAIRIE ELEMENTARY SCHOOL,2ND,0,0,0,0,5,5,0,0%
1550,POUDRE R-1,8318,STOVE PRAIRIE ELEMENTARY SCHOOL,3RD,1,0,0,1,8,10,2,20%
1550,POUDRE R-1,8318,STOVE PRAIRIE ELEMENTARY SCHOOL,4TH,0,0,0,0,7,7,0,0%
1550,POUDRE R-1,8318,STOVE PRAIRIE ELEMENTARY SCHOOL,5TH,0,0,0,1,3,4,1,25%
1550,POUDRE R-1,8318,STOVE PRAIRIE ELEMENTARY SCHOOL,SCHOOL TOTAL,2,1,0,2,35,40,5,13%
1550,POUDRE R-1,8460,TAVELLI ELEMENTARY SCHOOL,HALF DAY K,1,2,1,7,28,39,11,28%
1550,POUDRE R-1,8460,TAVELLI ELEMENTARY SCHOOL,KINDERGARTEN,1,0,1,20,37,59,22,37%
1550,POUDRE R-1,8460,TAVELLI ELEMENTARY SCHOOL,1ST,1,0,2,21,59,83,24,29%
1550,POUDRE R-1,8460,TAVELLI ELEMENTARY SCHOOL,2ND,1,0,5,27,57,90,33,37%
1550,POUDRE R-1,8460,TAVELLI ELEMENTARY SCHOOL,3RD,2,0,1,21,58,82,24,29%
1550,POUDRE R-1,8460,TAVELLI ELEMENTARY SCHOOL,4TH,1,2,0,19,68,90,22,24%
1550,POUDRE R-1,8460,TAVELLI ELEMENTARY SCHOOL,5TH,4,1,5,27,57,94,37,39%
1550,POUDRE R-1,8460,TAVELLI ELEMENTARY SCHOOL,SCHOOL TOTAL,11,5,15,142,364,537,173,32%
1550,POUDRE R-1,8852,TIMNATH ELEMENTARY SCHOOL,HALF DAY K,0,0,2,2,18,22,4,18%
1550,POUDRE R-1,8852,TIMNATH ELEMENTARY SCHOOL,KINDERGARTEN,1,0,0,9,14,24,10,42%
1550,POUDRE R-1,8852,TIMNATH ELEMENTARY SCHOOL,1ST,2,1,0,14,40,57,17,30%
1550,POUDRE R-1,8852,TIMNATH ELEMENTARY SCHOOL,2ND,1,1,0,14,35,51,16,31%
1550,POUDRE R-1,8852,TIMNATH ELEMENTARY SCHOOL,3RD,0,0,0,11,40,51,11,22%
1550,POUDRE R-1,8852,TIMNATH ELEMENTARY SCHOOL,4TH,0,2,1,5,45,53,8,15%
1550,POUDRE R-1,8852,TIMNATH ELEMENTARY SCHOOL,5TH,3,1,0,9,49,62,13,21%
1550,POUDRE R-1,8852,TIMNATH ELEMENTARY SCHOOL,SCHOOL TOTAL,7,5,3,64,241,320,79,25%
1550,POUDRE R-1,9251,TRAUT CORE ELEMENTARY SCHOOL,PK,0,3,0,9,6,18,12,67%
1550,POUDRE R-1,9251,TRAUT CORE ELEMENTARY SCHOOL,HALF DAY K,0,3,0,5,30,38,8,21%
1550,POUDRE R-1,9251,TRAUT CORE ELEMENTARY SCHOOL,KINDERGARTEN,0,5,1,1,33,40,7,18%
1550,POUDRE R-1,9251,TRAUT CORE ELEMENTARY SCHOOL,1ST,0,15,1,1,61,78,17,22%
1550,POUDRE R-1,9251,TRAUT CORE ELEMENTARY SCHOOL,2ND,0,14,1,1,62,78,16,21%
1550,POUDRE R-1,9251,TRAUT CORE ELEMENTARY SCHOOL,3RD,0,19,0,2,57,78,21,27%
1550,POUDRE R-1,9251,TRAUT CORE ELEMENTARY SCHOOL,4TH,2,14,2,4,56,78,22,28%
1550,POUDRE R-1,9251,TRAUT CORE ELEMENTARY SCHOOL,5TH,0,10,1,1,66,78,12,15%
1550,POUDRE R-1,9251,TRAUT CORE ELEMENTARY SCHOOL,SCHOOL TOTAL,2,83,6,24,371,486,115,24%
1550,POUDRE R-1,9330,WEBBER MIDDLE SCHOOL,6TH,3,12,3,29,208,255,47,18%
1550,POUDRE R-1,9330,WEBBER MIDDLE SCHOOL,7TH,2,7,3,30,211,253,42,17%
1550,POUDRE R-1,9330,WEBBER MIDDLE SCHOOL,8TH,2,14,7,34,230,287,57,20%
1550,POUDRE R-1,9330,WEBBER MIDDLE SCHOOL,SCHOOL TOTAL,7,33,13,93,649,795,146,18%
1550,POUDRE R-1,9370,EYESTONE ELEMENTARY SCHOOL,PK,1,0,0,13,19,33,14,42%
1550,POUDRE R-1,9370,EYESTONE ELEMENTARY SCHOOL,HALF DAY K,0,0,0,5,30,35,5,14%
1550,POUDRE R-1,9370,EYESTONE ELEMENTARY SCHOOL,KINDERGARTEN,0,1,0,7,48,56,8,14%
1550,POUDRE R-1,9370,EYESTONE ELEMENTARY SCHOOL,1ST,0,1,1,12,73,87,14,16%
1550,POUDRE R-1,9370,EYESTONE ELEMENTARY SCHOOL,2ND,2,0,2,16,60,80,20,25%
1550,POUDRE R-1,9370,EYESTONE ELEMENTARY SCHOOL,3RD,2,0,2,7,63,74,11,15%
1550,POUDRE R-1,9370,EYESTONE ELEMENTARY SCHOOL,4TH,1,2,0,9,65,77,12,16%
1550,POUDRE R-1,9370,EYESTONE ELEMENTARY SCHOOL,5TH,1,1,0,25,65,92,27,29%
1550,POUDRE R-1,9370,EYESTONE ELEMENTARY SCHOOL,SCHOOL TOTAL,7,5,5,94,423,534,111,21%
1550,POUDRE R-1,9374,WELLINGTON MIDDLE SCHOOL,6TH,4,1,2,28,91,126,35,28%
1550,POUDRE R-1,9374,WELLINGTON MIDDLE SCHOOL,7TH,3,0,0,12,87,102,15,15%
1550,POUDRE R-1,9374,WELLINGTON MIDDLE SCHOOL,8TH,0,1,3,29,85,118,33,28%
1550,POUDRE R-1,9374,WELLINGTON MIDDLE SCHOOL,SCHOOL TOTAL,7,2,5,69,263,346,83,24%
1550,POUDRE R-1,9380,WERNER ELEMENTARY SCHOOL,HALF DAY K,0,1,0,0,31,32,1,3%
1550,POUDRE R-1,9380,WERNER ELEMENTARY SCHOOL,KINDERGARTEN,0,3,0,1,39,43,4,9%
1550,POUDRE R-1,9380,WERNER ELEMENTARY SCHOOL,1ST,0,4,0,3,80,87,7,8%
1550,POUDRE R-1,9380,WERNER ELEMENTARY SCHOOL,2ND,0,4,0,2,59,65,6,9%
1550,POUDRE R-1,9380,WERNER ELEMENTARY SCHOOL,3RD,1,6,1,4,78,90,12,13%
1550,POUDRE R-1,9380,WERNER ELEMENTARY SCHOOL,4TH,0,1,1,2,79,83,4,5%
1550,POUDRE R-1,9380,WERNER ELEMENTARY SCHOOL,5TH,0,1,0,2,59,62,3,5%
1550,POUDRE R-1,9380,WERNER ELEMENTARY SCHOOL,SCHOOL TOTAL,1,20,2,14,425,462,37,8%
1550,POUDRE R-1,,DISTRICT TOTAL,,280,1009,584,4360,20287,26520,6233,24%
1560,THOMPSON R-2J,0510,CONRAD BALL MIDDLE SCHOOL,6TH,3,2,2,47,146,200,54,27%
1560,THOMPSON R-2J,0510,CONRAD BALL MIDDLE SCHOOL,7TH,2,4,6,50,162,224,62,28%
1560,THOMPSON R-2J,0510,CONRAD BALL MIDDLE SCHOOL,8TH,2,2,3,39,159,205,46,22%
1560,THOMPSON R-2J,0510,CONRAD BALL MIDDLE SCHOOL,SCHOOL TOTAL,7,8,11,136,467,629,162,26%
1560,THOMPSON R-2J,0808,BERTHOUD ELEMENTARY SCHOOL,HALF DAY K,0,3,0,6,46,55,9,16%
1560,THOMPSON R-2J,0808,BERTHOUD ELEMENTARY SCHOOL,1ST,1,0,0,8,62,71,9,13%
1560,THOMPSON R-2J,0808,BERTHOUD ELEMENTARY SCHOOL,2ND,1,1,0,5,61,68,7,10%
1560,THOMPSON R-2J,0808,BERTHOUD ELEMENTARY SCHOOL,3RD,0,4,0,7,58,69,11,16%
1560,THOMPSON R-2J,0808,BERTHOUD ELEMENTARY SCHOOL,4TH,3,3,1,7,74,88,14,16%
1560,THOMPSON R-2J,0808,BERTHOUD ELEMENTARY SCHOOL,5TH,1,2,1,6,63,73,10,14%
1560,THOMPSON R-2J,0808,BERTHOUD ELEMENTARY SCHOOL,SCHOOL TOTAL,6,13,2,39,364,424,60,14%
1560,THOMPSON R-2J,0812,BERTHOUD HIGH SCHOOL,9TH,2,2,0,13,137,154,17,11%
1560,THOMPSON R-2J,0812,BERTHOUD HIGH SCHOOL,10TH,0,0,1,5,126,132,6,5%
1560,THOMPSON R-2J,0812,BERTHOUD HIGH SCHOOL,11TH,1,5,0,19,154,179,25,14%
1560,THOMPSON R-2J,0812,BERTHOUD HIGH SCHOOL,12TH,0,2,1,9,147,159,12,8%
1560,THOMPSON R-2J,0812,BERTHOUD HIGH SCHOOL,SCHOOL TOTAL,3,9,2,46,564,624,60,10%
1560,THOMPSON R-2J,0865,B F KITCHEN ELEMENTARY SCHOOL,HALF DAY K,0,0,1,7,27,35,8,23%
1560,THOMPSON R-2J,0865,B F KITCHEN ELEMENTARY SCHOOL,1ST,0,0,0,7,34,41,7,17%
1560,THOMPSON R-2J,0865,B F KITCHEN ELEMENTARY SCHOOL,2ND,0,0,0,11,27,38,11,29%
1560,THOMPSON R-2J,0865,B F KITCHEN ELEMENTARY SCHOOL,3RD,0,1,0,6,25,32,7,22%
1560,THOMPSON R-2J,0865,B F KITCHEN ELEMENTARY SCHOOL,4TH,1,1,0,9,33,44,11,25%
1560,THOMPSON R-2J,0865,B F KITCHEN ELEMENTARY SCHOOL,5TH,0,2,2,0,21,25,4,16%
1560,THOMPSON R-2J,0865,B F KITCHEN ELEMENTARY SCHOOL,SCHOOL TOTAL,1,4,3,40,167,215,48,22%
1560,THOMPSON R-2J,0870,BIG THOMPSON ELEMENTARY SCHOOL,HALF DAY K,0,1,0,2,30,33,3,9%
1560,THOMPSON R-2J,0870,BIG THOMPSON ELEMENTARY SCHOOL,1ST,0,1,0,0,22,23,1,4%
1560,THOMPSON R-2J,0870,BIG THOMPSON ELEMENTARY SCHOOL,2ND,0,0,0,4,22,26,4,15%
1560,THOMPSON R-2J,0870,BIG THOMPSON ELEMENTARY SCHOOL,3RD,0,1,0,0,30,31,1,3%
1560,THOMPSON R-2J,0870,BIG THOMPSON ELEMENTARY SCHOOL,4TH,0,1,0,1,32,34,2,6%
1560,THOMPSON R-2J,0870,BIG THOMPSON ELEMENTARY SCHOOL,5TH,0,1,0,1,34,36,2,6%
1560,THOMPSON R-2J,0870,BIG THOMPSON ELEMENTARY SCHOOL,SCHOOL TOTAL,0,5,0,8,170,183,13,7%
1560,THOMPSON R-2J,0890,MARY BLAIR ELEMENTARY SCHOOL,HALF DAY K,1,0,1,5,22,29,7,24%
1560,THOMPSON R-2J,0890,MARY BLAIR ELEMENTARY SCHOOL,KINDERGARTEN,0,1,3,5,29,38,9,24%
1560,THOMPSON R-2J,0890,MARY BLAIR ELEMENTARY SCHOOL,1ST,0,1,2,15,77,95,18,19%
1560,THOMPSON R-2J,0890,MARY BLAIR ELEMENTARY SCHOOL,2ND,0,1,2,17,60,80,20,25%
1560,THOMPSON R-2J,0890,MARY BLAIR ELEMENTARY SCHOOL,3RD,0,3,3,13,71,90,19,21%
1560,THOMPSON R-2J,0890,MARY BLAIR ELEMENTARY SCHOOL,4TH,1,1,2,13,63,80,17,21%
1560,THOMPSON R-2J,0890,MARY BLAIR ELEMENTARY SCHOOL,5TH,0,4,1,11,53,69,16,23%
1560,THOMPSON R-2J,0890,MARY BLAIR ELEMENTARY SCHOOL,SCHOOL TOTAL,2,11,14,79,375,481,106,22%
1560,THOMPSON R-2J,1323,CARRIE MARTIN ELEMENTARY SCHOOL,HALF DAY K,0,0,1,1,25,27,2,7%
1560,THOMPSON R-2J,1323,CARRIE MARTIN ELEMENTARY SCHOOL,KINDERGARTEN,0,0,0,1,18,19,1,5%
1560,THOMPSON R-2J,1323,CARRIE MARTIN ELEMENTARY SCHOOL,1ST,0,1,0,4,49,54,5,9%
1560,THOMPSON R-2J,1323,CARRIE MARTIN ELEMENTARY SCHOOL,2ND,1,0,2,4,48,55,7,13%
1560,THOMPSON R-2J,1323,CARRIE MARTIN ELEMENTARY SCHOOL,3RD,1,0,0,5,42,48,6,13%
1560,THOMPSON R-2J,1323,CARRIE MARTIN ELEMENTARY SCHOOL,4TH,0,1,0,5,54,60,6,10%
1560,THOMPSON R-2J,1323,CARRIE MARTIN ELEMENTARY SCHOOL,5TH,0,0,3,4,43,50,7,14%
1560,THOMPSON R-2J,1323,CARRIE MARTIN ELEMENTARY SCHOOL,SCHOOL TOTAL,2,2,6,24,279,313,34,11%
1560,THOMPSON R-2J,1385,CENTENNIAL ELEMENTARY SCHOOL,HALF DAY K,0,0,1,11,42,54,12,22%
1560,THOMPSON R-2J,1385,CENTENNIAL ELEMENTARY SCHOOL,KINDERGARTEN,0,0,0,5,13,18,5,28%
1560,THOMPSON R-2J,1385,CENTENNIAL ELEMENTARY SCHOOL,1ST,0,1,3,9,66,79,13,16%
1560,THOMPSON R-2J,1385,CENTENNIAL ELEMENTARY SCHOOL,2ND,0,0,0,10,54,64,10,16%
1560,THOMPSON R-2J,1385,CENTENNIAL ELEMENTARY SCHOOL,3RD,0,1,2,11,62,76,14,18%
1560,THOMPSON R-2J,1385,CENTENNIAL ELEMENTARY SCHOOL,4TH,1,0,2,12,57,72,15,21%
1560,THOMPSON R-2J,1385,CENTENNIAL ELEMENTARY SCHOOL,5TH,0,0,1,8,57,66,9,14%
1560,THOMPSON R-2J,1385,CENTENNIAL ELEMENTARY SCHOOL,SCHOOL TOTAL,1,2,9,66,351,429,78,18%
1560,THOMPSON R-2J,1920,COTTONWOOD PLAINS ELEMENTARY SCHOOL,HALF DAY K,0,1,0,4,21,26,5,19%
1560,THOMPSON R-2J,1920,COTTONWOOD PLAINS ELEMENTARY SCHOOL,KINDERGARTEN,0,1,1,6,25,33,8,24%
1560,THOMPSON R-2J,1920,COTTONWOOD PLAINS ELEMENTARY SCHOOL,1ST,0,5,2,7,50,64,14,22%
1560,THOMPSON R-2J,1920,COTTONWOOD PLAINS ELEMENTARY SCHOOL,2ND,1,1,1,9,52,64,12,19%
1560,THOMPSON R-2J,1920,COTTONWOOD PLAINS ELEMENTARY SCHOOL,3RD,0,4,0,15,56,75,19,25%
1560,THOMPSON R-2J,1920,COTTONWOOD PLAINS ELEMENTARY SCHOOL,4TH,0,1,1,19,65,86,21,24%
1560,THOMPSON R-2J,1920,COTTONWOOD PLAINS ELEMENTARY SCHOOL,5TH,0,2,3,17,68,90,22,24%
1560,THOMPSON R-2J,1920,COTTONWOOD PLAINS ELEMENTARY SCHOOL,SCHOOL TOTAL,1,15,8,77,337,438,101,23%
1560,THOMPSON R-2J,2089,COYOTE RIDGE ELEMENTARY SCHOOL,HALF DAY K,1,0,1,1,21,24,3,13%
1560,THOMPSON R-2J,2089,COYOTE RIDGE ELEMENTARY SCHOOL,KINDERGARTEN,0,0,0,0,35,35,0,0%
1560,THOMPSON R-2J,2089,COYOTE RIDGE ELEMENTARY SCHOOL,1ST,0,3,2,6,49,60,11,18%
1560,THOMPSON R-2J,2089,COYOTE RIDGE ELEMENTARY SCHOOL,2ND,0,2,0,5,45,52,7,13%
1560,THOMPSON R-2J,2089,COYOTE RIDGE ELEMENTARY SCHOOL,3RD,0,3,1,0,45,49,4,8%
1560,THOMPSON R-2J,2089,COYOTE RIDGE ELEMENTARY SCHOOL,4TH,0,3,1,4,34,42,8,19%
1560,THOMPSON R-2J,2089,COYOTE RIDGE ELEMENTARY SCHOOL,5TH,0,3,1,3,24,31,7,23%
1560,THOMPSON R-2J,2089,COYOTE RIDGE ELEMENTARY SCHOOL,SCHOOL TOTAL,1,14,6,19,253,293,40,14%
1560,THOMPSON R-2J,3320,GARFIELD ELEMENTARY SCHOOL,HALF DAY K,0,0,0,1,0,1,1,100%
1560,THOMPSON R-2J,3320,GARFIELD ELEMENTARY SCHOOL,KINDERGARTEN,0,1,1,15,35,52,17,33%
1560,THOMPSON R-2J,3320,GARFIELD ELEMENTARY SCHOOL,1ST,1,0,1,13,38,53,15,28%
1560,THOMPSON R-2J,3320,GARFIELD ELEMENTARY SCHOOL,2ND,2,0,2,7,35,46,11,24%
1560,THOMPSON R-2J,3320,GARFIELD ELEMENTARY SCHOOL,3RD,0,1,2,11,33,47,14,30%
1560,THOMPSON R-2J,3320,GARFIELD ELEMENTARY SCHOOL,4TH,2,0,0,10,37,49,12,24%
1560,THOMPSON R-2J,3320,GARFIELD ELEMENTARY SCHOOL,5TH,2,0,1,5,34,42,8,19%
1560,THOMPSON R-2J,3320,GARFIELD ELEMENTARY SCHOOL,SCHOOL TOTAL,7,2,7,62,212,290,78,27%
1560,THOMPSON R-2J,4332,IVY STOCKWELL ELEMENTARY SCHOOL,HALF DAY K,0,0,0,3,38,41,3,7%
1560,THOMPSON R-2J,4332,IVY STOCKWELL ELEMENTARY SCHOOL,KINDERGARTEN,0,1,0,1,20,22,2,9%
1560,THOMPSON R-2J,4332,IVY STOCKWELL ELEMENTARY SCHOOL,1ST,0,1,0,1,40,42,2,5%
1560,THOMPSON R-2J,4332,IVY STOCKWELL ELEMENTARY SCHOOL,2ND,0,1,1,4,45,51,6,12%
1560,THOMPSON R-2J,4332,IVY STOCKWELL ELEMENTARY SCHOOL,3RD,0,2,0,3,43,48,5,10%
1560,THOMPSON R-2J,4332,IVY STOCKWELL ELEMENTARY SCHOOL,4TH,0,2,1,5,56,64,8,13%
1560,THOMPSON R-2J,4332,IVY STOCKWELL ELEMENTARY SCHOOL,5TH,0,0,0,4,58,62,4,6%
1560,THOMPSON R-2J,4332,IVY STOCKWELL ELEMENTARY SCHOOL,SCHOOL TOTAL,0,7,2,21,300,330,30,9%
1560,THOMPSON R-2J,5018,LAURENE EDMONDSON ELEMENTARY SCHOOL,HALF DAY K,0,2,0,10,31,43,12,28%
1560,THOMPSON R-2J,5018,LAURENE EDMONDSON ELEMENTARY SCHOOL,1ST,0,0,0,6,33,39,6,15%
1560,THOMPSON R-2J,5018,LAURENE EDMONDSON ELEMENTARY SCHOOL,2ND,0,0,1,7,34,42,8,19%
1560,THOMPSON R-2J,5018,LAURENE EDMONDSON ELEMENTARY SCHOOL,3RD,0,0,1,8,25,34,9,26%
1560,THOMPSON R-2J,5018,LAURENE EDMONDSON ELEMENTARY SCHOOL,4TH,0,4,0,5,34,43,9,21%
1560,THOMPSON R-2J,5018,LAURENE EDMONDSON ELEMENTARY SCHOOL,5TH,0,1,0,11,34,46,12,26%
1560,THOMPSON R-2J,5018,LAURENE EDMONDSON ELEMENTARY SCHOOL,SCHOOL TOTAL,0,7,2,47,191,247,56,23%
1560,THOMPSON R-2J,5170,LINCOLN ELEMENTARY SCHOOL,HALF DAY K,0,1,2,10,23,36,13,36%
1560,THOMPSON R-2J,5170,LINCOLN ELEMENTARY SCHOOL,KINDERGARTEN,0,0,0,3,12,15,3,20%
1560,THOMPSON R-2J,5170,LINCOLN ELEMENTARY SCHOOL,1ST,1,1,1,14,34,51,17,33%
1560,THOMPSON R-2J,5170,LINCOLN ELEMENTARY SCHOOL,2ND,0,0,4,10,47,61,14,23%
1560,THOMPSON R-2J,5170,LINCOLN ELEMENTARY SCHOOL,3RD,0,1,2,15,43,61,18,30%
1560,THOMPSON R-2J,5170,LINCOLN ELEMENTARY SCHOOL,4TH,1,0,4,16,47,68,21,31%
1560,THOMPSON R-2J,5170,LINCOLN ELEMENTARY SCHOOL,5TH,2,2,1,19,43,67,24,36%
1560,THOMPSON R-2J,5170,LINCOLN ELEMENTARY SCHOOL,SCHOOL TOTAL,4,5,14,87,249,359,110,31%
1560,THOMPSON R-2J,5312,BILL REED MIDDLE SCHOOL,6TH,3,3,1,35,163,205,42,20%
1560,THOMPSON R-2J,5312,BILL REED MIDDLE SCHOOL,7TH,5,2,3,41,158,209,51,24%
1560,THOMPSON R-2J,5312,BILL REED MIDDLE SCHOOL,8TH,0,1,6,37,160,204,44,22%
1560,THOMPSON R-2J,5312,BILL REED MIDDLE SCHOOL,SCHOOL TOTAL,8,6,10,113,481,618,137,22%
1560,THOMPSON R-2J,5316,LOVELAND HIGH SCHOOL,9TH,6,11,4,59,352,432,80,19%
1560,THOMPSON R-2J,5316,LOVELAND HIGH SCHOOL,10TH,6,9,6,59,310,390,80,21%
1560,THOMPSON R-2J,5316,LOVELAND HIGH SCHOOL,11TH,4,12,2,53,326,397,71,18%
1560,THOMPSON R-2J,5316,LOVELAND HIGH SCHOOL,12TH,1,12,3,36,357,409,52,13%
1560,THOMPSON R-2J,5316,LOVELAND HIGH SCHOOL,SCHOOL TOTAL,17,44,15,207,1345,1628,283,17%
1560,THOMPSON R-2J,5335,LUCILE ERWIN MIDDLE SCHOOL,6TH,3,6,6,40,216,271,55,20%
1560,THOMPSON R-2J,5335,LUCILE ERWIN MIDDLE SCHOOL,7TH,1,7,5,51,243,307,64,21%
1560,THOMPSON R-2J,5335,LUCILE ERWIN MIDDLE SCHOOL,8TH,2,10,2,31,232,277,45,16%
1560,THOMPSON R-2J,5335,LUCILE ERWIN MIDDLE SCHOOL,SCHOOL TOTAL,6,23,13,122,691,855,164,19%
1560,THOMPSON R-2J,5393,THOMPSON INTEGRATED EARLY CHILDHOOD,PK,2,5,6,166,267,446,179,40%
1560,THOMPSON R-2J,5393,THOMPSON INTEGRATED EARLY CHILDHOOD,SCHOOL TOTAL,2,5,6,166,267,446,179,40%
1560,THOMPSON R-2J,5992,MONROE ELEMENTARY SCHOOL,HALF DAY K,1,2,0,8,11,22,11,50%
1560,THOMPSON R-2J,5992,MONROE ELEMENTARY SCHOOL,KINDERGARTEN,0,0,1,13,24,38,14,37%
1560,THOMPSON R-2J,5992,MONROE ELEMENTARY SCHOOL,1ST,0,2,1,14,44,61,17,28%
1560,THOMPSON R-2J,5992,MONROE ELEMENTARY SCHOOL,2ND,1,0,1,19,36,57,21,37%
1560,THOMPSON R-2J,5992,MONROE ELEMENTARY SCHOOL,3RD,0,2,0,16,48,66,18,27%
1560,THOMPSON R-2J,5992,MONROE ELEMENTARY SCHOOL,4TH,0,2,2,17,38,59,21,36%
1560,THOMPSON R-2J,5992,MONROE ELEMENTARY SCHOOL,5TH,0,1,2,21,32,56,24,43%
1560,THOMPSON R-2J,5992,MONROE ELEMENTARY SCHOOL,SCHOOL TOTAL,2,9,7,108,233,359,126,35%
1560,THOMPSON R-2J,6163,MOUNTAIN VIEW HIGH SCHOOL,9TH,1,2,5,52,206,266,60,23%
1560,THOMPSON R-2J,6163,MOUNTAIN VIEW HIGH SCHOOL,10TH,4,4,1,44,212,265,53,20%
1560,THOMPSON R-2J,6163,MOUNTAIN VIEW HIGH SCHOOL,11TH,3,4,4,48,237,296,59,20%
1560,THOMPSON R-2J,6163,MOUNTAIN VIEW HIGH SCHOOL,12TH,2,3,6,39,214,264,50,19%
1560,THOMPSON R-2J,6163,MOUNTAIN VIEW HIGH SCHOOL,SCHOOL TOTAL,10,13,16,183,869,1091,222,20%
1560,THOMPSON R-2J,6194,NAMAQUA ELEMENTARY SCHOOL,HALF DAY K,0,1,1,1,44,47,3,6%
1560,THOMPSON R-2J,6194,NAMAQUA ELEMENTARY SCHOOL,KINDERGARTEN,0,1,0,0,20,21,1,5%
1560,THOMPSON R-2J,6194,NAMAQUA ELEMENTARY SCHOOL,1ST,0,1,2,4,65,72,7,10%
1560,THOMPSON R-2J,6194,NAMAQUA ELEMENTARY SCHOOL,2ND,0,0,1,6,69,76,7,9%
1560,THOMPSON R-2J,6194,NAMAQUA ELEMENTARY SCHOOL,3RD,0,0,2,6,55,63,8,13%
1560,THOMPSON R-2J,6194,NAMAQUA ELEMENTARY SCHOOL,4TH,0,2,1,7,75,85,10,12%
1560,THOMPSON R-2J,6194,NAMAQUA ELEMENTARY SCHOOL,5TH,1,3,1,9,95,109,14,13%
1560,THOMPSON R-2J,6194,NAMAQUA ELEMENTARY SCHOOL,SCHOOL TOTAL,1,8,8,33,423,473,50,11%
1560,THOMPSON R-2J,6220,NEW VISION CHARTER SCHOOL,HALF DAY K,0,0,1,1,30,32,2,6%
1560,THOMPSON R-2J,6220,NEW VISION CHARTER SCHOOL,KINDERGARTEN,2,1,1,0,12,16,4,25%
1560,THOMPSON R-2J,6220,NEW VISION CHARTER SCHOOL,1ST,1,4,0,1,42,48,6,13%
1560,THOMPSON R-2J,6220,NEW VISION CHARTER SCHOOL,2ND,0,1,0,3,44,48,4,8%
1560,THOMPSON R-2J,6220,NEW VISION CHARTER SCHOOL,3RD,0,0,0,3,45,48,3,6%
1560,THOMPSON R-2J,6220,NEW VISION CHARTER SCHOOL,4TH,0,1,0,3,44,48,4,8%
1560,THOMPSON R-2J,6220,NEW VISION CHARTER SCHOOL,5TH,1,2,1,6,38,48,10,21%
1560,THOMPSON R-2J,6220,NEW VISION CHARTER SCHOOL,6TH,0,1,1,2,44,48,4,8%
1560,THOMPSON R-2J,6220,NEW VISION CHARTER SCHOOL,7TH,0,1,1,3,43,48,5,10%
1560,THOMPSON R-2J,6220,NEW VISION CHARTER SCHOOL,8TH,1,1,0,2,44,48,4,8%
1560,THOMPSON R-2J,6220,NEW VISION CHARTER SCHOOL,SCHOOL TOTAL,5,12,5,24,386,432,46,11%
1560,THOMPSON R-2J,7640,SARAH MILNER ELEMENTARY SCHOOL,HALF DAY K,0,0,1,11,32,44,12,27%
1560,THOMPSON R-2J,7640,SARAH MILNER ELEMENTARY SCHOOL,KINDERGARTEN,0,1,0,3,19,23,4,17%
1560,THOMPSON R-2J,7640,SARAH MILNER ELEMENTARY SCHOOL,1ST,0,0,0,11,32,43,11,26%
1560,THOMPSON R-2J,7640,SARAH MILNER ELEMENTARY SCHOOL,2ND,1,2,2,8,35,48,13,27%
1560,THOMPSON R-2J,7640,SARAH MILNER ELEMENTARY SCHOOL,3RD,0,0,1,15,40,56,16,29%
1560,THOMPSON R-2J,7640,SARAH MILNER ELEMENTARY SCHOOL,4TH,1,0,1,12,44,58,14,24%
1560,THOMPSON R-2J,7640,SARAH MILNER ELEMENTARY SCHOOL,5TH,0,1,0,16,47,64,17,27%
1560,THOMPSON R-2J,7640,SARAH MILNER ELEMENTARY SCHOOL,SCHOOL TOTAL,2,4,5,76,249,336,87,26%
1560,THOMPSON R-2J,7650,STANSBERRY ELEMENTARY SCHOOL,HALF DAY K,0,0,1,5,38,44,6,14%
1560,THOMPSON R-2J,7650,STANSBERRY ELEMENTARY SCHOOL,1ST,1,1,0,2,37,41,4,10%
1560,THOMPSON R-2J,7650,STANSBERRY ELEMENTARY SCHOOL,2ND,0,1,0,5,40,46,6,13%
1560,THOMPSON R-2J,7650,STANSBERRY ELEMENTARY SCHOOL,3RD,0,1,0,7,38,46,8,17%
1560,THOMPSON R-2J,7650,STANSBERRY ELEMENTARY SCHOOL,4TH,1,0,0,11,27,39,12,31%
1560,THOMPSON R-2J,7650,STANSBERRY ELEMENTARY SCHOOL,5TH,2,1,0,5,30,38,8,21%
1560,THOMPSON R-2J,7650,STANSBERRY ELEMENTARY SCHOOL,SCHOOL TOTAL,4,4,1,35,210,254,44,17%
1560,THOMPSON R-2J,8824,THOMPSON VALLEY HIGH SCHOOL,9TH,4,4,1,27,316,352,36,10%
1560,THOMPSON R-2J,8824,THOMPSON VALLEY HIGH SCHOOL,10TH,4,6,2,37,317,366,49,13%
1560,THOMPSON R-2J,8824,THOMPSON VALLEY HIGH SCHOOL,11TH,2,2,1,25,266,296,30,10%
1560,THOMPSON R-2J,8824,THOMPSON VALLEY HIGH SCHOOL,12TH,5,2,1,29,315,352,37,11%
1560,THOMPSON R-2J,8824,THOMPSON VALLEY HIGH SCHOOL,SCHOOL TOTAL,15,14,5,118,1214,1366,152,11%
1560,THOMPSON R-2J,8918,TRUSCOTT ELEMENTARY SCHOOL,HALF DAY K,1,1,1,11,36,50,14,28%
1560,THOMPSON R-2J,8918,TRUSCOTT ELEMENTARY SCHOOL,1ST,0,0,6,16,27,49,22,45%
1560,THOMPSON R-2J,8918,TRUSCOTT ELEMENTARY SCHOOL,2ND,0,0,1,14,35,50,15,30%
1560,THOMPSON R-2J,8918,TRUSCOTT ELEMENTARY SCHOOL,3RD,2,0,2,8,29,41,12,29%
1560,THOMPSON R-2J,8918,TRUSCOTT ELEMENTARY SCHOOL,4TH,0,1,1,17,28,47,19,40%
1560,THOMPSON R-2J,8918,TRUSCOTT ELEMENTARY SCHOOL,5TH,0,0,1,15,31,47,16,34%
1560,THOMPSON R-2J,8918,TRUSCOTT ELEMENTARY SCHOOL,SCHOOL TOTAL,3,2,12,81,186,284,98,35%
1560,THOMPSON R-2J,8925,TURNER MIDDLE SCHOOL,6TH,1,3,0,14,131,149,18,12%
1560,THOMPSON R-2J,8925,TURNER MIDDLE SCHOOL,7TH,1,0,0,11,107,119,12,10%
1560,THOMPSON R-2J,8925,TURNER MIDDLE SCHOOL,8TH,0,5,1,17,131,154,23,15%
1560,THOMPSON R-2J,8925,TURNER MIDDLE SCHOOL,SCHOOL TOTAL,2,8,1,42,369,422,53,13%
1560,THOMPSON R-2J,9055,VAN BUREN ELEMENTARY SCHOOL,HALF DAY K,1,0,0,9,31,41,10,24%
1560,THOMPSON R-2J,9055,VAN BUREN ELEMENTARY SCHOOL,1ST,0,2,0,7,41,50,9,18%
1560,THOMPSON R-2J,9055,VAN BUREN ELEMENTARY SCHOOL,2ND,1,1,0,11,39,52,13,25%
1560,THOMPSON R-2J,9055,VAN BUREN ELEMENTARY SCHOOL,3RD,0,0,0,5,31,36,5,14%
1560,THOMPSON R-2J,9055,VAN BUREN ELEMENTARY SCHOOL,4TH,0,1,0,11,31,43,12,28%
1560,THOMPSON R-2J,9055,VAN BUREN ELEMENTARY SCHOOL,5TH,0,0,0,8,35,43,8,19%
1560,THOMPSON R-2J,9055,VAN BUREN ELEMENTARY SCHOOL,SCHOOL TOTAL,2,4,0,51,208,265,57,22%
1560,THOMPSON R-2J,9228,WALT CLARK MIDDLE SCHOOL,6TH,2,0,2,20,138,162,24,15%
1560,THOMPSON R-2J,9228,WALT CLARK MIDDLE SCHOOL,7TH,4,4,1,23,182,214,32,15%
1560,THOMPSON R-2J,9228,WALT CLARK MIDDLE SCHOOL,8TH,0,3,1,22,174,200,26,13%
1560,THOMPSON R-2J,9228,WALT CLARK MIDDLE SCHOOL,SCHOOL TOTAL,6,7,4,65,494,576,82,14%
1560,THOMPSON R-2J,9260,HAROLD FERGUSON HIGH SCHOOL,11TH,0,1,1,13,36,51,15,29%
1560,THOMPSON R-2J,9260,HAROLD FERGUSON HIGH SCHOOL,12TH,0,0,2,12,60,74,14,19%
1560,THOMPSON R-2J,9260,HAROLD FERGUSON HIGH SCHOOL,SCHOOL TOTAL,0,1,3,25,96,125,29,23%
1560,THOMPSON R-2J,9674,WINONA ELEMENTARY SCHOOL,HALF DAY K,2,1,0,28,54,85,31,36%
1560,THOMPSON R-2J,9674,WINONA ELEMENTARY SCHOOL,1ST,6,4,0,30,41,81,40,49%
1560,THOMPSON R-2J,9674,WINONA ELEMENTARY SCHOOL,2ND,0,0,0,28,39,67,28,42%
1560,THOMPSON R-2J,9674,WINONA ELEMENTARY SCHOOL,3RD,4,2,0,29,44,79,35,44%
1560,THOMPSON R-2J,9674,WINONA ELEMENTARY SCHOOL,4TH,0,1,0,23,31,55,24,44%
1560,THOMPSON R-2J,9674,WINONA ELEMENTARY SCHOOL,5TH,1,2,1,28,41,73,32,44%
1560,THOMPSON R-2J,9674,WINONA ELEMENTARY SCHOOL,SCHOOL TOTAL,13,10,1,166,250,440,190,43%
1560,THOMPSON R-2J,,DISTRICT TOTAL,,133,278,198,2366,12250,15225,2975,20%
1570,PARK (ESTES PARK) R-3,2788,ESTES PARK OPTIONS SCHOOL,KINDERGARTEN,0,0,0,0,3,3,0,0%
1570,PARK (ESTES PARK) R-3,2788,ESTES PARK OPTIONS SCHOOL,1ST,0,0,0,0,4,4,0,0%
1570,PARK (ESTES PARK) R-3,2788,ESTES PARK OPTIONS SCHOOL,2ND,0,0,0,0,1,1,0,0%
1570,PARK (ESTES PARK) R-3,2788,ESTES PARK OPTIONS SCHOOL,3RD,0,0,0,0,3,3,0,0%
1570,PARK (ESTES PARK) R-3,2788,ESTES PARK OPTIONS SCHOOL,4TH,0,0,0,0,2,2,0,0%
1570,PARK (ESTES PARK) R-3,2788,ESTES PARK OPTIONS SCHOOL,5TH,1,0,0,0,0,1,1,100%
1570,PARK (ESTES PARK) R-3,2788,ESTES PARK OPTIONS SCHOOL,6TH,0,0,0,0,2,2,0,0%
1570,PARK (ESTES PARK) R-3,2788,ESTES PARK OPTIONS SCHOOL,7TH,0,0,0,0,5,5,0,0%
1570,PARK (ESTES PARK) R-3,2788,ESTES PARK OPTIONS SCHOOL,8TH,0,0,0,1,1,2,1,50%
1570,PARK (ESTES PARK) R-3,2788,ESTES PARK OPTIONS SCHOOL,9TH,0,0,0,0,2,2,0,0%
1570,PARK (ESTES PARK) R-3,2788,ESTES PARK OPTIONS SCHOOL,11TH,0,0,0,0,1,1,0,0%
1570,PARK (ESTES PARK) R-3,2788,ESTES PARK OPTIONS SCHOOL,SCHOOL TOTAL,1,0,0,1,24,26,2,8%
1570,PARK (ESTES PARK) R-3,2790,ESTES PARK K-5 SCHOOL,PK,1,1,0,1,25,28,3,11%
1570,PARK (ESTES PARK) R-3,2790,ESTES PARK K-5 SCHOOL,KINDERGARTEN,2,1,1,22,68,94,26,28%
1570,PARK (ESTES PARK) R-3,2790,ESTES PARK K-5 SCHOOL,1ST,0,1,2,24,59,86,27,31%
1570,PARK (ESTES PARK) R-3,2790,ESTES PARK K-5 SCHOOL,2ND,1,3,1,20,50,75,25,33%
1570,PARK (ESTES PARK) R-3,2790,ESTES PARK K-5 SCHOOL,3RD,0,3,0,18,49,70,21,30%
1570,PARK (ESTES PARK) R-3,2790,ESTES PARK K-5 SCHOOL,4TH,0,1,2,22,64,89,25,28%
1570,PARK (ESTES PARK) R-3,2790,ESTES PARK K-5 SCHOOL,5TH,3,6,1,11,62,83,21,25%
1570,PARK (ESTES PARK) R-3,2790,ESTES PARK K-5 SCHOOL,SCHOOL TOTAL,7,16,7,118,377,525,148,28%
1570,PARK (ESTES PARK) R-3,2792,ESTES PARK MIDDLE SCHOOL,6TH,0,2,1,19,49,71,22,31%
1570,PARK (ESTES PARK) R-3,2792,ESTES PARK MIDDLE SCHOOL,7TH,2,2,1,19,68,92,24,26%
1570,PARK (ESTES PARK) R-3,2792,ESTES PARK MIDDLE SCHOOL,8TH,2,2,1,15,93,113,20,18%
1570,PARK (ESTES PARK) R-3,2792,ESTES PARK MIDDLE SCHOOL,SCHOOL TOTAL,4,6,3,53,210,276,66,24%
1570,PARK (ESTES PARK) R-3,2794,ESTES PARK HIGH SCHOOL,9TH,1,2,1,16,68,88,20,23%
1570,PARK (ESTES PARK) R-3,2794,ESTES PARK HIGH SCHOOL,10TH,1,2,3,8,88,102,14,14%
1570,PARK (ESTES PARK) R-3,2794,ESTES PARK HIGH SCHOOL,11TH,1,2,1,19,78,101,23,23%
1570,PARK (ESTES PARK) R-3,2794,ESTES PARK HIGH SCHOOL,12TH,3,1,1,12,75,92,17,18%
1570,PARK (ESTES PARK) R-3,2794,ESTES PARK HIGH SCHOOL,SCHOOL TOTAL,6,7,6,55,309,383,74,19%
1570,PARK (ESTES PARK) R-3,,DISTRICT TOTAL,,18,29,16,227,920,1210,290,24%
1580,TRINIDAD 1,1386,TRINIDAD MIDDLE SCHOOL,6TH,4,1,2,64,30,101,71,70%
1580,TRINIDAD 1,1386,TRINIDAD MIDDLE SCHOOL,7TH,2,2,0,67,40,111,71,64%
1580,TRINIDAD 1,1386,TRINIDAD MIDDLE SCHOOL,8TH,2,1,1,69,39,112,73,65%
1580,TRINIDAD 1,1386,TRINIDAD MIDDLE SCHOOL,SCHOOL TOTAL,8,4,3,200,109,324,215,66%
1580,TRINIDAD 1,2481,ECKHART ELEMENTARY SCHOOL,KINDERGARTEN,2,3,1,71,34,111,77,69%
1580,TRINIDAD 1,2481,ECKHART ELEMENTARY SCHOOL,1ST,1,1,1,61,24,88,64,73%
1580,TRINIDAD 1,2481,ECKHART ELEMENTARY SCHOOL,SCHOOL TOTAL,3,4,2,132,58,199,141,71%
1580,TRINIDAD 1,2944,FISHER'S PEAK ELEMENTARY SCHOOL,2ND,1,2,4,65,48,120,72,60%
1580,TRINIDAD 1,2944,FISHER'S PEAK ELEMENTARY SCHOOL,3RD,2,0,1,77,38,118,80,68%
1580,TRINIDAD 1,2944,FISHER'S PEAK ELEMENTARY SCHOOL,4TH,1,1,1,94,29,126,97,77%
1580,TRINIDAD 1,2944,FISHER'S PEAK ELEMENTARY SCHOOL,5TH,2,3,1,63,30,99,69,70%
1580,TRINIDAD 1,2944,FISHER'S PEAK ELEMENTARY SCHOOL,SCHOOL TOTAL,6,6,7,299,145,463,318,69%
1580,TRINIDAD 1,8906,TRINIDAD HIGH SCHOOL,9TH,2,3,0,64,35,104,69,66%
1580,TRINIDAD 1,8906,TRINIDAD HIGH SCHOOL,10TH,3,3,0,74,43,123,80,65%
1580,TRINIDAD 1,8906,TRINIDAD HIGH SCHOOL,11TH,0,3,0,61,32,96,64,67%
1580,TRINIDAD 1,8906,TRINIDAD HIGH SCHOOL,12TH,0,1,2,60,29,92,63,68%
1580,TRINIDAD 1,8906,TRINIDAD HIGH SCHOOL,SCHOOL TOTAL,5,10,2,259,139,415,276,67%
1580,TRINIDAD 1,,DISTRICT TOTAL,,22,24,14,890,451,1401,950,68%
1590,PRIMERO REORGANIZED 2,7160,PRIMERO ELEMENTARY SCHOOL,PK,0,0,0,8,13,21,8,38%
1590,PRIMERO REORGANIZED 2,7160,PRIMERO ELEMENTARY SCHOOL,KINDERGARTEN,0,0,0,6,9,15,6,40%
1590,PRIMERO REORGANIZED 2,7160,PRIMERO ELEMENTARY SCHOOL,1ST,0,0,0,8,13,21,8,38%
1590,PRIMERO REORGANIZED 2,7160,PRIMERO ELEMENTARY SCHOOL,2ND,0,0,0,5,3,8,5,63%
1590,PRIMERO REORGANIZED 2,7160,PRIMERO ELEMENTARY SCHOOL,3RD,0,0,0,10,7,17,10,59%
1590,PRIMERO REORGANIZED 2,7160,PRIMERO ELEMENTARY SCHOOL,4TH,0,0,0,4,10,14,4,29%
1590,PRIMERO REORGANIZED 2,7160,PRIMERO ELEMENTARY SCHOOL,5TH,0,0,0,9,7,16,9,56%
1590,PRIMERO REORGANIZED 2,7160,PRIMERO ELEMENTARY SCHOOL,SCHOOL TOTAL,0,0,0,50,62,112,50,45%
1590,PRIMERO REORGANIZED 2,7164,PRIMERO JUNIOR-SENIOR HIGH SCHOOL,6TH,0,0,0,6,9,15,6,40%
1590,PRIMERO REORGANIZED 2,7164,PRIMERO JUNIOR-SENIOR HIGH SCHOOL,7TH,0,0,1,8,9,18,9,50%
1590,PRIMERO REORGANIZED 2,7164,PRIMERO JUNIOR-SENIOR HIGH SCHOOL,8TH,0,0,0,6,6,12,6,50%
1590,PRIMERO REORGANIZED 2,7164,PRIMERO JUNIOR-SENIOR HIGH SCHOOL,9TH,0,0,1,3,17,21,4,19%
1590,PRIMERO REORGANIZED 2,7164,PRIMERO JUNIOR-SENIOR HIGH SCHOOL,10TH,0,1,0,7,8,16,8,50%
1590,PRIMERO REORGANIZED 2,7164,PRIMERO JUNIOR-SENIOR HIGH SCHOOL,11TH,0,0,0,7,13,20,7,35%
1590,PRIMERO REORGANIZED 2,7164,PRIMERO JUNIOR-SENIOR HIGH SCHOOL,12TH,0,0,0,6,11,17,6,35%
1590,PRIMERO REORGANIZED 2,7164,PRIMERO JUNIOR-SENIOR HIGH SCHOOL,SCHOOL TOTAL,0,1,2,43,73,119,46,39%
1590,PRIMERO REORGANIZED 2,,DISTRICT TOTAL,,0,1,2,93,135,231,96,42%
1600,HOEHNE REORGANIZED 3,0000,NOT IN A SCHOOL,8TH,0,0,0,1,0,1,1,100%
1600,HOEHNE REORGANIZED 3,0000,NOT IN A SCHOOL,SCHOOL TOTAL,0,0,0,1,0,1,1,100%
1600,HOEHNE REORGANIZED 3,4044,HOEHNE ELEMENTARY SCHOOL,KINDERGARTEN,0,1,1,7,14,23,9,39%
1600,HOEHNE REORGANIZED 3,4044,HOEHNE ELEMENTARY SCHOOL,1ST,0,0,0,5,12,17,5,29%
1600,HOEHNE REORGANIZED 3,4044,HOEHNE ELEMENTARY SCHOOL,2ND,0,0,0,6,15,21,6,29%
1600,HOEHNE REORGANIZED 3,4044,HOEHNE ELEMENTARY SCHOOL,3RD,0,0,0,9,8,17,9,53%
1600,HOEHNE REORGANIZED 3,4044,HOEHNE ELEMENTARY SCHOOL,4TH,0,0,0,9,16,25,9,36%
1600,HOEHNE REORGANIZED 3,4044,HOEHNE ELEMENTARY SCHOOL,5TH,0,1,0,7,13,21,8,38%
1600,HOEHNE REORGANIZED 3,4044,HOEHNE ELEMENTARY SCHOOL,6TH,0,0,0,9,14,23,9,39%
1600,HOEHNE REORGANIZED 3,4044,HOEHNE ELEMENTARY SCHOOL,SCHOOL TOTAL,0,2,1,52,92,147,55,37%
1600,HOEHNE REORGANIZED 3,4045,HOEHNE JUNIOR HIGH SCHOOL,7TH,0,0,0,7,16,23,7,30%
1600,HOEHNE REORGANIZED 3,4045,HOEHNE JUNIOR HIGH SCHOOL,8TH,0,0,0,16,20,36,16,44%
1600,HOEHNE REORGANIZED 3,4045,HOEHNE JUNIOR HIGH SCHOOL,SCHOOL TOTAL,0,0,0,23,36,59,23,39%
1600,HOEHNE REORGANIZED 3,4048,HOEHNE HIGH SCHOOL,9TH,0,1,0,12,23,36,13,36%
1600,HOEHNE REORGANIZED 3,4048,HOEHNE HIGH SCHOOL,10TH,0,0,0,17,16,33,17,52%
1600,HOEHNE REORGANIZED 3,4048,HOEHNE HIGH SCHOOL,11TH,1,2,0,8,19,30,11,37%
1600,HOEHNE REORGANIZED 3,4048,HOEHNE HIGH SCHOOL,12TH,0,0,0,7,16,23,7,30%
1600,HOEHNE REORGANIZED 3,4048,HOEHNE HIGH SCHOOL,SCHOOL TOTAL,1,3,0,44,74,122,48,39%
1600,HOEHNE REORGANIZED 3,,DISTRICT TOTAL,,1,5,1,120,202,329,127,39%
1620,AGUILAR REORGANIZED 6,0058,AGUILAR ELEMENTARY SCHOOL,PK,0,0,0,10,6,16,10,63%
1620,AGUILAR REORGANIZED 6,0058,AGUILAR ELEMENTARY SCHOOL,KINDERGARTEN,0,0,0,3,4,7,3,43%
1620,AGUILAR REORGANIZED 6,0058,AGUILAR ELEMENTARY SCHOOL,1ST,0,0,0,9,1,10,9,90%
1620,AGUILAR REORGANIZED 6,0058,AGUILAR ELEMENTARY SCHOOL,2ND,0,0,0,6,4,10,6,60%
1620,AGUILAR REORGANIZED 6,0058,AGUILAR ELEMENTARY SCHOOL,3RD,0,0,0,4,5,9,4,44%
1620,AGUILAR REORGANIZED 6,0058,AGUILAR ELEMENTARY SCHOOL,4TH,0,0,0,3,2,5,3,60%
1620,AGUILAR REORGANIZED 6,0058,AGUILAR ELEMENTARY SCHOOL,5TH,0,0,0,7,3,10,7,70%
1620,AGUILAR REORGANIZED 6,0058,AGUILAR ELEMENTARY SCHOOL,6TH,0,0,0,5,3,8,5,63%
1620,AGUILAR REORGANIZED 6,0058,AGUILAR ELEMENTARY SCHOOL,SCHOOL TOTAL,0,0,0,47,28,75,47,63%
1620,AGUILAR REORGANIZED 6,0066,AGUILAR JUNIOR-SENIOR HIGH SCHOOL,7TH,0,0,0,5,2,7,5,71%
1620,AGUILAR REORGANIZED 6,0066,AGUILAR JUNIOR-SENIOR HIGH SCHOOL,8TH,0,0,0,5,5,10,5,50%
1620,AGUILAR REORGANIZED 6,0066,AGUILAR JUNIOR-SENIOR HIGH SCHOOL,9TH,0,0,0,3,2,5,3,60%
1620,AGUILAR REORGANIZED 6,0066,AGUILAR JUNIOR-SENIOR HIGH SCHOOL,10TH,0,0,0,4,7,11,4,36%
1620,AGUILAR REORGANIZED 6,0066,AGUILAR JUNIOR-SENIOR HIGH SCHOOL,11TH,0,0,0,9,7,16,9,56%
1620,AGUILAR REORGANIZED 6,0066,AGUILAR JUNIOR-SENIOR HIGH SCHOOL,12TH,0,0,0,5,4,9,5,56%
1620,AGUILAR REORGANIZED 6,0066,AGUILAR JUNIOR-SENIOR HIGH SCHOOL,SCHOOL TOTAL,0,0,0,31,27,58,31,53%
1620,AGUILAR REORGANIZED 6,,DISTRICT TOTAL,,0,0,0,78,55,133,78,59%
1750,BRANSON REORGANIZED 82,0948,BRANSON SCHOOL ONLINE,KINDERGARTEN,0,0,0,0,23,23,0,0%
1750,BRANSON REORGANIZED 82,0948,BRANSON SCHOOL ONLINE,1ST,0,0,0,2,17,19,2,11%
1750,BRANSON REORGANIZED 82,0948,BRANSON SCHOOL ONLINE,2ND,1,0,1,6,12,20,8,40%
1750,BRANSON REORGANIZED 82,0948,BRANSON SCHOOL ONLINE,3RD,0,0,0,1,18,19,1,5%
1750,BRANSON REORGANIZED 82,0948,BRANSON SCHOOL ONLINE,4TH,0,0,0,4,27,31,4,13%
1750,BRANSON REORGANIZED 82,0948,BRANSON SCHOOL ONLINE,5TH,1,0,1,1,20,23,3,13%
1750,BRANSON REORGANIZED 82,0948,BRANSON SCHOOL ONLINE,6TH,1,0,2,6,25,34,9,26%
1750,BRANSON REORGANIZED 82,0948,BRANSON SCHOOL ONLINE,7TH,0,0,1,7,38,46,8,17%
1750,BRANSON REORGANIZED 82,0948,BRANSON SCHOOL ONLINE,8TH,0,0,0,6,33,39,6,15%
1750,BRANSON REORGANIZED 82,0948,BRANSON SCHOOL ONLINE,9TH,2,0,2,6,52,62,10,16%
1750,BRANSON REORGANIZED 82,0948,BRANSON SCHOOL ONLINE,10TH,0,0,0,4,35,39,4,10%
1750,BRANSON REORGANIZED 82,0948,BRANSON SCHOOL ONLINE,11TH,2,0,0,8,39,49,10,20%
1750,BRANSON REORGANIZED 82,0948,BRANSON SCHOOL ONLINE,12TH,1,0,0,9,33,43,10,23%
1750,BRANSON REORGANIZED 82,0948,BRANSON SCHOOL ONLINE,SCHOOL TOTAL,8,0,7,60,372,447,75,17%
1750,BRANSON REORGANIZED 82,0974,BRANSON ELEMENTARY SCHOOL,PK,0,0,0,1,2,3,1,33%
1750,BRANSON REORGANIZED 82,0974,BRANSON ELEMENTARY SCHOOL,KINDERGARTEN,0,0,0,1,2,3,1,33%
1750,BRANSON REORGANIZED 82,0974,BRANSON ELEMENTARY SCHOOL,1ST,0,0,1,1,2,4,2,50%
1750,BRANSON REORGANIZED 82,0974,BRANSON ELEMENTARY SCHOOL,2ND,0,0,1,0,0,1,1,100%
1750,BRANSON REORGANIZED 82,0974,BRANSON ELEMENTARY SCHOOL,3RD,0,0,1,0,0,1,1,100%
1750,BRANSON REORGANIZED 82,0974,BRANSON ELEMENTARY SCHOOL,4TH,0,0,1,0,2,3,1,33%
1750,BRANSON REORGANIZED 82,0974,BRANSON ELEMENTARY SCHOOL,5TH,0,0,0,0,1,1,0,0%
1750,BRANSON REORGANIZED 82,0974,BRANSON ELEMENTARY SCHOOL,6TH,0,0,1,0,3,4,1,25%
1750,BRANSON REORGANIZED 82,0974,BRANSON ELEMENTARY SCHOOL,SCHOOL TOTAL,0,0,5,3,12,20,8,40%
1750,BRANSON REORGANIZED 82,0978,BRANSON UNDIVIDED HIGH SCHOOL,10TH,0,0,0,1,3,4,1,25%
1750,BRANSON REORGANIZED 82,0978,BRANSON UNDIVIDED HIGH SCHOOL,11TH,0,0,0,0,5,5,0,0%
1750,BRANSON REORGANIZED 82,0978,BRANSON UNDIVIDED HIGH SCHOOL,12TH,0,0,0,0,2,2,0,0%
1750,BRANSON REORGANIZED 82,0978,BRANSON UNDIVIDED HIGH SCHOOL,SCHOOL TOTAL,0,0,0,1,10,11,1,9%
1750,BRANSON REORGANIZED 82,0979,BRANSON SCHOOL ONLINE GED PREP,9TH,0,0,0,0,3,3,0,0%
1750,BRANSON REORGANIZED 82,0979,BRANSON SCHOOL ONLINE GED PREP,10TH,0,0,0,0,10,10,0,0%
1750,BRANSON REORGANIZED 82,0979,BRANSON SCHOOL ONLINE GED PREP,11TH,0,0,0,0,2,2,0,0%
1750,BRANSON REORGANIZED 82,0979,BRANSON SCHOOL ONLINE GED PREP,SCHOOL TOTAL,0,0,0,0,15,15,0,0%
1750,BRANSON REORGANIZED 82,,DISTRICT TOTAL,,8,0,12,64,409,493,84,17%
1760,KIM REORGANIZED 88,4690,KIM ELEMENTARY SCHOOL,PK,0,0,0,1,2,3,1,33%
1760,KIM REORGANIZED 88,4690,KIM ELEMENTARY SCHOOL,KINDERGARTEN,0,0,0,0,3,3,0,0%
1760,KIM REORGANIZED 88,4690,KIM ELEMENTARY SCHOOL,1ST,0,0,0,0,5,5,0,0%
1760,KIM REORGANIZED 88,4690,KIM ELEMENTARY SCHOOL,2ND,0,0,0,1,2,3,1,33%
1760,KIM REORGANIZED 88,4690,KIM ELEMENTARY SCHOOL,3RD,0,0,0,0,3,3,0,0%
1760,KIM REORGANIZED 88,4690,KIM ELEMENTARY SCHOOL,4TH,0,0,0,0,4,4,0,0%
1760,KIM REORGANIZED 88,4690,KIM ELEMENTARY SCHOOL,5TH,0,0,0,0,5,5,0,0%
1760,KIM REORGANIZED 88,4690,KIM ELEMENTARY SCHOOL,6TH,0,0,0,0,2,2,0,0%
1760,KIM REORGANIZED 88,4690,KIM ELEMENTARY SCHOOL,SCHOOL TOTAL,0,0,0,2,26,28,2,7%
1760,KIM REORGANIZED 88,4694,KIM UNDIVIDED HIGH SCHOOL,7TH,0,0,0,1,5,6,1,17%
1760,KIM REORGANIZED 88,4694,KIM UNDIVIDED HIGH SCHOOL,8TH,0,0,0,0,1,1,0,0%
1760,KIM REORGANIZED 88,4694,KIM UNDIVIDED HIGH SCHOOL,9TH,0,0,0,0,6,6,0,0%
1760,KIM REORGANIZED 88,4694,KIM UNDIVIDED HIGH SCHOOL,10TH,0,0,0,0,7,7,0,0%
1760,KIM REORGANIZED 88,4694,KIM UNDIVIDED HIGH SCHOOL,11TH,0,0,0,0,6,6,0,0%
1760,KIM REORGANIZED 88,4694,KIM UNDIVIDED HIGH SCHOOL,12TH,0,0,0,0,7,7,0,0%
1760,KIM REORGANIZED 88,4694,KIM UNDIVIDED HIGH SCHOOL,SCHOOL TOTAL,0,0,0,1,32,33,1,3%
1760,KIM REORGANIZED 88,,DISTRICT TOTAL,,0,0,0,3,58,61,3,5%
1780,GENOA-HUGO C113,4158,GENOA-HUGO ELEMENTARY SCHOOL,PK,0,0,2,0,17,19,2,11%
1780,GENOA-HUGO C113,4158,GENOA-HUGO ELEMENTARY SCHOOL,KINDERGARTEN,0,0,0,0,12,12,0,0%
1780,GENOA-HUGO C113,4158,GENOA-HUGO ELEMENTARY SCHOOL,1ST,0,0,0,2,12,14,2,14%
1780,GENOA-HUGO C113,4158,GENOA-HUGO ELEMENTARY SCHOOL,2ND,0,0,0,1,10,11,1,9%
1780,GENOA-HUGO C113,4158,GENOA-HUGO ELEMENTARY SCHOOL,3RD,0,0,0,1,13,14,1,7%
1780,GENOA-HUGO C113,4158,GENOA-HUGO ELEMENTARY SCHOOL,4TH,0,0,0,1,15,16,1,6%
1780,GENOA-HUGO C113,4158,GENOA-HUGO ELEMENTARY SCHOOL,5TH,0,0,1,2,11,14,3,21%
1780,GENOA-HUGO C113,4158,GENOA-HUGO ELEMENTARY SCHOOL,SCHOOL TOTAL,0,0,3,7,90,100,10,10%
1780,GENOA-HUGO C113,4160,GENOA-HUGO MIDDLE SCHOOL,6TH,0,0,0,2,10,12,2,17%
1780,GENOA-HUGO C113,4160,GENOA-HUGO MIDDLE SCHOOL,7TH,0,0,0,1,12,13,1,8%
1780,GENOA-HUGO C113,4160,GENOA-HUGO MIDDLE SCHOOL,8TH,0,0,0,0,12,12,0,0%
1780,GENOA-HUGO C113,4160,GENOA-HUGO MIDDLE SCHOOL,SCHOOL TOTAL,0,0,0,3,34,37,3,8%
1780,GENOA-HUGO C113,4162,GENOA-HUGO SENIOR HIGH SCHOOL,9TH,0,0,1,0,11,12,1,8%
1780,GENOA-HUGO C113,4162,GENOA-HUGO SENIOR HIGH SCHOOL,10TH,0,0,0,0,15,15,0,0%
1780,GENOA-HUGO C113,4162,GENOA-HUGO SENIOR HIGH SCHOOL,11TH,0,0,0,0,13,13,0,0%
1780,GENOA-HUGO C113,4162,GENOA-HUGO SENIOR HIGH SCHOOL,12TH,0,0,0,1,12,13,1,8%
1780,GENOA-HUGO C113,4162,GENOA-HUGO SENIOR HIGH SCHOOL,SCHOOL TOTAL,0,0,1,1,51,53,2,4%
1780,GENOA-HUGO C113,,DISTRICT TOTAL,,0,0,4,11,175,190,15,8%
1790,LIMON RE-4J,5132,LIMON ELEMENTARY SCHOOL,KINDERGARTEN,0,2,4,4,28,38,10,26%
1790,LIMON RE-4J,5132,LIMON ELEMENTARY SCHOOL,1ST,1,2,0,7,22,32,10,31%
1790,LIMON RE-4J,5132,LIMON ELEMENTARY SCHOOL,2ND,1,0,1,5,16,23,7,30%
1790,LIMON RE-4J,5132,LIMON ELEMENTARY SCHOOL,3RD,0,0,1,3,27,31,4,13%
1790,LIMON RE-4J,5132,LIMON ELEMENTARY SCHOOL,4TH,0,1,1,5,19,26,7,27%
1790,LIMON RE-4J,5132,LIMON ELEMENTARY SCHOOL,5TH,0,0,1,3,20,24,4,17%
1790,LIMON RE-4J,5132,LIMON ELEMENTARY SCHOOL,SCHOOL TOTAL,2,5,8,27,132,174,42,24%
1790,LIMON RE-4J,5136,LIMON JUNIOR-SENIOR HIGH SCHOOL,6TH,0,0,3,4,32,39,7,18%
1790,LIMON RE-4J,5136,LIMON JUNIOR-SENIOR HIGH SCHOOL,7TH,0,0,1,1,33,35,2,6%
1790,LIMON RE-4J,5136,LIMON JUNIOR-SENIOR HIGH SCHOOL,8TH,2,0,4,1,30,37,7,19%
1790,LIMON RE-4J,5136,LIMON JUNIOR-SENIOR HIGH SCHOOL,9TH,0,0,1,3,33,37,4,11%
1790,LIMON RE-4J,5136,LIMON JUNIOR-SENIOR HIGH SCHOOL,10TH,1,0,2,4,48,55,7,13%
1790,LIMON RE-4J,5136,LIMON JUNIOR-SENIOR HIGH SCHOOL,11TH,0,0,2,5,30,37,7,19%
1790,LIMON RE-4J,5136,LIMON JUNIOR-SENIOR HIGH SCHOOL,12TH,2,0,2,3,27,34,7,21%
1790,LIMON RE-4J,5136,LIMON JUNIOR-SENIOR HIGH SCHOOL,SCHOOL TOTAL,5,0,15,21,233,274,41,15%
1790,LIMON RE-4J,,DISTRICT TOTAL,,7,5,23,48,365,448,83,19%
1810,KARVAL RE-23,4502,KARVAL ELEMENTARY SCHOOL,PK,0,0,0,0,6,6,0,0%
1810,KARVAL RE-23,4502,KARVAL ELEMENTARY SCHOOL,KINDERGARTEN,0,0,0,0,5,5,0,0%
1810,KARVAL RE-23,4502,KARVAL ELEMENTARY SCHOOL,1ST,0,0,0,0,2,2,0,0%
1810,KARVAL RE-23,4502,KARVAL ELEMENTARY SCHOOL,2ND,0,0,0,0,1,1,0,0%
1810,KARVAL RE-23,4502,KARVAL ELEMENTARY SCHOOL,3RD,0,0,0,0,4,4,0,0%
1810,KARVAL RE-23,4502,KARVAL ELEMENTARY SCHOOL,4TH,0,0,0,0,1,1,0,0%
1810,KARVAL RE-23,4502,KARVAL ELEMENTARY SCHOOL,5TH,0,0,0,0,1,1,0,0%
1810,KARVAL RE-23,4502,KARVAL ELEMENTARY SCHOOL,SCHOOL TOTAL,0,0,0,0,20,20,0,0%
1810,KARVAL RE-23,4504,KARVAL ONLINE EDUCATION,HALF DAY K,0,0,0,1,2,3,1,33%
1810,KARVAL RE-23,4504,KARVAL ONLINE EDUCATION,1ST,0,0,1,1,5,7,2,29%
1810,KARVAL RE-23,4504,KARVAL ONLINE EDUCATION,2ND,0,0,0,1,2,3,1,33%
1810,KARVAL RE-23,4504,KARVAL ONLINE EDUCATION,3RD,0,0,0,1,5,6,1,17%
1810,KARVAL RE-23,4504,KARVAL ONLINE EDUCATION,4TH,0,0,0,2,5,7,2,29%
1810,KARVAL RE-23,4504,KARVAL ONLINE EDUCATION,5TH,0,0,0,0,4,4,0,0%
1810,KARVAL RE-23,4504,KARVAL ONLINE EDUCATION,6TH,0,0,1,0,6,7,1,14%
1810,KARVAL RE-23,4504,KARVAL ONLINE EDUCATION,7TH,0,0,3,1,16,20,4,20%
1810,KARVAL RE-23,4504,KARVAL ONLINE EDUCATION,8TH,1,0,0,0,12,13,1,8%
1810,KARVAL RE-23,4504,KARVAL ONLINE EDUCATION,9TH,1,0,5,8,21,35,14,40%
1810,KARVAL RE-23,4504,KARVAL ONLINE EDUCATION,10TH,0,1,2,4,31,38,7,18%
1810,KARVAL RE-23,4504,KARVAL ONLINE EDUCATION,11TH,0,0,3,3,23,29,6,21%
1810,KARVAL RE-23,4504,KARVAL ONLINE EDUCATION,12TH,1,0,1,6,28,36,8,22%
1810,KARVAL RE-23,4504,KARVAL ONLINE EDUCATION,SCHOOL TOTAL,3,1,16,28,160,208,48,23%
1810,KARVAL RE-23,4506,KARVAL JUNIOR-SENIOR HIGH SCHOOL,6TH,0,0,0,0,10,10,0,0%
1810,KARVAL RE-23,4506,KARVAL JUNIOR-SENIOR HIGH SCHOOL,7TH,0,0,0,0,2,2,0,0%
1810,KARVAL RE-23,4506,KARVAL JUNIOR-SENIOR HIGH SCHOOL,8TH,0,1,0,0,4,5,1,20%
1810,KARVAL RE-23,4506,KARVAL JUNIOR-SENIOR HIGH SCHOOL,9TH,0,0,0,0,4,4,0,0%
1810,KARVAL RE-23,4506,KARVAL JUNIOR-SENIOR HIGH SCHOOL,10TH,0,0,0,0,3,3,0,0%
1810,KARVAL RE-23,4506,KARVAL JUNIOR-SENIOR HIGH SCHOOL,11TH,0,2,0,0,9,11,2,18%
1810,KARVAL RE-23,4506,KARVAL JUNIOR-SENIOR HIGH SCHOOL,12TH,0,0,0,0,10,10,0,0%
1810,KARVAL RE-23,4506,KARVAL JUNIOR-SENIOR HIGH SCHOOL,SCHOOL TOTAL,0,3,0,0,42,45,3,7%
1810,KARVAL RE-23,,DISTRICT TOTAL,,3,4,16,28,222,273,51,19%
1828,VALLEY RE-1,0202,SMITH HIGH SCHOOL,9TH,0,0,1,0,4,5,1,20%
1828,VALLEY RE-1,0202,SMITH HIGH SCHOOL,10TH,0,0,0,3,4,7,3,43%
1828,VALLEY RE-1,0202,SMITH HIGH SCHOOL,11TH,0,0,0,2,9,11,2,18%
1828,VALLEY RE-1,0202,SMITH HIGH SCHOOL,12TH,0,0,0,1,2,3,1,33%
1828,VALLEY RE-1,0202,SMITH HIGH SCHOOL,SCHOOL TOTAL,0,0,1,6,19,26,7,27%
1828,VALLEY RE-1,0515,AYRES ELEMENTARY SCHOOL,HALF DAY K,2,0,2,28,126,158,32,20%
1828,VALLEY RE-1,0515,AYRES ELEMENTARY SCHOOL,1ST,5,0,4,32,125,166,41,25%
1828,VALLEY RE-1,0515,AYRES ELEMENTARY SCHOOL,2ND,2,3,1,27,111,144,33,23%
1828,VALLEY RE-1,0515,AYRES ELEMENTARY SCHOOL,SCHOOL TOTAL,9,3,7,87,362,468,106,23%
1828,VALLEY RE-1,1220,CALICHE ELEMENTARY SCHOOL,PK,0,0,0,1,24,25,1,4%
1828,VALLEY RE-1,1220,CALICHE ELEMENTARY SCHOOL,HALF DAY K,0,0,0,2,13,15,2,13%
1828,VALLEY RE-1,1220,CALICHE ELEMENTARY SCHOOL,1ST,1,0,0,2,20,23,3,13%
1828,VALLEY RE-1,1220,CALICHE ELEMENTARY SCHOOL,2ND,0,0,0,0,14,14,0,0%
1828,VALLEY RE-1,1220,CALICHE ELEMENTARY SCHOOL,3RD,0,0,3,2,16,21,5,24%
1828,VALLEY RE-1,1220,CALICHE ELEMENTARY SCHOOL,4TH,1,0,0,3,20,24,4,17%
1828,VALLEY RE-1,1220,CALICHE ELEMENTARY SCHOOL,5TH,0,0,0,1,22,23,1,4%
1828,VALLEY RE-1,1220,CALICHE ELEMENTARY SCHOOL,6TH,0,0,0,2,16,18,2,11%
1828,VALLEY RE-1,1220,CALICHE ELEMENTARY SCHOOL,SCHOOL TOTAL,2,0,3,13,145,163,18,11%
1828,VALLEY RE-1,1224,CALICHE JUNIOR-SENIOR HIGH SCHOOL,7TH,1,0,0,0,14,15,1,7%
1828,VALLEY RE-1,1224,CALICHE JUNIOR-SENIOR HIGH SCHOOL,8TH,0,0,0,5,26,31,5,16%
1828,VALLEY RE-1,1224,CALICHE JUNIOR-SENIOR HIGH SCHOOL,9TH,0,0,0,4,17,21,4,19%
1828,VALLEY RE-1,1224,CALICHE JUNIOR-SENIOR HIGH SCHOOL,10TH,1,0,1,0,15,17,2,12%
1828,VALLEY RE-1,1224,CALICHE JUNIOR-SENIOR HIGH SCHOOL,11TH,0,0,0,2,17,19,2,11%
1828,VALLEY RE-1,1224,CALICHE JUNIOR-SENIOR HIGH SCHOOL,12TH,0,0,0,1,13,14,1,7%
1828,VALLEY RE-1,1224,CALICHE JUNIOR-SENIOR HIGH SCHOOL,SCHOOL TOTAL,2,0,1,12,102,117,15,13%
1828,VALLEY RE-1,1321,CAMPBELL ELEMENTARY SCHOOL,3RD,4,3,3,33,124,167,43,26%
1828,VALLEY RE-1,1321,CAMPBELL ELEMENTARY SCHOOL,4TH,1,2,2,27,116,148,32,22%
1828,VALLEY RE-1,1321,CAMPBELL ELEMENTARY SCHOOL,5TH,1,0,2,35,115,153,38,25%
1828,VALLEY RE-1,1321,CAMPBELL ELEMENTARY SCHOOL,SCHOOL TOTAL,6,5,7,95,355,468,113,24%
1828,VALLEY RE-1,3729,HAGEN EARLY EDUCATION CENTER,PK,2,2,4,31,98,137,39,28%
1828,VALLEY RE-1,3729,HAGEN EARLY EDUCATION CENTER,SCHOOL TOTAL,2,2,4,31,98,137,39,28%
1828,VALLEY RE-1,8256,STERLING MIDDLE SCHOOL,6TH,0,2,2,37,124,165,41,25%
1828,VALLEY RE-1,8256,STERLING MIDDLE SCHOOL,7TH,1,2,2,34,124,163,39,24%
1828,VALLEY RE-1,8256,STERLING MIDDLE SCHOOL,8TH,1,1,0,34,111,147,36,24%
1828,VALLEY RE-1,8256,STERLING MIDDLE SCHOOL,SCHOOL TOTAL,2,5,4,105,359,475,116,24%
1828,VALLEY RE-1,8260,STERLING HIGH SCHOOL,9TH,6,2,1,27,133,169,36,21%
1828,VALLEY RE-1,8260,STERLING HIGH SCHOOL,10TH,3,2,5,30,120,160,40,25%
1828,VALLEY RE-1,8260,STERLING HIGH SCHOOL,11TH,2,3,0,22,132,159,27,17%
1828,VALLEY RE-1,8260,STERLING HIGH SCHOOL,12TH,1,1,4,27,127,160,33,21%
1828,VALLEY RE-1,8260,STERLING HIGH SCHOOL,SCHOOL TOTAL,12,8,10,106,512,648,136,21%
1828,VALLEY RE-1,,DISTRICT TOTAL,,35,23,37,455,1952,2502,550,22%
1850,FRENCHMAN RE-3,2980,FLEMING ELEMENTARY SCHOOL,PK,0,0,0,1,12,13,1,8%
1850,FRENCHMAN RE-3,2980,FLEMING ELEMENTARY SCHOOL,KINDERGARTEN,0,0,0,3,12,15,3,20%
1850,FRENCHMAN RE-3,2980,FLEMING ELEMENTARY SCHOOL,1ST,0,0,0,3,13,16,3,19%
1850,FRENCHMAN RE-3,2980,FLEMING ELEMENTARY SCHOOL,2ND,0,0,0,1,9,10,1,10%
1850,FRENCHMAN RE-3,2980,FLEMING ELEMENTARY SCHOOL,3RD,0,0,0,1,6,7,1,14%
1850,FRENCHMAN RE-3,2980,FLEMING ELEMENTARY SCHOOL,4TH,0,0,0,3,10,13,3,23%
1850,FRENCHMAN RE-3,2980,FLEMING ELEMENTARY SCHOOL,5TH,0,0,0,1,21,22,1,5%
1850,FRENCHMAN RE-3,2980,FLEMING ELEMENTARY SCHOOL,6TH,0,0,0,1,7,8,1,13%
1850,FRENCHMAN RE-3,2980,FLEMING ELEMENTARY SCHOOL,SCHOOL TOTAL,0,0,0,14,90,104,14,13%
1850,FRENCHMAN RE-3,2988,FLEMING HIGH SCHOOL,7TH,0,0,0,1,13,14,1,7%
1850,FRENCHMAN RE-3,2988,FLEMING HIGH SCHOOL,8TH,0,0,0,1,10,11,1,9%
1850,FRENCHMAN RE-3,2988,FLEMING HIGH SCHOOL,9TH,0,0,0,2,17,19,2,11%
1850,FRENCHMAN RE-3,2988,FLEMING HIGH SCHOOL,10TH,0,1,0,1,13,15,2,13%
1850,FRENCHMAN RE-3,2988,FLEMING HIGH SCHOOL,11TH,0,0,0,0,13,13,0,0%
1850,FRENCHMAN RE-3,2988,FLEMING HIGH SCHOOL,12TH,0,0,0,0,12,12,0,0%
1850,FRENCHMAN RE-3,2988,FLEMING HIGH SCHOOL,SCHOOL TOTAL,0,1,0,5,78,84,6,7%
1850,FRENCHMAN RE-3,,DISTRICT TOTAL,,0,1,0,19,168,188,20,11%
1860,BUFFALO RE-4J,5802,MERINO ELEMENTARY SCHOOL,KINDERGARTEN,0,0,2,2,17,21,4,19%
1860,BUFFALO RE-4J,5802,MERINO ELEMENTARY SCHOOL,1ST,1,0,0,0,22,23,1,4%
1860,BUFFALO RE-4J,5802,MERINO ELEMENTARY SCHOOL,2ND,0,0,1,1,19,21,2,10%
1860,BUFFALO RE-4J,5802,MERINO ELEMENTARY SCHOOL,3RD,1,0,0,0,21,22,1,5%
1860,BUFFALO RE-4J,5802,MERINO ELEMENTARY SCHOOL,4TH,0,0,0,1,23,24,1,4%
1860,BUFFALO RE-4J,5802,MERINO ELEMENTARY SCHOOL,5TH,0,0,2,5,20,27,7,26%
1860,BUFFALO RE-4J,5802,MERINO ELEMENTARY SCHOOL,6TH,1,1,0,1,26,29,3,10%
1860,BUFFALO RE-4J,5802,MERINO ELEMENTARY SCHOOL,SCHOOL TOTAL,3,1,5,10,148,167,19,11%
1860,BUFFALO RE-4J,5806,MERINO JUNIOR SENIOR HIGH SCHOOL,7TH,0,0,1,3,21,25,4,16%
1860,BUFFALO RE-4J,5806,MERINO JUNIOR SENIOR HIGH SCHOOL,8TH,1,2,1,0,18,22,4,18%
1860,BUFFALO RE-4J,5806,MERINO JUNIOR SENIOR HIGH SCHOOL,9TH,0,1,0,0,20,21,1,5%
1860,BUFFALO RE-4J,5806,MERINO JUNIOR SENIOR HIGH SCHOOL,10TH,0,0,1,1,19,21,2,10%
1860,BUFFALO RE-4J,5806,MERINO JUNIOR SENIOR HIGH SCHOOL,11TH,0,0,0,4,18,22,4,18%
1860,BUFFALO RE-4J,5806,MERINO JUNIOR SENIOR HIGH SCHOOL,12TH,0,0,0,3,25,28,3,11%
1860,BUFFALO RE-4J,5806,MERINO JUNIOR SENIOR HIGH SCHOOL,SCHOOL TOTAL,1,3,3,11,121,139,18,13%
1860,BUFFALO RE-4J,,DISTRICT TOTAL,,4,4,8,21,269,306,37,12%
1870,PLATEAU RE-5,6834,PEETZ ELEMENTARY SCHOOL,PK,0,0,0,0,13,13,0,0%
1870,PLATEAU RE-5,6834,PEETZ ELEMENTARY SCHOOL,KINDERGARTEN,0,0,0,0,4,4,0,0%
1870,PLATEAU RE-5,6834,PEETZ ELEMENTARY SCHOOL,1ST,0,0,0,0,12,12,0,0%
1870,PLATEAU RE-5,6834,PEETZ ELEMENTARY SCHOOL,2ND,0,0,0,0,10,10,0,0%
1870,PLATEAU RE-5,6834,PEETZ ELEMENTARY SCHOOL,3RD,0,0,1,0,10,11,1,9%
1870,PLATEAU RE-5,6834,PEETZ ELEMENTARY SCHOOL,4TH,0,0,0,0,13,13,0,0%
1870,PLATEAU RE-5,6834,PEETZ ELEMENTARY SCHOOL,5TH,0,0,1,1,11,13,2,15%
1870,PLATEAU RE-5,6834,PEETZ ELEMENTARY SCHOOL,6TH,0,0,0,0,17,17,0,0%
1870,PLATEAU RE-5,6834,PEETZ ELEMENTARY SCHOOL,SCHOOL TOTAL,0,0,2,1,90,93,3,3%
1870,PLATEAU RE-5,6838,PEETZ JUNIOR-SENIOR HIGH SCHOOL,7TH,0,0,0,0,10,10,0,0%
1870,PLATEAU RE-5,6838,PEETZ JUNIOR-SENIOR HIGH SCHOOL,8TH,0,0,1,0,14,15,1,7%
1870,PLATEAU RE-5,6838,PEETZ JUNIOR-SENIOR HIGH SCHOOL,9TH,0,0,0,0,8,8,0,0%
1870,PLATEAU RE-5,6838,PEETZ JUNIOR-SENIOR HIGH SCHOOL,10TH,0,0,1,0,10,11,1,9%
1870,PLATEAU RE-5,6838,PEETZ JUNIOR-SENIOR HIGH SCHOOL,11TH,0,0,1,1,8,10,2,20%
1870,PLATEAU RE-5,6838,PEETZ JUNIOR-SENIOR HIGH SCHOOL,12TH,0,0,0,1,15,16,1,6%
1870,PLATEAU RE-5,6838,PEETZ JUNIOR-SENIOR HIGH SCHOOL,SCHOOL TOTAL,0,0,3,2,65,70,5,7%
1870,PLATEAU RE-5,,DISTRICT TOTAL,,0,0,5,3,155,163,8,5%
1980,DE BEQUE 49JT,2122,DE BEQUE ELEMENTARY SCHOOL,PK,0,0,0,3,25,28,3,11%
1980,DE BEQUE 49JT,2122,DE BEQUE ELEMENTARY SCHOOL,KINDERGARTEN,0,0,0,1,15,16,1,6%
1980,DE BEQUE 49JT,2122,DE BEQUE ELEMENTARY SCHOOL,1ST,0,0,0,1,12,13,1,8%
1980,DE BEQUE 49JT,2122,DE BEQUE ELEMENTARY SCHOOL,2ND,0,0,0,1,11,12,1,8%
1980,DE BEQUE 49JT,2122,DE BEQUE ELEMENTARY SCHOOL,3RD,0,0,0,3,9,12,3,25%
1980,DE BEQUE 49JT,2122,DE BEQUE ELEMENTARY SCHOOL,4TH,0,0,0,0,8,8,0,0%
1980,DE BEQUE 49JT,2122,DE BEQUE ELEMENTARY SCHOOL,5TH,0,0,0,0,7,7,0,0%
1980,DE BEQUE 49JT,2122,DE BEQUE ELEMENTARY SCHOOL,6TH,1,0,0,1,10,12,2,17%
1980,DE BEQUE 49JT,2122,DE BEQUE ELEMENTARY SCHOOL,SCHOOL TOTAL,1,0,0,10,97,108,11,10%
1980,DE BEQUE 49JT,2126,DE BEQUE UNDIVIDED HIGH SCHOOL,7TH,0,1,0,2,8,11,3,27%
1980,DE BEQUE 49JT,2126,DE BEQUE UNDIVIDED HIGH SCHOOL,8TH,0,0,0,0,6,6,0,0%
1980,DE BEQUE 49JT,2126,DE BEQUE UNDIVIDED HIGH SCHOOL,9TH,0,1,0,1,7,9,2,22%
1980,DE BEQUE 49JT,2126,DE BEQUE UNDIVIDED HIGH SCHOOL,10TH,1,0,0,2,10,13,3,23%
1980,DE BEQUE 49JT,2126,DE BEQUE UNDIVIDED HIGH SCHOOL,11TH,0,0,0,2,6,8,2,25%
1980,DE BEQUE 49JT,2126,DE BEQUE UNDIVIDED HIGH SCHOOL,12TH,0,0,0,1,4,5,1,20%
1980,DE BEQUE 49JT,2126,DE BEQUE UNDIVIDED HIGH SCHOOL,SCHOOL TOTAL,1,2,0,8,41,52,11,21%
1980,DE BEQUE 49JT,,DISTRICT TOTAL,,2,2,0,18,138,160,22,14%
1990,PLATEAU VALLEY 50,3582,GRAND MESA HIGH SCHOOL,9TH,1,2,9,12,21,45,24,53%
1990,PLATEAU VALLEY 50,3582,GRAND MESA HIGH SCHOOL,10TH,1,0,8,10,18,37,19,51%
1990,PLATEAU VALLEY 50,3582,GRAND MESA HIGH SCHOOL,11TH,0,0,6,6,21,33,12,36%
1990,PLATEAU VALLEY 50,3582,GRAND MESA HIGH SCHOOL,12TH,1,1,2,20,25,49,24,49%
1990,PLATEAU VALLEY 50,3582,GRAND MESA HIGH SCHOOL,SCHOOL TOTAL,3,3,25,48,85,164,79,48%
1990,PLATEAU VALLEY 50,7024,PLATEAU VALLEY ELEMENTARY SCHOOL,PK,0,1,0,2,22,25,3,12%
1990,PLATEAU VALLEY 50,7024,PLATEAU VALLEY ELEMENTARY SCHOOL,KINDERGARTEN,0,0,0,2,26,28,2,7%
1990,PLATEAU VALLEY 50,7024,PLATEAU VALLEY ELEMENTARY SCHOOL,1ST,0,1,0,1,18,20,2,10%
1990,PLATEAU VALLEY 50,7024,PLATEAU VALLEY ELEMENTARY SCHOOL,2ND,0,0,0,2,21,23,2,9%
1990,PLATEAU VALLEY 50,7024,PLATEAU VALLEY ELEMENTARY SCHOOL,3RD,0,0,0,3,28,31,3,10%
1990,PLATEAU VALLEY 50,7024,PLATEAU VALLEY ELEMENTARY SCHOOL,4TH,0,0,0,4,24,28,4,14%
1990,PLATEAU VALLEY 50,7024,PLATEAU VALLEY ELEMENTARY SCHOOL,5TH,0,0,0,2,18,20,2,10%
1990,PLATEAU VALLEY 50,7024,PLATEAU VALLEY ELEMENTARY SCHOOL,SCHOOL TOTAL,0,2,0,16,157,175,18,10%
1990,PLATEAU VALLEY 50,7028,PLATEAU VALLEY MIDDLE SCHOOL,6TH,0,0,0,5,14,19,5,26%
1990,PLATEAU VALLEY 50,7028,PLATEAU VALLEY MIDDLE SCHOOL,7TH,0,0,0,2,12,14,2,14%
1990,PLATEAU VALLEY 50,7028,PLATEAU VALLEY MIDDLE SCHOOL,8TH,0,0,0,2,21,23,2,9%
1990,PLATEAU VALLEY 50,7028,PLATEAU VALLEY MIDDLE SCHOOL,SCHOOL TOTAL,0,0,0,9,47,56,9,16%
1990,PLATEAU VALLEY 50,7032,PLATEAU VALLEY HIGH SCHOOL,9TH,0,0,0,5,15,20,5,25%
1990,PLATEAU VALLEY 50,7032,PLATEAU VALLEY HIGH SCHOOL,10TH,1,0,0,3,21,25,4,16%
1990,PLATEAU VALLEY 50,7032,PLATEAU VALLEY HIGH SCHOOL,11TH,0,0,0,2,22,24,2,8%
1990,PLATEAU VALLEY 50,7032,PLATEAU VALLEY HIGH SCHOOL,12TH,0,0,0,3,22,25,3,12%
1990,PLATEAU VALLEY 50,7032,PLATEAU VALLEY HIGH SCHOOL,SCHOOL TOTAL,1,0,0,13,80,94,14,15%
1990,PLATEAU VALLEY 50,,DISTRICT TOTAL,,4,5,25,86,369,489,120,25%
2000,MESA COUNTY VALLEY 51,0000,NOT IN A SCHOOL,7TH,0,0,0,0,1,1,0,0%
2000,MESA COUNTY VALLEY 51,0000,NOT IN A SCHOOL,8TH,0,0,0,1,1,2,1,50%
2000,MESA COUNTY VALLEY 51,0000,NOT IN A SCHOOL,9TH,0,0,0,0,4,4,0,0%
2000,MESA COUNTY VALLEY 51,0000,NOT IN A SCHOOL,10TH,0,0,0,0,5,5,0,0%
2000,MESA COUNTY VALLEY 51,0000,NOT IN A SCHOOL,11TH,0,0,0,1,4,5,1,20%
2000,MESA COUNTY VALLEY 51,0000,NOT IN A SCHOOL,12TH,0,0,0,2,3,5,2,40%
2000,MESA COUNTY VALLEY 51,0000,NOT IN A SCHOOL,SCHOOL TOTAL,0,0,0,4,18,22,4,18%
2000,MESA COUNTY VALLEY 51,0262,APPLETON ELEMENTARY SCHOOL,PK,0,3,0,3,21,27,6,22%
2000,MESA COUNTY VALLEY 51,0262,APPLETON ELEMENTARY SCHOOL,HALF DAY K,0,5,0,8,48,61,13,21%
2000,MESA COUNTY VALLEY 51,0262,APPLETON ELEMENTARY SCHOOL,1ST,0,1,0,5,62,68,6,9%
2000,MESA COUNTY VALLEY 51,0262,APPLETON ELEMENTARY SCHOOL,2ND,0,3,0,5,55,63,8,13%
2000,MESA COUNTY VALLEY 51,0262,APPLETON ELEMENTARY SCHOOL,3RD,0,2,2,5,48,57,9,16%
2000,MESA COUNTY VALLEY 51,0262,APPLETON ELEMENTARY SCHOOL,4TH,0,1,0,4,50,55,5,9%
2000,MESA COUNTY VALLEY 51,0262,APPLETON ELEMENTARY SCHOOL,5TH,0,2,0,8,62,72,10,14%
2000,MESA COUNTY VALLEY 51,0262,APPLETON ELEMENTARY SCHOOL,SCHOOL TOTAL,0,17,2,38,346,403,57,14%
2000,MESA COUNTY VALLEY 51,0361,FRUITA 8/9 SCHOOL,8TH,1,2,2,40,251,296,45,15%
2000,MESA COUNTY VALLEY 51,0361,FRUITA 8/9 SCHOOL,9TH,1,3,5,39,376,424,48,11%
2000,MESA COUNTY VALLEY 51,0361,FRUITA 8/9 SCHOOL,SCHOOL TOTAL,2,5,7,79,627,720,93,13%
2000,MESA COUNTY VALLEY 51,0362,RIM ROCK ELEMENTARY SCHOOL,PK,1,0,0,5,24,30,6,20%
2000,MESA COUNTY VALLEY 51,0362,RIM ROCK ELEMENTARY SCHOOL,HALF DAY K,2,1,0,14,74,91,17,19%
2000,MESA COUNTY VALLEY 51,0362,RIM ROCK ELEMENTARY SCHOOL,1ST,1,2,1,12,80,96,16,17%
2000,MESA COUNTY VALLEY 51,0362,RIM ROCK ELEMENTARY SCHOOL,2ND,1,1,0,16,91,109,18,17%
2000,MESA COUNTY VALLEY 51,0362,RIM ROCK ELEMENTARY SCHOOL,3RD,0,1,3,14,87,105,18,17%
2000,MESA COUNTY VALLEY 51,0362,RIM ROCK ELEMENTARY SCHOOL,4TH,3,1,0,11,100,115,15,13%
2000,MESA COUNTY VALLEY 51,0362,RIM ROCK ELEMENTARY SCHOOL,5TH,1,0,1,5,76,83,7,8%
2000,MESA COUNTY VALLEY 51,0362,RIM ROCK ELEMENTARY SCHOOL,SCHOOL TOTAL,9,6,5,77,532,629,97,15%
2000,MESA COUNTY VALLEY 51,0363,PEAR PARK ELEMENTARY SCHOOL,PK,0,0,0,3,27,30,3,10%
2000,MESA COUNTY VALLEY 51,0363,PEAR PARK ELEMENTARY SCHOOL,HALF DAY K,1,1,1,13,35,51,16,31%
2000,MESA COUNTY VALLEY 51,0363,PEAR PARK ELEMENTARY SCHOOL,KINDERGARTEN,0,1,0,1,5,7,2,29%
2000,MESA COUNTY VALLEY 51,0363,PEAR PARK ELEMENTARY SCHOOL,1ST,1,0,2,20,60,83,23,28%
2000,MESA COUNTY VALLEY 51,0363,PEAR PARK ELEMENTARY SCHOOL,2ND,0,0,0,20,50,70,20,29%
2000,MESA COUNTY VALLEY 51,0363,PEAR PARK ELEMENTARY SCHOOL,3RD,1,0,0,17,43,61,18,30%
2000,MESA COUNTY VALLEY 51,0363,PEAR PARK ELEMENTARY SCHOOL,4TH,2,0,2,18,58,80,22,28%
2000,MESA COUNTY VALLEY 51,0363,PEAR PARK ELEMENTARY SCHOOL,5TH,2,1,0,13,49,65,16,25%
2000,MESA COUNTY VALLEY 51,0363,PEAR PARK ELEMENTARY SCHOOL,SCHOOL TOTAL,7,3,5,105,327,447,120,27%
2000,MESA COUNTY VALLEY 51,0900,BOOKCLIFF MIDDLE SCHOOL,6TH,2,1,2,58,127,190,63,33%
2000,MESA COUNTY VALLEY 51,0900,BOOKCLIFF MIDDLE SCHOOL,7TH,4,3,4,66,111,188,77,41%
2000,MESA COUNTY VALLEY 51,0900,BOOKCLIFF MIDDLE SCHOOL,8TH,0,3,6,51,109,169,60,36%
2000,MESA COUNTY VALLEY 51,0900,BOOKCLIFF MIDDLE SCHOOL,SCHOOL TOTAL,6,7,12,175,347,547,200,37%
2000,MESA COUNTY VALLEY 51,1046,BROADWAY ELEMENTARY SCHOOL,PK,0,0,1,3,19,23,4,17%
2000,MESA COUNTY VALLEY 51,1046,BROADWAY ELEMENTARY SCHOOL,HALF DAY K,0,0,1,2,26,29,3,10%
2000,MESA COUNTY VALLEY 51,1046,BROADWAY ELEMENTARY SCHOOL,1ST,1,2,0,5,29,37,8,22%
2000,MESA COUNTY VALLEY 51,1046,BROADWAY ELEMENTARY SCHOOL,2ND,0,2,0,1,41,44,3,7%
2000,MESA COUNTY VALLEY 51,1046,BROADWAY ELEMENTARY SCHOOL,3RD,0,2,0,6,38,46,8,17%
2000,MESA COUNTY VALLEY 51,1046,BROADWAY ELEMENTARY SCHOOL,4TH,1,1,1,3,36,42,6,14%
2000,MESA COUNTY VALLEY 51,1046,BROADWAY ELEMENTARY SCHOOL,5TH,0,1,0,4,35,40,5,13%
2000,MESA COUNTY VALLEY 51,1046,BROADWAY ELEMENTARY SCHOOL,SCHOOL TOTAL,2,8,3,24,224,261,37,14%
2000,MESA COUNTY VALLEY 51,1450,CENTRAL HIGH SCHOOL,9TH,9,6,6,108,322,451,129,29%
2000,MESA COUNTY VALLEY 51,1450,CENTRAL HIGH SCHOOL,10TH,10,5,7,98,294,414,120,29%
2000,MESA COUNTY VALLEY 51,1450,CENTRAL HIGH SCHOOL,11TH,3,4,3,96,315,421,106,25%
2000,MESA COUNTY VALLEY 51,1450,CENTRAL HIGH SCHOOL,12TH,12,3,6,91,266,378,112,30%
2000,MESA COUNTY VALLEY 51,1450,CENTRAL HIGH SCHOOL,SCHOOL TOTAL,34,18,22,393,1197,1664,467,28%
2000,MESA COUNTY VALLEY 51,1520,CHATFIELD ELEMENTARY SCHOOL,PK,0,0,1,5,22,28,6,21%
2000,MESA COUNTY VALLEY 51,1520,CHATFIELD ELEMENTARY SCHOOL,HALF DAY K,1,2,1,12,38,54,16,30%
2000,MESA COUNTY VALLEY 51,1520,CHATFIELD ELEMENTARY SCHOOL,KINDERGARTEN,0,0,0,6,8,14,6,43%
2000,MESA COUNTY VALLEY 51,1520,CHATFIELD ELEMENTARY SCHOOL,1ST,3,0,2,18,53,76,23,30%
2000,MESA COUNTY VALLEY 51,1520,CHATFIELD ELEMENTARY SCHOOL,2ND,0,0,0,12,48,60,12,20%
2000,MESA COUNTY VALLEY 51,1520,CHATFIELD ELEMENTARY SCHOOL,3RD,0,1,2,14,42,59,17,29%
2000,MESA COUNTY VALLEY 51,1520,CHATFIELD ELEMENTARY SCHOOL,4TH,0,1,3,16,53,73,20,27%
2000,MESA COUNTY VALLEY 51,1520,CHATFIELD ELEMENTARY SCHOOL,5TH,1,2,1,17,48,69,21,30%
2000,MESA COUNTY VALLEY 51,1520,CHATFIELD ELEMENTARY SCHOOL,SCHOOL TOTAL,5,6,10,100,312,433,121,28%
2000,MESA COUNTY VALLEY 51,1619,CHIPETA ELEMENTARY SCHOOL,PK,0,0,0,16,14,30,16,53%
2000,MESA COUNTY VALLEY 51,1619,CHIPETA ELEMENTARY SCHOOL,HALF DAY K,2,2,1,31,41,77,36,47%
2000,MESA COUNTY VALLEY 51,1619,CHIPETA ELEMENTARY SCHOOL,1ST,0,0,1,28,39,68,29,43%
2000,MESA COUNTY VALLEY 51,1619,CHIPETA ELEMENTARY SCHOOL,2ND,3,1,3,18,43,68,25,37%
2000,MESA COUNTY VALLEY 51,1619,CHIPETA ELEMENTARY SCHOOL,3RD,1,2,1,31,34,69,35,51%
2000,MESA COUNTY VALLEY 51,1619,CHIPETA ELEMENTARY SCHOOL,4TH,0,0,4,30,49,83,34,41%
2000,MESA COUNTY VALLEY 51,1619,CHIPETA ELEMENTARY SCHOOL,5TH,2,1,3,23,29,58,29,50%
2000,MESA COUNTY VALLEY 51,1619,CHIPETA ELEMENTARY SCHOOL,SCHOOL TOTAL,8,6,13,177,249,453,204,45%
2000,MESA COUNTY VALLEY 51,1686,CLIFTON ELEMENTARY SCHOOL,PK,0,0,0,17,30,47,17,36%
2000,MESA COUNTY VALLEY 51,1686,CLIFTON ELEMENTARY SCHOOL,HALF DAY K,2,0,3,22,66,93,27,29%
2000,MESA COUNTY VALLEY 51,1686,CLIFTON ELEMENTARY SCHOOL,KINDERGARTEN,0,0,0,0,1,1,0,0%
2000,MESA COUNTY VALLEY 51,1686,CLIFTON ELEMENTARY SCHOOL,1ST,1,0,2,25,41,69,28,41%
2000,MESA COUNTY VALLEY 51,1686,CLIFTON ELEMENTARY SCHOOL,2ND,0,0,1,19,50,70,20,29%
2000,MESA COUNTY VALLEY 51,1686,CLIFTON ELEMENTARY SCHOOL,3RD,0,0,2,25,53,80,27,34%
2000,MESA COUNTY VALLEY 51,1686,CLIFTON ELEMENTARY SCHOOL,4TH,2,1,0,15,37,55,18,33%
2000,MESA COUNTY VALLEY 51,1686,CLIFTON ELEMENTARY SCHOOL,5TH,1,0,2,20,55,78,23,29%
2000,MESA COUNTY VALLEY 51,1686,CLIFTON ELEMENTARY SCHOOL,SCHOOL TOTAL,6,1,10,143,333,493,160,32%
2000,MESA COUNTY VALLEY 51,2128,INDEPENDENCE ACADEMY,KINDERGARTEN,0,1,1,4,35,41,6,15%
2000,MESA COUNTY VALLEY 51,2128,INDEPENDENCE ACADEMY,1ST,1,0,1,4,38,44,6,14%
2000,MESA COUNTY VALLEY 51,2128,INDEPENDENCE ACADEMY,2ND,0,0,0,3,18,21,3,14%
2000,MESA COUNTY VALLEY 51,2128,INDEPENDENCE ACADEMY,3RD,0,0,0,0,12,12,0,0%
2000,MESA COUNTY VALLEY 51,2128,INDEPENDENCE ACADEMY,4TH,0,0,1,3,18,22,4,18%
2000,MESA COUNTY VALLEY 51,2128,INDEPENDENCE ACADEMY,5TH,0,0,0,3,17,20,3,15%
2000,MESA COUNTY VALLEY 51,2128,INDEPENDENCE ACADEMY,6TH,0,0,0,0,9,9,0,0%
2000,MESA COUNTY VALLEY 51,2128,INDEPENDENCE ACADEMY,7TH,1,0,0,3,10,14,4,29%
2000,MESA COUNTY VALLEY 51,2128,INDEPENDENCE ACADEMY,8TH,0,1,0,3,19,23,4,17%
2000,MESA COUNTY VALLEY 51,2128,INDEPENDENCE ACADEMY,SCHOOL TOTAL,2,2,3,23,176,206,30,15%
2000,MESA COUNTY VALLEY 51,2224,DOS RIOS ELEMENTARY SCHOOL,PK,0,0,0,9,17,26,9,35%
2000,MESA COUNTY VALLEY 51,2224,DOS RIOS ELEMENTARY SCHOOL,HALF DAY K,0,0,0,5,3,8,5,63%
2000,MESA COUNTY VALLEY 51,2224,DOS RIOS ELEMENTARY SCHOOL,KINDERGARTEN,1,0,1,18,37,57,20,35%
2000,MESA COUNTY VALLEY 51,2224,DOS RIOS ELEMENTARY SCHOOL,1ST,1,2,2,26,62,93,31,33%
2000,MESA COUNTY VALLEY 51,2224,DOS RIOS ELEMENTARY SCHOOL,2ND,0,0,3,18,36,57,21,37%
2000,MESA COUNTY VALLEY 51,2224,DOS RIOS ELEMENTARY SCHOOL,3RD,1,0,2,16,51,70,19,27%
2000,MESA COUNTY VALLEY 51,2224,DOS RIOS ELEMENTARY SCHOOL,4TH,3,0,0,18,41,62,21,34%
2000,MESA COUNTY VALLEY 51,2224,DOS RIOS ELEMENTARY SCHOOL,5TH,3,0,1,11,53,68,15,22%
2000,MESA COUNTY VALLEY 51,2224,DOS RIOS ELEMENTARY SCHOOL,SCHOOL TOTAL,9,2,9,121,300,441,141,32%
2000,MESA COUNTY VALLEY 51,2297,DUAL IMMERSION ACADEMY SCHOOL,PK,0,0,0,24,4,28,24,86%
2000,MESA COUNTY VALLEY 51,2297,DUAL IMMERSION ACADEMY SCHOOL,KINDERGARTEN,0,0,0,31,14,45,31,69%
2000,MESA COUNTY VALLEY 51,2297,DUAL IMMERSION ACADEMY SCHOOL,1ST,0,0,0,37,12,49,37,76%
2000,MESA COUNTY VALLEY 51,2297,DUAL IMMERSION ACADEMY SCHOOL,2ND,0,0,0,30,11,41,30,73%
2000,MESA COUNTY VALLEY 51,2297,DUAL IMMERSION ACADEMY SCHOOL,3RD,0,1,0,31,8,40,32,80%
2000,MESA COUNTY VALLEY 51,2297,DUAL IMMERSION ACADEMY SCHOOL,4TH,0,1,1,32,7,41,34,83%
2000,MESA COUNTY VALLEY 51,2297,DUAL IMMERSION ACADEMY SCHOOL,5TH,0,0,1,16,6,23,17,74%
2000,MESA COUNTY VALLEY 51,2297,DUAL IMMERSION ACADEMY SCHOOL,SCHOOL TOTAL,0,2,2,201,62,267,205,77%
2000,MESA COUNTY VALLEY 51,2392,EAST MIDDLE SCHOOL,6TH,2,2,4,22,112,142,30,21%
2000,MESA COUNTY VALLEY 51,2392,EAST MIDDLE SCHOOL,7TH,0,4,2,23,115,144,29,20%
2000,MESA COUNTY VALLEY 51,2392,EAST MIDDLE SCHOOL,8TH,0,3,5,24,128,160,32,20%
2000,MESA COUNTY VALLEY 51,2392,EAST MIDDLE SCHOOL,SCHOOL TOTAL,2,9,11,69,355,446,91,20%
2000,MESA COUNTY VALLEY 51,2724,NEW EMERSON SCHOOL AT COLUMBUS,KINDERGARTEN,0,0,2,2,12,16,4,25%
2000,MESA COUNTY VALLEY 51,2724,NEW EMERSON SCHOOL AT COLUMBUS,1ST,1,1,1,5,22,30,8,27%
2000,MESA COUNTY VALLEY 51,2724,NEW EMERSON SCHOOL AT COLUMBUS,2ND,0,1,0,0,22,23,1,4%
2000,MESA COUNTY VALLEY 51,2724,NEW EMERSON SCHOOL AT COLUMBUS,3RD,2,1,0,2,14,19,5,26%
2000,MESA COUNTY VALLEY 51,2724,NEW EMERSON SCHOOL AT COLUMBUS,4TH,0,2,0,2,18,22,4,18%
2000,MESA COUNTY VALLEY 51,2724,NEW EMERSON SCHOOL AT COLUMBUS,5TH,0,0,0,5,14,19,5,26%
2000,MESA COUNTY VALLEY 51,2724,NEW EMERSON SCHOOL AT COLUMBUS,SCHOOL TOTAL,3,5,3,16,102,129,27,21%
2000,MESA COUNTY VALLEY 51,3244,FRUITA MIDDLE SCHOOL,6TH,3,2,4,34,243,286,43,15%
2000,MESA COUNTY VALLEY 51,3244,FRUITA MIDDLE SCHOOL,7TH,3,1,5,40,251,300,49,16%
2000,MESA COUNTY VALLEY 51,3244,FRUITA MIDDLE SCHOOL,SCHOOL TOTAL,6,3,9,74,494,586,92,16%
2000,MESA COUNTY VALLEY 51,3262,FRUITVALE ELEMENTARY SCHOOL,PK,0,1,0,6,22,29,7,24%
2000,MESA COUNTY VALLEY 51,3262,FRUITVALE ELEMENTARY SCHOOL,HALF DAY K,1,0,1,16,57,75,18,24%
2000,MESA COUNTY VALLEY 51,3262,FRUITVALE ELEMENTARY SCHOOL,1ST,3,0,2,15,44,64,20,31%
2000,MESA COUNTY VALLEY 51,3262,FRUITVALE ELEMENTARY SCHOOL,2ND,2,0,0,18,64,84,20,24%
2000,MESA COUNTY VALLEY 51,3262,FRUITVALE ELEMENTARY SCHOOL,3RD,0,0,3,13,63,79,16,20%
2000,MESA COUNTY VALLEY 51,3262,FRUITVALE ELEMENTARY SCHOOL,4TH,1,1,1,18,59,80,21,26%
2000,MESA COUNTY VALLEY 51,3262,FRUITVALE ELEMENTARY SCHOOL,5TH,2,0,2,18,67,89,22,25%
2000,MESA COUNTY VALLEY 51,3262,FRUITVALE ELEMENTARY SCHOOL,SCHOOL TOTAL,9,2,9,104,376,500,124,25%
2000,MESA COUNTY VALLEY 51,3350,GATEWAY SCHOOL,PK,1,0,0,0,7,8,1,13%
2000,MESA COUNTY VALLEY 51,3350,GATEWAY SCHOOL,KINDERGARTEN,0,0,0,0,3,3,0,0%
2000,MESA COUNTY VALLEY 51,3350,GATEWAY SCHOOL,1ST,0,0,0,0,4,4,0,0%
2000,MESA COUNTY VALLEY 51,3350,GATEWAY SCHOOL,2ND,0,0,0,1,3,4,1,25%
2000,MESA COUNTY VALLEY 51,3350,GATEWAY SCHOOL,3RD,0,0,0,0,3,3,0,0%
2000,MESA COUNTY VALLEY 51,3350,GATEWAY SCHOOL,4TH,0,0,0,0,1,1,0,0%
2000,MESA COUNTY VALLEY 51,3350,GATEWAY SCHOOL,5TH,0,0,0,0,3,3,0,0%
2000,MESA COUNTY VALLEY 51,3350,GATEWAY SCHOOL,6TH,0,1,0,0,5,6,1,17%
2000,MESA COUNTY VALLEY 51,3350,GATEWAY SCHOOL,7TH,0,0,0,0,1,1,0,0%
2000,MESA COUNTY VALLEY 51,3350,GATEWAY SCHOOL,8TH,1,0,0,0,3,4,1,25%
2000,MESA COUNTY VALLEY 51,3350,GATEWAY SCHOOL,9TH,0,0,0,0,1,1,0,0%
2000,MESA COUNTY VALLEY 51,3350,GATEWAY SCHOOL,10TH,0,0,0,0,5,5,0,0%
2000,MESA COUNTY VALLEY 51,3350,GATEWAY SCHOOL,11TH,0,0,0,1,2,3,1,33%
2000,MESA COUNTY VALLEY 51,3350,GATEWAY SCHOOL,SCHOOL TOTAL,2,1,0,2,41,46,5,11%
2000,MESA COUNTY VALLEY 51,3469,GLADE PARK COMMUNITY SCHOOL,KINDERGARTEN,0,0,0,0,4,4,0,0%
2000,MESA COUNTY VALLEY 51,3469,GLADE PARK COMMUNITY SCHOOL,1ST,0,0,0,0,4,4,0,0%
2000,MESA COUNTY VALLEY 51,3469,GLADE PARK COMMUNITY SCHOOL,2ND,0,0,0,0,1,1,0,0%
2000,MESA COUNTY VALLEY 51,3469,GLADE PARK COMMUNITY SCHOOL,SCHOOL TOTAL,0,0,0,0,9,9,0,0%
2000,MESA COUNTY VALLEY 51,3570,GRAND JUNCTION HIGH SCHOOL,9TH,6,10,3,92,349,460,111,24%
2000,MESA COUNTY VALLEY 51,3570,GRAND JUNCTION HIGH SCHOOL,10TH,3,2,15,79,366,465,99,21%
2000,MESA COUNTY VALLEY 51,3570,GRAND JUNCTION HIGH SCHOOL,11TH,3,5,8,81,351,448,97,22%
2000,MESA COUNTY VALLEY 51,3570,GRAND JUNCTION HIGH SCHOOL,12TH,6,2,4,66,306,384,78,20%
2000,MESA COUNTY VALLEY 51,3570,GRAND JUNCTION HIGH SCHOOL,SCHOOL TOTAL,18,19,30,318,1372,1757,385,22%
2000,MESA COUNTY VALLEY 51,3584,GRAND MESA MIDDLE SCHOOL,6TH,0,3,2,42,168,215,47,22%
2000,MESA COUNTY VALLEY 51,3584,GRAND MESA MIDDLE SCHOOL,7TH,4,3,9,60,161,237,76,32%
2000,MESA COUNTY VALLEY 51,3584,GRAND MESA MIDDLE SCHOOL,8TH,4,2,3,46,157,212,55,26%
2000,MESA COUNTY VALLEY 51,3584,GRAND MESA MIDDLE SCHOOL,SCHOOL TOTAL,8,8,14,148,486,664,178,27%
2000,MESA COUNTY VALLEY 51,3825,HAWTHORNE BUILDING,PK,2,1,0,14,38,55,17,31%
2000,MESA COUNTY VALLEY 51,3825,HAWTHORNE BUILDING,SCHOOL TOTAL,2,1,0,14,38,55,17,31%
2000,MESA COUNTY VALLEY 51,5210,LINCOLN ORCHARD MESA ELEMENTARY SCHOOL,PK,1,0,0,8,21,30,9,30%
2000,MESA COUNTY VALLEY 51,5210,LINCOLN ORCHARD MESA ELEMENTARY SCHOOL,HALF DAY K,0,0,1,10,49,60,11,18%
2000,MESA COUNTY VALLEY 51,5210,LINCOLN ORCHARD MESA ELEMENTARY SCHOOL,1ST,0,0,1,16,48,65,17,26%
2000,MESA COUNTY VALLEY 51,5210,LINCOLN ORCHARD MESA ELEMENTARY SCHOOL,2ND,0,0,1,7,53,61,8,13%
2000,MESA COUNTY VALLEY 51,5210,LINCOLN ORCHARD MESA ELEMENTARY SCHOOL,3RD,1,0,2,14,46,63,17,27%
2000,MESA COUNTY VALLEY 51,5210,LINCOLN ORCHARD MESA ELEMENTARY SCHOOL,4TH,1,1,3,17,55,77,22,29%
2000,MESA COUNTY VALLEY 51,5210,LINCOLN ORCHARD MESA ELEMENTARY SCHOOL,5TH,0,0,0,12,41,53,12,23%
2000,MESA COUNTY VALLEY 51,5210,LINCOLN ORCHARD MESA ELEMENTARY SCHOOL,SCHOOL TOTAL,3,1,8,84,313,409,96,23%
2000,MESA COUNTY VALLEY 51,5244,LOMA ELEMENTARY SCHOOL,PK,0,1,0,2,22,25,3,12%
2000,MESA COUNTY VALLEY 51,5244,LOMA ELEMENTARY SCHOOL,HALF DAY K,0,0,0,3,29,32,3,9%
2000,MESA COUNTY VALLEY 51,5244,LOMA ELEMENTARY SCHOOL,1ST,1,1,0,3,39,44,5,11%
2000,MESA COUNTY VALLEY 51,5244,LOMA ELEMENTARY SCHOOL,2ND,1,0,1,3,35,40,5,13%
2000,MESA COUNTY VALLEY 51,5244,LOMA ELEMENTARY SCHOOL,3RD,0,1,0,7,37,45,8,18%
2000,MESA COUNTY VALLEY 51,5244,LOMA ELEMENTARY SCHOOL,4TH,0,0,0,6,35,41,6,15%
2000,MESA COUNTY VALLEY 51,5244,LOMA ELEMENTARY SCHOOL,5TH,0,1,0,3,37,41,4,10%
2000,MESA COUNTY VALLEY 51,5244,LOMA ELEMENTARY SCHOOL,SCHOOL TOTAL,2,4,1,27,234,268,34,13%
2000,MESA COUNTY VALLEY 51,5828,MESA VALLEY VISION HOME AND COMMUNITY PROGRAM,KINDERGARTEN,0,0,0,1,25,26,1,4%
2000,MESA COUNTY VALLEY 51,5828,MESA VALLEY VISION HOME AND COMMUNITY PROGRAM,1ST,0,0,0,1,28,29,1,3%
2000,MESA COUNTY VALLEY 51,5828,MESA VALLEY VISION HOME AND COMMUNITY PROGRAM,2ND,1,0,0,0,23,24,1,4%
2000,MESA COUNTY VALLEY 51,5828,MESA VALLEY VISION HOME AND COMMUNITY PROGRAM,3RD,0,1,0,2,27,30,3,10%
2000,MESA COUNTY VALLEY 51,5828,MESA VALLEY VISION HOME AND COMMUNITY PROGRAM,4TH,0,0,0,1,20,21,1,5%
2000,MESA COUNTY VALLEY 51,5828,MESA VALLEY VISION HOME AND COMMUNITY PROGRAM,5TH,0,1,1,0,25,27,2,7%
2000,MESA COUNTY VALLEY 51,5828,MESA VALLEY VISION HOME AND COMMUNITY PROGRAM,6TH,1,0,0,1,16,18,2,11%
2000,MESA COUNTY VALLEY 51,5828,MESA VALLEY VISION HOME AND COMMUNITY PROGRAM,7TH,0,3,0,2,34,39,5,13%
2000,MESA COUNTY VALLEY 51,5828,MESA VALLEY VISION HOME AND COMMUNITY PROGRAM,8TH,0,0,0,0,20,20,0,0%
2000,MESA COUNTY VALLEY 51,5828,MESA VALLEY VISION HOME AND COMMUNITY PROGRAM,9TH,0,0,0,2,19,21,2,10%
2000,MESA COUNTY VALLEY 51,5828,MESA VALLEY VISION HOME AND COMMUNITY PROGRAM,10TH,0,0,0,1,15,16,1,6%
2000,MESA COUNTY VALLEY 51,5828,MESA VALLEY VISION HOME AND COMMUNITY PROGRAM,11TH,0,1,0,0,10,11,1,9%
2000,MESA COUNTY VALLEY 51,5828,MESA VALLEY VISION HOME AND COMMUNITY PROGRAM,12TH,0,0,0,1,7,8,1,13%
2000,MESA COUNTY VALLEY 51,5828,MESA VALLEY VISION HOME AND COMMUNITY PROGRAM,SCHOOL TOTAL,2,6,1,12,269,290,21,7%
2000,MESA COUNTY VALLEY 51,5842,MESA VIEW ELEMENTARY SCHOOL,PK,0,0,0,8,22,30,8,27%
2000,MESA COUNTY VALLEY 51,5842,MESA VIEW ELEMENTARY SCHOOL,HALF DAY K,0,1,1,5,54,61,7,11%
2000,MESA COUNTY VALLEY 51,5842,MESA VIEW ELEMENTARY SCHOOL,1ST,1,1,0,7,67,76,9,12%
2000,MESA COUNTY VALLEY 51,5842,MESA VIEW ELEMENTARY SCHOOL,2ND,1,0,1,11,49,62,13,21%
2000,MESA COUNTY VALLEY 51,5842,MESA VIEW ELEMENTARY SCHOOL,3RD,1,0,2,8,58,69,11,16%
2000,MESA COUNTY VALLEY 51,5842,MESA VIEW ELEMENTARY SCHOOL,4TH,1,0,0,7,42,50,8,16%
2000,MESA COUNTY VALLEY 51,5842,MESA VIEW ELEMENTARY SCHOOL,5TH,2,2,0,5,61,70,9,13%
2000,MESA COUNTY VALLEY 51,5842,MESA VIEW ELEMENTARY SCHOOL,SCHOOL TOTAL,6,4,4,51,353,418,65,16%
2000,MESA COUNTY VALLEY 51,6070,FRUITA MONUMENT HIGH SCHOOL,10TH,8,3,5,44,378,438,60,14%
2000,MESA COUNTY VALLEY 51,6070,FRUITA MONUMENT HIGH SCHOOL,11TH,3,12,4,44,396,459,63,14%
2000,MESA COUNTY VALLEY 51,6070,FRUITA MONUMENT HIGH SCHOOL,12TH,5,7,6,35,373,426,53,12%
2000,MESA COUNTY VALLEY 51,6070,FRUITA MONUMENT HIGH SCHOOL,SCHOOL TOTAL,16,22,15,123,1147,1323,176,13%
2000,MESA COUNTY VALLEY 51,6166,MOUNT GARFIELD MIDDLE SCHOOL,6TH,7,1,4,55,129,196,67,34%
2000,MESA COUNTY VALLEY 51,6166,MOUNT GARFIELD MIDDLE SCHOOL,7TH,5,2,5,55,154,221,67,30%
2000,MESA COUNTY VALLEY 51,6166,MOUNT GARFIELD MIDDLE SCHOOL,8TH,7,1,6,58,157,229,72,31%
2000,MESA COUNTY VALLEY 51,6166,MOUNT GARFIELD MIDDLE SCHOOL,SCHOOL TOTAL,19,4,15,168,440,646,206,32%
2000,MESA COUNTY VALLEY 51,6264,NISLEY ELEMENTARY SCHOOL,PK,0,0,0,8,22,30,8,27%
2000,MESA COUNTY VALLEY 51,6264,NISLEY ELEMENTARY SCHOOL,HALF DAY K,1,0,1,6,33,41,8,20%
2000,MESA COUNTY VALLEY 51,6264,NISLEY ELEMENTARY SCHOOL,KINDERGARTEN,0,1,1,18,18,38,20,53%
2000,MESA COUNTY VALLEY 51,6264,NISLEY ELEMENTARY SCHOOL,1ST,0,0,0,31,38,69,31,45%
2000,MESA COUNTY VALLEY 51,6264,NISLEY ELEMENTARY SCHOOL,2ND,3,1,1,24,42,71,29,41%
2000,MESA COUNTY VALLEY 51,6264,NISLEY ELEMENTARY SCHOOL,3RD,1,1,3,31,42,78,36,46%
2000,MESA COUNTY VALLEY 51,6264,NISLEY ELEMENTARY SCHOOL,4TH,1,2,4,23,31,61,30,49%
2000,MESA COUNTY VALLEY 51,6264,NISLEY ELEMENTARY SCHOOL,5TH,1,1,2,30,42,76,34,45%
2000,MESA COUNTY VALLEY 51,6264,NISLEY ELEMENTARY SCHOOL,SCHOOL TOTAL,7,6,12,171,268,464,196,42%
2000,MESA COUNTY VALLEY 51,6554,ORCHARD AVENUE ELEMENTARY SCHOOL,PK,1,1,1,5,19,27,8,30%
2000,MESA COUNTY VALLEY 51,6554,ORCHARD AVENUE ELEMENTARY SCHOOL,HALF DAY K,1,2,1,15,66,85,19,22%
2000,MESA COUNTY VALLEY 51,6554,ORCHARD AVENUE ELEMENTARY SCHOOL,1ST,1,1,1,18,61,82,21,26%
2000,MESA COUNTY VALLEY 51,6554,ORCHARD AVENUE ELEMENTARY SCHOOL,2ND,1,1,3,16,61,82,21,26%
2000,MESA COUNTY VALLEY 51,6554,ORCHARD AVENUE ELEMENTARY SCHOOL,3RD,1,4,3,8,49,65,16,25%
2000,MESA COUNTY VALLEY 51,6554,ORCHARD AVENUE ELEMENTARY SCHOOL,4TH,0,2,3,15,62,82,20,24%
2000,MESA COUNTY VALLEY 51,6554,ORCHARD AVENUE ELEMENTARY SCHOOL,5TH,1,1,0,11,55,68,13,19%
2000,MESA COUNTY VALLEY 51,6554,ORCHARD AVENUE ELEMENTARY SCHOOL,SCHOOL TOTAL,6,12,12,88,373,491,118,24%
2000,MESA COUNTY VALLEY 51,6562,ORCHARD MESA MIDDLE SCHOOL,6TH,5,4,1,35,134,179,45,25%
2000,MESA COUNTY VALLEY 51,6562,ORCHARD MESA MIDDLE SCHOOL,7TH,3,0,4,45,119,171,52,30%
2000,MESA COUNTY VALLEY 51,6562,ORCHARD MESA MIDDLE SCHOOL,8TH,5,0,2,31,120,158,38,24%
2000,MESA COUNTY VALLEY 51,6562,ORCHARD MESA MIDDLE SCHOOL,SCHOOL TOTAL,13,4,7,111,373,508,135,27%
2000,MESA COUNTY VALLEY 51,6666,PALISADE HIGH SCHOOL,9TH,3,3,6,58,202,272,70,26%
2000,MESA COUNTY VALLEY 51,6666,PALISADE HIGH SCHOOL,10TH,2,2,6,49,218,277,59,21%
2000,MESA COUNTY VALLEY 51,6666,PALISADE HIGH SCHOOL,11TH,2,3,6,56,183,250,67,27%
2000,MESA COUNTY VALLEY 51,6666,PALISADE HIGH SCHOOL,12TH,2,4,6,46,171,229,58,25%
2000,MESA COUNTY VALLEY 51,6666,PALISADE HIGH SCHOOL,SCHOOL TOTAL,9,12,24,209,774,1028,254,25%
2000,MESA COUNTY VALLEY 51,7110,POMONA ELEMENTARY SCHOOL,HALF DAY K,0,1,3,11,53,68,15,22%
2000,MESA COUNTY VALLEY 51,7110,POMONA ELEMENTARY SCHOOL,1ST,0,1,1,8,50,60,10,17%
2000,MESA COUNTY VALLEY 51,7110,POMONA ELEMENTARY SCHOOL,2ND,0,2,0,10,56,68,12,18%
2000,MESA COUNTY VALLEY 51,7110,POMONA ELEMENTARY SCHOOL,3RD,2,0,3,14,43,62,19,31%
2000,MESA COUNTY VALLEY 51,7110,POMONA ELEMENTARY SCHOOL,4TH,1,3,0,10,64,78,14,18%
2000,MESA COUNTY VALLEY 51,7110,POMONA ELEMENTARY SCHOOL,5TH,0,2,1,20,68,91,23,25%
2000,MESA COUNTY VALLEY 51,7110,POMONA ELEMENTARY SCHOOL,SCHOOL TOTAL,3,9,8,73,334,427,93,22%
2000,MESA COUNTY VALLEY 51,7236,R-5 HIGH SCHOOL,9TH,0,0,0,0,1,1,0,0%
2000,MESA COUNTY VALLEY 51,7236,R-5 HIGH SCHOOL,10TH,0,0,0,0,25,25,0,0%
2000,MESA COUNTY VALLEY 51,7236,R-5 HIGH SCHOOL,11TH,1,0,2,14,77,94,17,18%
2000,MESA COUNTY VALLEY 51,7236,R-5 HIGH SCHOOL,12TH,2,0,0,41,107,150,43,29%
2000,MESA COUNTY VALLEY 51,7236,R-5 HIGH SCHOOL,SCHOOL TOTAL,3,0,2,55,210,270,60,22%
2000,MESA COUNTY VALLEY 51,7281,REDLANDS MIDDLE SCHOOL,6TH,1,3,3,16,188,211,23,11%
2000,MESA COUNTY VALLEY 51,7281,REDLANDS MIDDLE SCHOOL,7TH,0,1,1,22,181,205,24,12%
2000,MESA COUNTY VALLEY 51,7281,REDLANDS MIDDLE SCHOOL,8TH,1,4,2,20,169,196,27,14%
2000,MESA COUNTY VALLEY 51,7281,REDLANDS MIDDLE SCHOOL,SCHOOL TOTAL,2,8,6,58,538,612,74,12%
2000,MESA COUNTY VALLEY 51,7467,ROCKY MOUNTAIN ELEMENTARY SCHOOL,PK,0,0,0,10,18,28,10,36%
2000,MESA COUNTY VALLEY 51,7467,ROCKY MOUNTAIN ELEMENTARY SCHOOL,HALF DAY K,6,0,1,21,36,64,28,44%
2000,MESA COUNTY VALLEY 51,7467,ROCKY MOUNTAIN ELEMENTARY SCHOOL,KINDERGARTEN,0,0,0,14,19,33,14,42%
2000,MESA COUNTY VALLEY 51,7467,ROCKY MOUNTAIN ELEMENTARY SCHOOL,1ST,7,2,1,54,55,119,64,54%
2000,MESA COUNTY VALLEY 51,7467,ROCKY MOUNTAIN ELEMENTARY SCHOOL,2ND,1,0,2,27,60,90,30,33%
2000,MESA COUNTY VALLEY 51,7467,ROCKY MOUNTAIN ELEMENTARY SCHOOL,3RD,2,0,4,33,53,92,39,42%
2000,MESA COUNTY VALLEY 51,7467,ROCKY MOUNTAIN ELEMENTARY SCHOOL,4TH,2,0,2,36,43,83,40,48%
2000,MESA COUNTY VALLEY 51,7467,ROCKY MOUNTAIN ELEMENTARY SCHOOL,5TH,3,0,4,33,44,84,40,48%
2000,MESA COUNTY VALLEY 51,7467,ROCKY MOUNTAIN ELEMENTARY SCHOOL,SCHOOL TOTAL,21,2,14,228,328,593,265,45%
2000,MESA COUNTY VALLEY 51,7832,SHELLEDY ELEMENTARY SCHOOL,PK,0,0,1,1,26,28,2,7%
2000,MESA COUNTY VALLEY 51,7832,SHELLEDY ELEMENTARY SCHOOL,HALF DAY K,0,2,2,13,81,98,17,17%
2000,MESA COUNTY VALLEY 51,7832,SHELLEDY ELEMENTARY SCHOOL,1ST,1,1,1,11,62,76,14,18%
2000,MESA COUNTY VALLEY 51,7832,SHELLEDY ELEMENTARY SCHOOL,2ND,1,1,2,10,87,101,14,14%
2000,MESA COUNTY VALLEY 51,7832,SHELLEDY ELEMENTARY SCHOOL,3RD,0,0,2,16,70,88,18,20%
2000,MESA COUNTY VALLEY 51,7832,SHELLEDY ELEMENTARY SCHOOL,4TH,0,0,2,17,59,78,19,24%
2000,MESA COUNTY VALLEY 51,7832,SHELLEDY ELEMENTARY SCHOOL,5TH,0,0,2,8,71,81,10,12%
2000,MESA COUNTY VALLEY 51,7832,SHELLEDY ELEMENTARY SCHOOL,SCHOOL TOTAL,2,4,12,76,456,550,94,17%
2000,MESA COUNTY VALLEY 51,8462,TAYLOR ELEMENTARY SCHOOL,PK,0,0,0,4,20,24,4,17%
2000,MESA COUNTY VALLEY 51,8462,TAYLOR ELEMENTARY SCHOOL,HALF DAY K,1,1,1,16,37,56,19,34%
2000,MESA COUNTY VALLEY 51,8462,TAYLOR ELEMENTARY SCHOOL,KINDERGARTEN,0,0,0,1,5,6,1,17%
2000,MESA COUNTY VALLEY 51,8462,TAYLOR ELEMENTARY SCHOOL,1ST,0,0,1,10,52,63,11,17%
2000,MESA COUNTY VALLEY 51,8462,TAYLOR ELEMENTARY SCHOOL,2ND,1,0,0,6,41,48,7,15%
2000,MESA COUNTY VALLEY 51,8462,TAYLOR ELEMENTARY SCHOOL,3RD,1,1,0,15,57,74,17,23%
2000,MESA COUNTY VALLEY 51,8462,TAYLOR ELEMENTARY SCHOOL,4TH,0,0,0,10,51,61,10,16%
2000,MESA COUNTY VALLEY 51,8462,TAYLOR ELEMENTARY SCHOOL,5TH,1,1,2,11,54,69,15,22%
2000,MESA COUNTY VALLEY 51,8462,TAYLOR ELEMENTARY SCHOOL,SCHOOL TOTAL,4,3,4,73,317,401,84,21%
2000,MESA COUNTY VALLEY 51,8846,THUNDER MOUNTAIN ELEMENTARY SCHOOL,PK,0,0,0,11,15,26,11,42%
2000,MESA COUNTY VALLEY 51,8846,THUNDER MOUNTAIN ELEMENTARY SCHOOL,HALF DAY K,1,2,2,11,67,83,16,19%
2000,MESA COUNTY VALLEY 51,8846,THUNDER MOUNTAIN ELEMENTARY SCHOOL,KINDERGARTEN,0,0,0,0,1,1,0,0%
2000,MESA COUNTY VALLEY 51,8846,THUNDER MOUNTAIN ELEMENTARY SCHOOL,1ST,1,0,5,15,86,107,21,20%
2000,MESA COUNTY VALLEY 51,8846,THUNDER MOUNTAIN ELEMENTARY SCHOOL,2ND,0,1,2,12,89,104,15,14%
2000,MESA COUNTY VALLEY 51,8846,THUNDER MOUNTAIN ELEMENTARY SCHOOL,3RD,2,3,1,22,76,104,28,27%
2000,MESA COUNTY VALLEY 51,8846,THUNDER MOUNTAIN ELEMENTARY SCHOOL,4TH,1,0,1,14,78,94,16,17%
2000,MESA COUNTY VALLEY 51,8846,THUNDER MOUNTAIN ELEMENTARY SCHOOL,5TH,2,6,0,13,70,91,21,23%
2000,MESA COUNTY VALLEY 51,8846,THUNDER MOUNTAIN ELEMENTARY SCHOOL,SCHOOL TOTAL,7,12,11,98,482,610,128,21%
2000,MESA COUNTY VALLEY 51,8876,TOPE ELEMENTARY SCHOOL,PK,0,0,0,7,20,27,7,26%
2000,MESA COUNTY VALLEY 51,8876,TOPE ELEMENTARY SCHOOL,HALF DAY K,1,0,0,12,41,54,13,24%
2000,MESA COUNTY VALLEY 51,8876,TOPE ELEMENTARY SCHOOL,1ST,0,2,1,15,43,61,18,30%
2000,MESA COUNTY VALLEY 51,8876,TOPE ELEMENTARY SCHOOL,2ND,0,2,0,10,47,59,12,20%
2000,MESA COUNTY VALLEY 51,8876,TOPE ELEMENTARY SCHOOL,3RD,2,2,1,13,42,60,18,30%
2000,MESA COUNTY VALLEY 51,8876,TOPE ELEMENTARY SCHOOL,4TH,0,0,0,14,54,68,14,21%
2000,MESA COUNTY VALLEY 51,8876,TOPE ELEMENTARY SCHOOL,5TH,2,2,0,13,43,60,17,28%
2000,MESA COUNTY VALLEY 51,8876,TOPE ELEMENTARY SCHOOL,SCHOOL TOTAL,5,8,2,84,290,389,99,25%
2000,MESA COUNTY VALLEY 51,9406,WEST MIDDLE SCHOOL,6TH,1,3,1,30,110,145,35,24%
2000,MESA COUNTY VALLEY 51,9406,WEST MIDDLE SCHOOL,7TH,2,3,2,19,104,130,26,20%
2000,MESA COUNTY VALLEY 51,9406,WEST MIDDLE SCHOOL,8TH,3,4,2,27,114,150,36,24%
2000,MESA COUNTY VALLEY 51,9406,WEST MIDDLE SCHOOL,SCHOOL TOTAL,6,10,5,76,328,425,97,23%
2000,MESA COUNTY VALLEY 51,9434,SCENIC ELEMENTARY SCHOOL,HALF DAY K,0,1,0,0,33,34,1,3%
2000,MESA COUNTY VALLEY 51,9434,SCENIC ELEMENTARY SCHOOL,1ST,0,0,1,6,30,37,7,19%
2000,MESA COUNTY VALLEY 51,9434,SCENIC ELEMENTARY SCHOOL,2ND,0,0,3,3,37,43,6,14%
2000,MESA COUNTY VALLEY 51,9434,SCENIC ELEMENTARY SCHOOL,3RD,0,1,1,5,37,44,7,16%
2000,MESA COUNTY VALLEY 51,9434,SCENIC ELEMENTARY SCHOOL,4TH,1,0,0,6,43,50,7,14%
2000,MESA COUNTY VALLEY 51,9434,SCENIC ELEMENTARY SCHOOL,5TH,0,0,1,2,41,44,3,7%
2000,MESA COUNTY VALLEY 51,9434,SCENIC ELEMENTARY SCHOOL,SCHOOL TOTAL,1,2,6,22,221,252,31,12%
2000,MESA COUNTY VALLEY 51,9673,WINGATE ELEMENTARY SCHOOL,PK,1,1,0,3,17,22,5,23%
2000,MESA COUNTY VALLEY 51,9673,WINGATE ELEMENTARY SCHOOL,HALF DAY K,0,4,0,2,54,60,6,10%
2000,MESA COUNTY VALLEY 51,9673,WINGATE ELEMENTARY SCHOOL,1ST,0,1,1,3,75,80,5,6%
2000,MESA COUNTY VALLEY 51,9673,WINGATE ELEMENTARY SCHOOL,2ND,0,1,0,7,68,76,8,11%
2000,MESA COUNTY VALLEY 51,9673,WINGATE ELEMENTARY SCHOOL,3RD,0,0,0,8,71,79,8,10%
2000,MESA COUNTY VALLEY 51,9673,WINGATE ELEMENTARY SCHOOL,4TH,1,1,0,8,76,86,10,12%
2000,MESA COUNTY VALLEY 51,9673,WINGATE ELEMENTARY SCHOOL,5TH,0,2,0,9,64,75,11,15%
2000,MESA COUNTY VALLEY 51,9673,WINGATE ELEMENTARY SCHOOL,SCHOOL TOTAL,2,10,1,40,425,478,53,11%
2000,MESA COUNTY VALLEY 51,,DISTRICT TOTAL,,279,274,349,4332,16796,22030,5234,24%
2010,CREEDE SCHOOL DISTRICT,1962,LAMB ELEMENTARY SCHOOL,PK,0,1,0,0,5,6,1,17%
2010,CREEDE SCHOOL DISTRICT,1962,LAMB ELEMENTARY SCHOOL,KINDERGARTEN,0,0,0,0,7,7,0,0%
2010,CREEDE SCHOOL DISTRICT,1962,LAMB ELEMENTARY SCHOOL,1ST,0,1,0,0,12,13,1,8%
2010,CREEDE SCHOOL DISTRICT,1962,LAMB ELEMENTARY SCHOOL,2ND,0,0,0,0,5,5,0,0%
2010,CREEDE SCHOOL DISTRICT,1962,LAMB ELEMENTARY SCHOOL,3RD,0,0,0,0,8,8,0,0%
2010,CREEDE SCHOOL DISTRICT,1962,LAMB ELEMENTARY SCHOOL,4TH,0,0,0,0,7,7,0,0%
2010,CREEDE SCHOOL DISTRICT,1962,LAMB ELEMENTARY SCHOOL,5TH,0,0,0,0,7,7,0,0%
2010,CREEDE SCHOOL DISTRICT,1962,LAMB ELEMENTARY SCHOOL,6TH,0,0,0,0,3,3,0,0%
2010,CREEDE SCHOOL DISTRICT,1962,LAMB ELEMENTARY SCHOOL,SCHOOL TOTAL,0,2,0,0,54,56,2,4%
2010,CREEDE SCHOOL DISTRICT,1966,CREEDE JUNIOR-SENIOR HIGH SCHOOL,7TH,0,0,0,0,3,3,0,0%
2010,CREEDE SCHOOL DISTRICT,1966,CREEDE JUNIOR-SENIOR HIGH SCHOOL,8TH,0,0,0,1,7,8,1,13%
2010,CREEDE SCHOOL DISTRICT,1966,CREEDE JUNIOR-SENIOR HIGH SCHOOL,9TH,0,0,0,1,7,8,1,13%
2010,CREEDE SCHOOL DISTRICT,1966,CREEDE JUNIOR-SENIOR HIGH SCHOOL,10TH,0,0,0,2,7,9,2,22%
2010,CREEDE SCHOOL DISTRICT,1966,CREEDE JUNIOR-SENIOR HIGH SCHOOL,11TH,1,0,0,1,4,6,2,33%
2010,CREEDE SCHOOL DISTRICT,1966,CREEDE JUNIOR-SENIOR HIGH SCHOOL,12TH,0,0,0,0,11,11,0,0%
2010,CREEDE SCHOOL DISTRICT,1966,CREEDE JUNIOR-SENIOR HIGH SCHOOL,SCHOOL TOTAL,1,0,0,5,39,45,6,13%
2010,CREEDE SCHOOL DISTRICT,,DISTRICT TOTAL,,1,2,0,5,93,101,8,8%
2020,MOFFAT COUNTY RE:NO 1,1936,SANDROCK ELEMENTARY,PK,0,0,0,7,23,30,7,23%
2020,MOFFAT COUNTY RE:NO 1,1936,SANDROCK ELEMENTARY,KINDERGARTEN,1,0,0,22,41,64,23,36%
2020,MOFFAT COUNTY RE:NO 1,1936,SANDROCK ELEMENTARY,1ST,0,0,0,13,41,54,13,24%
2020,MOFFAT COUNTY RE:NO 1,1936,SANDROCK ELEMENTARY,2ND,0,0,1,18,46,65,19,29%
2020,MOFFAT COUNTY RE:NO 1,1936,SANDROCK ELEMENTARY,3RD,0,0,0,22,48,70,22,31%
2020,MOFFAT COUNTY RE:NO 1,1936,SANDROCK ELEMENTARY,4TH,1,0,1,14,38,54,16,30%
2020,MOFFAT COUNTY RE:NO 1,1936,SANDROCK ELEMENTARY,5TH,0,0,3,11,39,53,14,26%
2020,MOFFAT COUNTY RE:NO 1,1936,SANDROCK ELEMENTARY,SCHOOL TOTAL,2,0,5,107,276,390,114,29%
2020,MOFFAT COUNTY RE:NO 1,1938,CRAIG MIDDLE SCHOOL SCHOOL,6TH,1,3,1,41,145,191,46,24%
2020,MOFFAT COUNTY RE:NO 1,1938,CRAIG MIDDLE SCHOOL SCHOOL,7TH,1,1,2,29,137,170,33,19%
2020,MOFFAT COUNTY RE:NO 1,1938,CRAIG MIDDLE SCHOOL SCHOOL,8TH,3,3,1,37,121,165,44,27%
2020,MOFFAT COUNTY RE:NO 1,1938,CRAIG MIDDLE SCHOOL SCHOOL,SCHOOL TOTAL,5,7,4,107,403,526,123,23%
2020,MOFFAT COUNTY RE:NO 1,2373,EARLY CHILDHOOD CENTER,PK,2,1,0,9,48,60,12,20%
2020,MOFFAT COUNTY RE:NO 1,2373,EARLY CHILDHOOD CENTER,SCHOOL TOTAL,2,1,0,9,48,60,12,20%
2020,MOFFAT COUNTY RE:NO 1,2374,EAST ELEMENTARY SCHOOL,PK,0,0,0,9,20,29,9,31%
2020,MOFFAT COUNTY RE:NO 1,2374,EAST ELEMENTARY SCHOOL,KINDERGARTEN,0,0,0,10,32,42,10,24%
2020,MOFFAT COUNTY RE:NO 1,2374,EAST ELEMENTARY SCHOOL,1ST,0,0,0,9,29,38,9,24%
2020,MOFFAT COUNTY RE:NO 1,2374,EAST ELEMENTARY SCHOOL,2ND,0,0,0,10,36,46,10,22%
2020,MOFFAT COUNTY RE:NO 1,2374,EAST ELEMENTARY SCHOOL,3RD,1,0,1,10,33,45,12,27%
2020,MOFFAT COUNTY RE:NO 1,2374,EAST ELEMENTARY SCHOOL,4TH,0,0,0,8,28,36,8,22%
2020,MOFFAT COUNTY RE:NO 1,2374,EAST ELEMENTARY SCHOOL,5TH,0,0,0,9,32,41,9,22%
2020,MOFFAT COUNTY RE:NO 1,2374,EAST ELEMENTARY SCHOOL,SCHOOL TOTAL,1,0,1,65,210,277,67,24%
2020,MOFFAT COUNTY RE:NO 1,5656,MAYBELL ELEMENTARY SCHOOL,KINDERGARTEN,0,0,0,0,2,2,0,0%
2020,MOFFAT COUNTY RE:NO 1,5656,MAYBELL ELEMENTARY SCHOOL,1ST,0,0,0,0,2,2,0,0%
2020,MOFFAT COUNTY RE:NO 1,5656,MAYBELL ELEMENTARY SCHOOL,2ND,0,0,0,0,4,4,0,0%
2020,MOFFAT COUNTY RE:NO 1,5656,MAYBELL ELEMENTARY SCHOOL,3RD,0,0,0,1,3,4,1,25%
2020,MOFFAT COUNTY RE:NO 1,5656,MAYBELL ELEMENTARY SCHOOL,4TH,0,0,0,0,3,3,0,0%
2020,MOFFAT COUNTY RE:NO 1,5656,MAYBELL ELEMENTARY SCHOOL,5TH,0,0,0,0,1,1,0,0%
2020,MOFFAT COUNTY RE:NO 1,5656,MAYBELL ELEMENTARY SCHOOL,SCHOOL TOTAL,0,0,0,1,15,16,1,6%
2020,MOFFAT COUNTY RE:NO 1,5962,MOFFAT COUNTY HIGH SCHOOL,9TH,2,2,1,24,164,193,29,15%
2020,MOFFAT COUNTY RE:NO 1,5962,MOFFAT COUNTY HIGH SCHOOL,10TH,3,0,2,25,123,153,30,20%
2020,MOFFAT COUNTY RE:NO 1,5962,MOFFAT COUNTY HIGH SCHOOL,11TH,0,0,2,21,129,152,23,15%
2020,MOFFAT COUNTY RE:NO 1,5962,MOFFAT COUNTY HIGH SCHOOL,12TH,1,1,0,20,153,175,22,13%
2020,MOFFAT COUNTY RE:NO 1,5962,MOFFAT COUNTY HIGH SCHOOL,SCHOOL TOTAL,6,3,5,90,569,673,104,15%
2020,MOFFAT COUNTY RE:NO 1,7338,RIDGEVIEW ELEMENTARY SCHOOL,PK,0,0,1,1,26,28,2,7%
2020,MOFFAT COUNTY RE:NO 1,7338,RIDGEVIEW ELEMENTARY SCHOOL,KINDERGARTEN,0,0,0,6,41,47,6,13%
2020,MOFFAT COUNTY RE:NO 1,7338,RIDGEVIEW ELEMENTARY SCHOOL,1ST,0,1,0,2,37,40,3,8%
2020,MOFFAT COUNTY RE:NO 1,7338,RIDGEVIEW ELEMENTARY SCHOOL,2ND,2,0,0,7,26,35,9,26%
2020,MOFFAT COUNTY RE:NO 1,7338,RIDGEVIEW ELEMENTARY SCHOOL,3RD,2,1,1,3,39,46,7,15%
2020,MOFFAT COUNTY RE:NO 1,7338,RIDGEVIEW ELEMENTARY SCHOOL,4TH,0,1,1,5,37,44,7,16%
2020,MOFFAT COUNTY RE:NO 1,7338,RIDGEVIEW ELEMENTARY SCHOOL,5TH,2,1,0,4,35,42,7,17%
2020,MOFFAT COUNTY RE:NO 1,7338,RIDGEVIEW ELEMENTARY SCHOOL,SCHOOL TOTAL,6,4,3,28,241,282,41,15%
2020,MOFFAT COUNTY RE:NO 1,8398,SUNSET ELEMENTARY SCHOOL,PK,0,0,0,2,25,27,2,7%
2020,MOFFAT COUNTY RE:NO 1,8398,SUNSET ELEMENTARY SCHOOL,HALF DAY K,0,0,0,0,2,2,0,0%
2020,MOFFAT COUNTY RE:NO 1,8398,SUNSET ELEMENTARY SCHOOL,KINDERGARTEN,0,0,0,9,43,52,9,17%
2020,MOFFAT COUNTY RE:NO 1,8398,SUNSET ELEMENTARY SCHOOL,1ST,1,0,2,11,37,51,14,27%
2020,MOFFAT COUNTY RE:NO 1,8398,SUNSET ELEMENTARY SCHOOL,2ND,0,0,0,12,30,42,12,29%
2020,MOFFAT COUNTY RE:NO 1,8398,SUNSET ELEMENTARY SCHOOL,3RD,0,1,0,4,43,48,5,10%
2020,MOFFAT COUNTY RE:NO 1,8398,SUNSET ELEMENTARY SCHOOL,4TH,3,0,0,8,41,52,11,21%
2020,MOFFAT COUNTY RE:NO 1,8398,SUNSET ELEMENTARY SCHOOL,5TH,0,0,1,6,31,38,7,18%
2020,MOFFAT COUNTY RE:NO 1,8398,SUNSET ELEMENTARY SCHOOL,SCHOOL TOTAL,4,1,3,52,252,312,60,19%
2020,MOFFAT COUNTY RE:NO 1,,DISTRICT TOTAL,,26,16,21,459,2014,2536,522,21%
2035,MONTEZUMA-CORTEZ RE-1,0609,BATTLE ROCK CHARTER SCHOOL,HALF DAY K,1,0,0,1,3,5,2,40%
2035,MONTEZUMA-CORTEZ RE-1,0609,BATTLE ROCK CHARTER SCHOOL,1ST,1,0,0,3,1,5,4,80%
2035,MONTEZUMA-CORTEZ RE-1,0609,BATTLE ROCK CHARTER SCHOOL,2ND,3,0,0,2,0,5,5,100%
2035,MONTEZUMA-CORTEZ RE-1,0609,BATTLE ROCK CHARTER SCHOOL,3RD,4,0,0,2,4,10,6,60%
2035,MONTEZUMA-CORTEZ RE-1,0609,BATTLE ROCK CHARTER SCHOOL,4TH,2,0,0,2,1,5,4,80%
2035,MONTEZUMA-CORTEZ RE-1,0609,BATTLE ROCK CHARTER SCHOOL,5TH,2,0,0,1,3,6,3,50%
2035,MONTEZUMA-CORTEZ RE-1,0609,BATTLE ROCK CHARTER SCHOOL,SCHOOL TOTAL,13,0,0,11,12,36,24,67%
2035,MONTEZUMA-CORTEZ RE-1,1888,CORTEZ MIDDLE SCHOOL,6TH,68,1,2,36,115,222,107,48%
2035,MONTEZUMA-CORTEZ RE-1,1888,CORTEZ MIDDLE SCHOOL,7TH,70,1,2,38,98,209,111,53%
2035,MONTEZUMA-CORTEZ RE-1,1888,CORTEZ MIDDLE SCHOOL,8TH,53,1,4,18,100,176,76,43%
2035,MONTEZUMA-CORTEZ RE-1,1888,CORTEZ MIDDLE SCHOOL,SCHOOL TOTAL,191,3,8,92,313,607,294,48%
2035,MONTEZUMA-CORTEZ RE-1,4546,KEMPER ELEMENTARY SCHOOL,HALF DAY K,16,0,0,10,28,54,26,48%
2035,MONTEZUMA-CORTEZ RE-1,4546,KEMPER ELEMENTARY SCHOOL,1ST,15,0,0,12,43,70,27,39%
2035,MONTEZUMA-CORTEZ RE-1,4546,KEMPER ELEMENTARY SCHOOL,2ND,17,1,2,10,37,67,30,45%
2035,MONTEZUMA-CORTEZ RE-1,4546,KEMPER ELEMENTARY SCHOOL,3RD,19,0,0,17,33,69,36,52%
2035,MONTEZUMA-CORTEZ RE-1,4546,KEMPER ELEMENTARY SCHOOL,4TH,15,0,0,15,44,74,30,41%
2035,MONTEZUMA-CORTEZ RE-1,4546,KEMPER ELEMENTARY SCHOOL,5TH,22,2,1,14,42,81,39,48%
2035,MONTEZUMA-CORTEZ RE-1,4546,KEMPER ELEMENTARY SCHOOL,SCHOOL TOTAL,104,3,3,78,227,415,188,45%
2035,MONTEZUMA-CORTEZ RE-1,5090,LEWIS-ARRIOLA ELEMENTARY SCHOOL,HALF DAY K,0,0,0,2,16,18,2,11%
2035,MONTEZUMA-CORTEZ RE-1,5090,LEWIS-ARRIOLA ELEMENTARY SCHOOL,1ST,0,0,0,2,20,22,2,9%
2035,MONTEZUMA-CORTEZ RE-1,5090,LEWIS-ARRIOLA ELEMENTARY SCHOOL,2ND,0,0,0,4,14,18,4,22%
2035,MONTEZUMA-CORTEZ RE-1,5090,LEWIS-ARRIOLA ELEMENTARY SCHOOL,3RD,1,0,0,2,21,24,3,13%
2035,MONTEZUMA-CORTEZ RE-1,5090,LEWIS-ARRIOLA ELEMENTARY SCHOOL,4TH,0,0,1,1,22,24,2,8%
2035,MONTEZUMA-CORTEZ RE-1,5090,LEWIS-ARRIOLA ELEMENTARY SCHOOL,5TH,0,0,0,0,23,23,0,0%
2035,MONTEZUMA-CORTEZ RE-1,5090,LEWIS-ARRIOLA ELEMENTARY SCHOOL,SCHOOL TOTAL,1,0,1,11,116,129,13,10%
2035,MONTEZUMA-CORTEZ RE-1,5436,MANAUGH ELEMENTARY SCHOOL,HALF DAY K,21,0,0,11,14,46,32,70%
2035,MONTEZUMA-CORTEZ RE-1,5436,MANAUGH ELEMENTARY SCHOOL,1ST,26,0,1,14,26,67,41,61%
2035,MONTEZUMA-CORTEZ RE-1,5436,MANAUGH ELEMENTARY SCHOOL,2ND,18,0,0,17,21,56,35,63%
2035,MONTEZUMA-CORTEZ RE-1,5436,MANAUGH ELEMENTARY SCHOOL,3RD,18,0,1,12,27,58,31,53%
2035,MONTEZUMA-CORTEZ RE-1,5436,MANAUGH ELEMENTARY SCHOOL,4TH,14,1,1,11,16,43,27,63%
2035,MONTEZUMA-CORTEZ RE-1,5436,MANAUGH ELEMENTARY SCHOOL,5TH,12,0,0,18,21,51,30,59%
2035,MONTEZUMA-CORTEZ RE-1,5436,MANAUGH ELEMENTARY SCHOOL,SCHOOL TOTAL,109,1,3,83,125,321,196,61%
2035,MONTEZUMA-CORTEZ RE-1,5836,MESA ELEMENTARY SCHOOL,HALF DAY K,10,0,0,5,22,37,15,41%
2035,MONTEZUMA-CORTEZ RE-1,5836,MESA ELEMENTARY SCHOOL,KINDERGARTEN,14,0,0,2,5,21,16,76%
2035,MONTEZUMA-CORTEZ RE-1,5836,MESA ELEMENTARY SCHOOL,1ST,29,2,1,9,27,68,41,60%
2035,MONTEZUMA-CORTEZ RE-1,5836,MESA ELEMENTARY SCHOOL,2ND,24,0,0,6,39,69,30,43%
2035,MONTEZUMA-CORTEZ RE-1,5836,MESA ELEMENTARY SCHOOL,3RD,18,1,0,11,39,69,30,43%
2035,MONTEZUMA-CORTEZ RE-1,5836,MESA ELEMENTARY SCHOOL,4TH,21,1,1,2,42,67,25,37%
2035,MONTEZUMA-CORTEZ RE-1,5836,MESA ELEMENTARY SCHOOL,5TH,24,1,1,10,40,76,36,47%
2035,MONTEZUMA-CORTEZ RE-1,5836,MESA ELEMENTARY SCHOOL,SCHOOL TOTAL,140,5,3,45,214,407,193,47%
2035,MONTEZUMA-CORTEZ RE-1,6026,MONTEZUMA-CORTEZ HIGH SCHOOL,9TH,38,1,3,26,120,188,68,36%
2035,MONTEZUMA-CORTEZ RE-1,6026,MONTEZUMA-CORTEZ HIGH SCHOOL,10TH,48,1,1,24,114,188,74,39%
2035,MONTEZUMA-CORTEZ RE-1,6026,MONTEZUMA-CORTEZ HIGH SCHOOL,11TH,51,1,0,20,131,203,72,35%
2035,MONTEZUMA-CORTEZ RE-1,6026,MONTEZUMA-CORTEZ HIGH SCHOOL,12TH,49,0,1,28,103,181,78,43%
2035,MONTEZUMA-CORTEZ RE-1,6026,MONTEZUMA-CORTEZ HIGH SCHOOL,SCHOOL TOTAL,186,3,5,98,468,760,292,38%
2035,MONTEZUMA-CORTEZ RE-1,7082,PLEASANT VIEW ELEMENTARY SCHOOL,HALF DAY K,0,0,0,1,6,7,1,14%
2035,MONTEZUMA-CORTEZ RE-1,7082,PLEASANT VIEW ELEMENTARY SCHOOL,1ST,0,0,0,0,5,5,0,0%
2035,MONTEZUMA-CORTEZ RE-1,7082,PLEASANT VIEW ELEMENTARY SCHOOL,2ND,1,0,0,0,4,5,1,20%
2035,MONTEZUMA-CORTEZ RE-1,7082,PLEASANT VIEW ELEMENTARY SCHOOL,3RD,0,0,0,1,3,4,1,25%
2035,MONTEZUMA-CORTEZ RE-1,7082,PLEASANT VIEW ELEMENTARY SCHOOL,4TH,0,0,0,0,1,1,0,0%
2035,MONTEZUMA-CORTEZ RE-1,7082,PLEASANT VIEW ELEMENTARY SCHOOL,5TH,0,0,1,0,3,4,1,25%
2035,MONTEZUMA-CORTEZ RE-1,7082,PLEASANT VIEW ELEMENTARY SCHOOL,SCHOOL TOTAL,1,0,1,2,22,26,4,15%
2035,MONTEZUMA-CORTEZ RE-1,7430,PRESCHOOL/JUMPSTART,PK,16,0,0,20,45,81,36,44%
2035,MONTEZUMA-CORTEZ RE-1,7430,PRESCHOOL/JUMPSTART,SCHOOL TOTAL,16,0,0,20,45,81,36,44%
2035,MONTEZUMA-CORTEZ RE-1,8133,SOUTHWEST OPEN CHARTER SCHOOL,9TH,6,1,0,5,7,19,12,63%
2035,MONTEZUMA-CORTEZ RE-1,8133,SOUTHWEST OPEN CHARTER SCHOOL,10TH,8,0,0,2,14,24,10,42%
2035,MONTEZUMA-CORTEZ RE-1,8133,SOUTHWEST OPEN CHARTER SCHOOL,11TH,4,1,0,6,18,29,11,38%
2035,MONTEZUMA-CORTEZ RE-1,8133,SOUTHWEST OPEN CHARTER SCHOOL,12TH,37,1,1,17,36,92,56,61%
2035,MONTEZUMA-CORTEZ RE-1,8133,SOUTHWEST OPEN CHARTER SCHOOL,SCHOOL TOTAL,55,3,1,30,75,164,89,54%
2035,MONTEZUMA-CORTEZ RE-1,,DISTRICT TOTAL,,816,18,25,470,1617,2946,1329,45%
2055,DOLORES RE-4A,2204,DOLORES ELEMENTARY SCHOOL,HALF DAY K,1,0,0,0,2,3,1,33%
2055,DOLORES RE-4A,2204,DOLORES ELEMENTARY SCHOOL,KINDERGARTEN,1,1,0,5,36,43,7,16%
2055,DOLORES RE-4A,2204,DOLORES ELEMENTARY SCHOOL,1ST,2,0,0,2,39,43,4,9%
2055,DOLORES RE-4A,2204,DOLORES ELEMENTARY SCHOOL,2ND,2,1,1,3,41,48,7,15%
2055,DOLORES RE-4A,2204,DOLORES ELEMENTARY SCHOOL,3RD,2,0,1,6,26,35,9,26%
2055,DOLORES RE-4A,2204,DOLORES ELEMENTARY SCHOOL,4TH,2,1,0,6,45,54,9,17%
2055,DOLORES RE-4A,2204,DOLORES ELEMENTARY SCHOOL,5TH,3,0,0,6,33,42,9,21%
2055,DOLORES RE-4A,2204,DOLORES ELEMENTARY SCHOOL,SCHOOL TOTAL,13,3,2,28,222,268,46,17%
2055,DOLORES RE-4A,2206,DOLORES MIDDLE SCHOOL,6TH,3,1,0,6,51,61,10,16%
2055,DOLORES RE-4A,2206,DOLORES MIDDLE SCHOOL,7TH,2,1,2,4,48,57,9,16%
2055,DOLORES RE-4A,2206,DOLORES MIDDLE SCHOOL,8TH,4,0,1,5,51,61,10,16%
2055,DOLORES RE-4A,2206,DOLORES MIDDLE SCHOOL,SCHOOL TOTAL,9,2,3,15,150,179,29,16%
2055,DOLORES RE-4A,2208,DOLORES HIGH SCHOOL,9TH,2,1,1,4,61,69,8,12%
2055,DOLORES RE-4A,2208,DOLORES HIGH SCHOOL,10TH,4,0,0,2,35,41,6,15%
2055,DOLORES RE-4A,2208,DOLORES HIGH SCHOOL,11TH,1,0,1,2,35,39,4,10%
2055,DOLORES RE-4A,2208,DOLORES HIGH SCHOOL,12TH,3,0,0,4,55,62,7,11%
2055,DOLORES RE-4A,2208,DOLORES HIGH SCHOOL,SCHOOL TOTAL,10,1,2,12,186,211,25,12%
2055,DOLORES RE-4A,8500,TEDDY BEAR PRESCHOOL,PK,6,0,0,7,39,52,13,25%
2055,DOLORES RE-4A,8500,TEDDY BEAR PRESCHOOL,SCHOOL TOTAL,6,0,0,7,39,52,13,25%
2055,DOLORES RE-4A,,DISTRICT TOTAL,,38,6,7,62,597,710,113,16%
2070,MANCOS RE-6,5446,MANCOS ELEMENTARY SCHOOL,KINDERGARTEN,4,0,0,7,15,26,11,42%
2070,MANCOS RE-6,5446,MANCOS ELEMENTARY SCHOOL,1ST,1,0,0,3,24,28,4,14%
2070,MANCOS RE-6,5446,MANCOS ELEMENTARY SCHOOL,2ND,4,0,0,5,29,38,9,24%
2070,MANCOS RE-6,5446,MANCOS ELEMENTARY SCHOOL,3RD,2,0,0,3,18,23,5,22%
2070,MANCOS RE-6,5446,MANCOS ELEMENTARY SCHOOL,4TH,1,0,0,2,26,29,3,10%
2070,MANCOS RE-6,5446,MANCOS ELEMENTARY SCHOOL,5TH,2,0,1,5,18,26,8,31%
2070,MANCOS RE-6,5446,MANCOS ELEMENTARY SCHOOL,SCHOOL TOTAL,14,0,1,25,130,170,40,24%
2070,MANCOS RE-6,5450,MANCOS MIDDLE SCHOOL,6TH,1,0,0,9,21,31,10,32%
2070,MANCOS RE-6,5450,MANCOS MIDDLE SCHOOL,7TH,4,1,0,4,25,34,9,26%
2070,MANCOS RE-6,5450,MANCOS MIDDLE SCHOOL,8TH,2,1,0,2,22,27,5,19%
2070,MANCOS RE-6,5450,MANCOS MIDDLE SCHOOL,SCHOOL TOTAL,7,2,0,15,68,92,24,26%
2070,MANCOS RE-6,5452,MANCOS HIGH SCHOOL,9TH,3,0,0,5,22,30,8,27%
2070,MANCOS RE-6,5452,MANCOS HIGH SCHOOL,10TH,3,0,0,4,17,24,7,29%
2070,MANCOS RE-6,5452,MANCOS HIGH SCHOOL,11TH,2,1,0,6,19,28,9,32%
2070,MANCOS RE-6,5452,MANCOS HIGH SCHOOL,12TH,3,0,1,2,23,29,6,21%
2070,MANCOS RE-6,5452,MANCOS HIGH SCHOOL,SCHOOL TOTAL,11,1,1,17,81,111,30,27%
2070,MANCOS RE-6,,DISTRICT TOTAL,,32,3,2,57,279,373,94,25%
2180,MONTROSE COUNTY RE-1J,1392,CENTENNIAL MIDDLE SCHOOL,6TH,1,2,5,68,132,208,76,37%
2180,MONTROSE COUNTY RE-1J,1392,CENTENNIAL MIDDLE SCHOOL,7TH,1,2,0,86,164,253,89,35%
2180,MONTROSE COUNTY RE-1J,1392,CENTENNIAL MIDDLE SCHOOL,8TH,1,3,2,78,151,235,84,36%
2180,MONTROSE COUNTY RE-1J,1392,CENTENNIAL MIDDLE SCHOOL,SCHOOL TOTAL,3,7,7,232,447,696,249,36%
2180,MONTROSE COUNTY RE-1J,1915,COTTONWOOD ELEMENTARY SCHOOL,HALF DAY K,0,3,0,13,48,64,16,25%
2180,MONTROSE COUNTY RE-1J,1915,COTTONWOOD ELEMENTARY SCHOOL,1ST,0,3,0,17,58,78,20,26%
2180,MONTROSE COUNTY RE-1J,1915,COTTONWOOD ELEMENTARY SCHOOL,2ND,0,1,0,9,62,72,10,14%
2180,MONTROSE COUNTY RE-1J,1915,COTTONWOOD ELEMENTARY SCHOOL,3RD,0,2,0,9,69,80,11,14%
2180,MONTROSE COUNTY RE-1J,1915,COTTONWOOD ELEMENTARY SCHOOL,4TH,0,3,1,13,86,103,17,17%
2180,MONTROSE COUNTY RE-1J,1915,COTTONWOOD ELEMENTARY SCHOOL,5TH,1,4,2,7,62,76,14,18%
2180,MONTROSE COUNTY RE-1J,1915,COTTONWOOD ELEMENTARY SCHOOL,SCHOOL TOTAL,1,16,3,68,385,473,88,19%
2180,MONTROSE COUNTY RE-1J,2942,EARLY CHILDHOOD CENTER,PK,3,2,2,113,168,288,120,42%
2180,MONTROSE COUNTY RE-1J,2942,EARLY CHILDHOOD CENTER,SCHOOL TOTAL,3,2,2,113,168,288,120,42%
2180,MONTROSE COUNTY RE-1J,4458,JOHNSON ELEMENTARY SCHOOL,HALF DAY K,2,2,1,44,59,108,49,45%
2180,MONTROSE COUNTY RE-1J,4458,JOHNSON ELEMENTARY SCHOOL,1ST,0,3,0,35,57,95,38,40%
2180,MONTROSE COUNTY RE-1J,4458,JOHNSON ELEMENTARY SCHOOL,2ND,0,2,3,58,70,133,63,47%
2180,MONTROSE COUNTY RE-1J,4458,JOHNSON ELEMENTARY SCHOOL,3RD,0,2,0,36,47,85,38,45%
2180,MONTROSE COUNTY RE-1J,4458,JOHNSON ELEMENTARY SCHOOL,4TH,1,3,0,40,48,92,44,48%
2180,MONTROSE COUNTY RE-1J,4458,JOHNSON ELEMENTARY SCHOOL,5TH,0,0,1,29,51,81,30,37%
2180,MONTROSE COUNTY RE-1J,4458,JOHNSON ELEMENTARY SCHOOL,SCHOOL TOTAL,3,12,5,242,332,594,262,44%
2180,MONTROSE COUNTY RE-1J,6054,COLUMBINE MIDDLE SCHOOL,6TH,3,3,1,44,142,193,51,26%
2180,MONTROSE COUNTY RE-1J,6054,COLUMBINE MIDDLE SCHOOL,7TH,2,1,1,34,120,158,38,24%
2180,MONTROSE COUNTY RE-1J,6054,COLUMBINE MIDDLE SCHOOL,8TH,2,1,1,30,130,164,34,21%
2180,MONTROSE COUNTY RE-1J,6054,COLUMBINE MIDDLE SCHOOL,SCHOOL TOTAL,7,5,3,108,392,515,123,24%
2180,MONTROSE COUNTY RE-1J,6058,MONTROSE HIGH SCHOOL,9TH,5,5,4,128,319,461,142,31%
2180,MONTROSE COUNTY RE-1J,6058,MONTROSE HIGH SCHOOL,10TH,6,5,2,72,244,329,85,26%
2180,MONTROSE COUNTY RE-1J,6058,MONTROSE HIGH SCHOOL,11TH,4,3,4,59,207,277,70,25%
2180,MONTROSE COUNTY RE-1J,6058,MONTROSE HIGH SCHOOL,12TH,1,4,4,39,204,252,48,19%
2180,MONTROSE COUNTY RE-1J,6058,MONTROSE HIGH SCHOOL,SCHOOL TOTAL,16,17,14,298,974,1319,345,26%
2180,MONTROSE COUNTY RE-1J,6366,NORTHSIDE ELEMENTARY SCHOOL,HALF DAY K,0,0,0,4,7,11,4,36%
2180,MONTROSE COUNTY RE-1J,6366,NORTHSIDE ELEMENTARY SCHOOL,KINDERGARTEN,0,0,2,30,30,62,32,52%
2180,MONTROSE COUNTY RE-1J,6366,NORTHSIDE ELEMENTARY SCHOOL,1ST,1,0,1,25,41,68,27,40%
2180,MONTROSE COUNTY RE-1J,6366,NORTHSIDE ELEMENTARY SCHOOL,2ND,0,0,1,26,44,71,27,38%
2180,MONTROSE COUNTY RE-1J,6366,NORTHSIDE ELEMENTARY SCHOOL,3RD,0,0,1,44,39,84,45,54%
2180,MONTROSE COUNTY RE-1J,6366,NORTHSIDE ELEMENTARY SCHOOL,4TH,2,0,0,29,22,53,31,58%
2180,MONTROSE COUNTY RE-1J,6366,NORTHSIDE ELEMENTARY SCHOOL,5TH,0,1,0,31,36,68,32,47%
2180,MONTROSE COUNTY RE-1J,6366,NORTHSIDE ELEMENTARY SCHOOL,SCHOOL TOTAL,3,1,5,189,219,417,198,47%
2180,MONTROSE COUNTY RE-1J,6466,OAK GROVE ELEMENTARY SCHOOL,HALF DAY K,1,0,0,27,36,64,28,44%
2180,MONTROSE COUNTY RE-1J,6466,OAK GROVE ELEMENTARY SCHOOL,1ST,0,0,0,22,33,55,22,40%
2180,MONTROSE COUNTY RE-1J,6466,OAK GROVE ELEMENTARY SCHOOL,2ND,0,1,3,19,58,81,23,28%
2180,MONTROSE COUNTY RE-1J,6466,OAK GROVE ELEMENTARY SCHOOL,3RD,0,1,2,26,42,71,29,41%
2180,MONTROSE COUNTY RE-1J,6466,OAK GROVE ELEMENTARY SCHOOL,4TH,0,0,1,17,38,56,18,32%
2180,MONTROSE COUNTY RE-1J,6466,OAK GROVE ELEMENTARY SCHOOL,5TH,0,0,0,22,47,69,22,32%
2180,MONTROSE COUNTY RE-1J,6466,OAK GROVE ELEMENTARY SCHOOL,SCHOOL TOTAL,1,2,6,133,254,396,142,36%
2180,MONTROSE COUNTY RE-1J,6486,OLATHE ELEMENTARY SCHOOL,KINDERGARTEN,0,0,0,30,31,61,30,49%
2180,MONTROSE COUNTY RE-1J,6486,OLATHE ELEMENTARY SCHOOL,1ST,2,1,0,39,38,80,42,53%
2180,MONTROSE COUNTY RE-1J,6486,OLATHE ELEMENTARY SCHOOL,2ND,0,0,0,35,37,72,35,49%
2180,MONTROSE COUNTY RE-1J,6486,OLATHE ELEMENTARY SCHOOL,3RD,2,0,0,50,40,92,52,57%
2180,MONTROSE COUNTY RE-1J,6486,OLATHE ELEMENTARY SCHOOL,4TH,1,1,0,47,38,87,49,56%
2180,MONTROSE COUNTY RE-1J,6486,OLATHE ELEMENTARY SCHOOL,5TH,0,0,0,49,56,105,49,47%
2180,MONTROSE COUNTY RE-1J,6486,OLATHE ELEMENTARY SCHOOL,SCHOOL TOTAL,5,2,0,250,240,497,257,52%
2180,MONTROSE COUNTY RE-1J,6490,OLATHE MIDDLE SCHOOL,6TH,1,0,1,41,57,100,43,43%
2180,MONTROSE COUNTY RE-1J,6490,OLATHE MIDDLE SCHOOL,7TH,0,1,1,47,56,105,49,47%
2180,MONTROSE COUNTY RE-1J,6490,OLATHE MIDDLE SCHOOL,8TH,1,0,0,36,56,93,37,40%
2180,MONTROSE COUNTY RE-1J,6490,OLATHE MIDDLE SCHOOL,SCHOOL TOTAL,2,1,2,124,169,298,129,43%
2180,MONTROSE COUNTY RE-1J,6494,OLATHE HIGH SCHOOL,9TH,1,1,1,42,56,101,45,45%
2180,MONTROSE COUNTY RE-1J,6494,OLATHE HIGH SCHOOL,10TH,2,0,0,36,54,92,38,41%
2180,MONTROSE COUNTY RE-1J,6494,OLATHE HIGH SCHOOL,11TH,2,1,0,38,42,83,41,49%
2180,MONTROSE COUNTY RE-1J,6494,OLATHE HIGH SCHOOL,12TH,0,0,1,25,55,81,26,32%
2180,MONTROSE COUNTY RE-1J,6494,OLATHE HIGH SCHOOL,SCHOOL TOTAL,5,2,2,141,207,357,150,42%
2180,MONTROSE COUNTY RE-1J,6807,PASSAGE CHARTER SCHOOL,9TH,0,0,0,5,2,7,5,71%
2180,MONTROSE COUNTY RE-1J,6807,PASSAGE CHARTER SCHOOL,10TH,0,0,0,4,1,5,4,80%
2180,MONTROSE COUNTY RE-1J,6807,PASSAGE CHARTER SCHOOL,11TH,0,0,0,6,3,9,6,67%
2180,MONTROSE COUNTY RE-1J,6807,PASSAGE CHARTER SCHOOL,12TH,0,0,0,3,5,8,3,38%
2180,MONTROSE COUNTY RE-1J,6807,PASSAGE CHARTER SCHOOL,SCHOOL TOTAL,0,0,0,18,11,29,18,62%
2180,MONTROSE COUNTY RE-1J,7106,POMONA ELEMENTARY SCHOOL,HALF DAY K,0,0,0,15,65,80,15,19%
2180,MONTROSE COUNTY RE-1J,7106,POMONA ELEMENTARY SCHOOL,1ST,0,0,0,21,40,61,21,34%
2180,MONTROSE COUNTY RE-1J,7106,POMONA ELEMENTARY SCHOOL,2ND,1,1,1,19,54,76,22,29%
2180,MONTROSE COUNTY RE-1J,7106,POMONA ELEMENTARY SCHOOL,3RD,1,0,2,23,50,76,26,34%
2180,MONTROSE COUNTY RE-1J,7106,POMONA ELEMENTARY SCHOOL,4TH,0,1,0,21,60,82,22,27%
2180,MONTROSE COUNTY RE-1J,7106,POMONA ELEMENTARY SCHOOL,5TH,0,0,1,19,60,80,20,25%
2180,MONTROSE COUNTY RE-1J,7106,POMONA ELEMENTARY SCHOOL,SCHOOL TOTAL,2,2,4,118,329,455,126,28%
2180,MONTROSE COUNTY RE-1J,9149,VISTA CHARTER SCHOOL,9TH,0,0,0,1,4,5,1,20%
2180,MONTROSE COUNTY RE-1J,9149,VISTA CHARTER SCHOOL,10TH,0,0,1,8,12,21,9,43%
2180,MONTROSE COUNTY RE-1J,9149,VISTA CHARTER SCHOOL,11TH,2,1,0,12,41,56,15,27%
2180,MONTROSE COUNTY RE-1J,9149,VISTA CHARTER SCHOOL,12TH,2,1,0,33,69,105,36,34%
2180,MONTROSE COUNTY RE-1J,9149,VISTA CHARTER SCHOOL,SCHOOL TOTAL,4,2,1,54,126,187,61,33%
2180,MONTROSE COUNTY RE-1J,,DISTRICT TOTAL,,55,71,54,2088,4253,6521,2268,35%
2190,WEST END RE-2,6196,NATURITA ELEMENTARY SCHOOL,PK,1,0,0,0,28,29,1,3%
2190,WEST END RE-2,6196,NATURITA ELEMENTARY SCHOOL,HALF DAY K,0,0,0,1,21,22,1,5%
2190,WEST END RE-2,6196,NATURITA ELEMENTARY SCHOOL,1ST,0,0,0,1,22,23,1,4%
2190,WEST END RE-2,6196,NATURITA ELEMENTARY SCHOOL,2ND,0,0,0,3,20,23,3,13%
2190,WEST END RE-2,6196,NATURITA ELEMENTARY SCHOOL,3RD,0,0,0,3,16,19,3,16%
2190,WEST END RE-2,6196,NATURITA ELEMENTARY SCHOOL,4TH,0,0,0,1,12,13,1,8%
2190,WEST END RE-2,6196,NATURITA ELEMENTARY SCHOOL,5TH,0,1,0,1,23,25,2,8%
2190,WEST END RE-2,6196,NATURITA ELEMENTARY SCHOOL,6TH,0,0,0,2,18,20,2,10%
2190,WEST END RE-2,6196,NATURITA ELEMENTARY SCHOOL,SCHOOL TOTAL,1,1,0,12,160,174,14,8%
2190,WEST END RE-2,6436,NUCLA JUNIOR/SENIOR HIGH SCHOOL,7TH,1,0,0,3,16,20,4,20%
2190,WEST END RE-2,6436,NUCLA JUNIOR/SENIOR HIGH SCHOOL,8TH,1,0,0,0,19,20,1,5%
2190,WEST END RE-2,6436,NUCLA JUNIOR/SENIOR HIGH SCHOOL,9TH,1,0,0,3,29,33,4,12%
2190,WEST END RE-2,6436,NUCLA JUNIOR/SENIOR HIGH SCHOOL,10TH,0,0,0,0,12,12,0,0%
2190,WEST END RE-2,6436,NUCLA JUNIOR/SENIOR HIGH SCHOOL,11TH,0,2,0,0,20,22,2,9%
2190,WEST END RE-2,6436,NUCLA JUNIOR/SENIOR HIGH SCHOOL,12TH,0,0,0,2,19,21,2,10%
2190,WEST END RE-2,6436,NUCLA JUNIOR/SENIOR HIGH SCHOOL,SCHOOL TOTAL,3,2,0,8,115,128,13,10%
2190,WEST END RE-2,6718,PARADOX VALLEY CHARTER SCHOOL,PK,0,0,1,0,5,6,1,17%
2190,WEST END RE-2,6718,PARADOX VALLEY CHARTER SCHOOL,KINDERGARTEN,0,0,1,0,6,7,1,14%
2190,WEST END RE-2,6718,PARADOX VALLEY CHARTER SCHOOL,1ST,0,0,1,0,4,5,1,20%
2190,WEST END RE-2,6718,PARADOX VALLEY CHARTER SCHOOL,2ND,0,0,0,1,2,3,1,33%
2190,WEST END RE-2,6718,PARADOX VALLEY CHARTER SCHOOL,3RD,1,0,0,0,3,4,1,25%
2190,WEST END RE-2,6718,PARADOX VALLEY CHARTER SCHOOL,4TH,0,0,1,0,5,6,1,17%
2190,WEST END RE-2,6718,PARADOX VALLEY CHARTER SCHOOL,5TH,0,0,0,0,7,7,0,0%
2190,WEST END RE-2,6718,PARADOX VALLEY CHARTER SCHOOL,6TH,0,0,0,0,3,3,0,0%
2190,WEST END RE-2,6718,PARADOX VALLEY CHARTER SCHOOL,7TH,0,0,0,0,3,3,0,0%
2190,WEST END RE-2,6718,PARADOX VALLEY CHARTER SCHOOL,SCHOOL TOTAL,1,0,4,1,38,44,6,14%
2190,WEST END RE-2,,DISTRICT TOTAL,,5,3,4,21,313,346,33,10%
2395,BRUSH RE-2(J),1094,BRUSH MIDDLE SCHOOL,6TH,0,0,3,41,54,98,44,45%
2395,BRUSH RE-2(J),1094,BRUSH MIDDLE SCHOOL,7TH,0,0,1,65,62,128,66,52%
2395,BRUSH RE-2(J),1094,BRUSH MIDDLE SCHOOL,8TH,0,0,2,58,57,117,60,51%
2395,BRUSH RE-2(J),1094,BRUSH MIDDLE SCHOOL,SCHOOL TOTAL,0,0,6,164,173,343,170,50%
2395,BRUSH RE-2(J),1096,BRUSH HIGH SCHOOL,9TH,0,0,3,46,45,94,49,52%
2395,BRUSH RE-2(J),1096,BRUSH HIGH SCHOOL,10TH,0,1,3,43,51,98,47,48%
2395,BRUSH RE-2(J),1096,BRUSH HIGH SCHOOL,11TH,1,0,1,50,71,123,52,42%
2395,BRUSH RE-2(J),1096,BRUSH HIGH SCHOOL,12TH,1,0,1,35,62,99,37,37%
2395,BRUSH RE-2(J),1096,BRUSH HIGH SCHOOL,SCHOOL TOTAL,2,1,8,174,229,414,185,45%
2395,BRUSH RE-2(J),1438,BEAVER VALLEY ELEMENTARY SCHOOL,3RD,2,1,0,47,52,102,50,49%
2395,BRUSH RE-2(J),1438,BEAVER VALLEY ELEMENTARY SCHOOL,4TH,0,0,1,62,60,123,63,51%
2395,BRUSH RE-2(J),1438,BEAVER VALLEY ELEMENTARY SCHOOL,5TH,2,0,2,54,56,114,58,51%
2395,BRUSH RE-2(J),1438,BEAVER VALLEY ELEMENTARY SCHOOL,SCHOOL TOTAL,4,1,3,163,168,339,171,50%
2395,BRUSH RE-2(J),8832,THOMSON PRIMARY SCHOOL,PK,0,0,1,21,55,77,22,29%
2395,BRUSH RE-2(J),8832,THOMSON PRIMARY SCHOOL,KINDERGARTEN,0,0,2,45,49,96,47,49%
2395,BRUSH RE-2(J),8832,THOMSON PRIMARY SCHOOL,1ST,1,1,1,52,45,100,55,55%
2395,BRUSH RE-2(J),8832,THOMSON PRIMARY SCHOOL,2ND,0,1,0,54,62,117,55,47%
2395,BRUSH RE-2(J),8832,THOMSON PRIMARY SCHOOL,SCHOOL TOTAL,1,2,4,172,211,390,179,46%
2395,BRUSH RE-2(J),,DISTRICT TOTAL,,7,4,21,673,781,1486,705,47%
2405,FORT MORGAN RE-3,0492,BAKER CENTRAL SCHOOL,5TH,0,2,4,141,100,247,147,60%
2405,FORT MORGAN RE-3,0492,BAKER CENTRAL SCHOOL,6TH,1,0,3,145,88,237,149,63%
2405,FORT MORGAN RE-3,0492,BAKER CENTRAL SCHOOL,SCHOOL TOTAL,1,2,7,286,188,484,296,61%
2405,FORT MORGAN RE-3,1850,COLUMBINE ELEMENTARY SCHOOL,1ST,0,1,1,40,37,79,42,53%
2405,FORT MORGAN RE-3,1850,COLUMBINE ELEMENTARY SCHOOL,2ND,2,1,0,60,37,100,63,63%
2405,FORT MORGAN RE-3,1850,COLUMBINE ELEMENTARY SCHOOL,3RD,1,0,2,46,42,91,49,54%
2405,FORT MORGAN RE-3,1850,COLUMBINE ELEMENTARY SCHOOL,4TH,0,0,0,45,36,81,45,56%
2405,FORT MORGAN RE-3,1850,COLUMBINE ELEMENTARY SCHOOL,SCHOOL TOTAL,3,2,3,191,152,351,199,57%
2405,FORT MORGAN RE-3,3074,FORT MORGAN MIDDLE SCHOOL,7TH,1,0,9,143,92,245,153,62%
2405,FORT MORGAN RE-3,3074,FORT MORGAN MIDDLE SCHOOL,8TH,1,0,7,112,94,214,120,56%
2405,FORT MORGAN RE-3,3074,FORT MORGAN MIDDLE SCHOOL,SCHOOL TOTAL,2,0,16,255,186,459,273,59%
2405,FORT MORGAN RE-3,3078,FORT MORGAN HIGH SCHOOL,9TH,1,1,8,122,107,239,132,55%
2405,FORT MORGAN RE-3,3078,FORT MORGAN HIGH SCHOOL,10TH,0,0,2,125,107,234,127,54%
2405,FORT MORGAN RE-3,3078,FORT MORGAN HIGH SCHOOL,11TH,1,0,6,100,88,195,107,55%
2405,FORT MORGAN RE-3,3078,FORT MORGAN HIGH SCHOOL,12TH,1,0,13,103,91,208,117,56%
2405,FORT MORGAN RE-3,3078,FORT MORGAN HIGH SCHOOL,SCHOOL TOTAL,3,1,29,450,393,876,483,55%
2405,FORT MORGAN RE-3,3620,GREEN ACRES ELEMENTARY SCHOOL,1ST,0,1,3,42,37,83,46,55%
2405,FORT MORGAN RE-3,3620,GREEN ACRES ELEMENTARY SCHOOL,2ND,1,0,2,35,45,83,38,46%
2405,FORT MORGAN RE-3,3620,GREEN ACRES ELEMENTARY SCHOOL,3RD,0,0,1,32,42,75,33,44%
2405,FORT MORGAN RE-3,3620,GREEN ACRES ELEMENTARY SCHOOL,4TH,0,0,1,38,42,81,39,48%
2405,FORT MORGAN RE-3,3620,GREEN ACRES ELEMENTARY SCHOOL,SCHOOL TOTAL,1,1,7,147,166,322,156,48%
2405,FORT MORGAN RE-3,5180,LINCOLN HIGH SCHOOL,9TH,0,0,0,0,5,5,0,0%
2405,FORT MORGAN RE-3,5180,LINCOLN HIGH SCHOOL,10TH,0,0,0,4,5,9,4,44%
2405,FORT MORGAN RE-3,5180,LINCOLN HIGH SCHOOL,11TH,1,0,0,3,6,10,4,40%
2405,FORT MORGAN RE-3,5180,LINCOLN HIGH SCHOOL,12TH,0,0,0,11,11,22,11,50%
2405,FORT MORGAN RE-3,5180,LINCOLN HIGH SCHOOL,SCHOOL TOTAL,1,0,0,18,27,46,19,41%
2405,FORT MORGAN RE-3,6954,PIONEER ELEMENTARY SCHOOL,1ST,0,2,6,53,18,79,61,77%
2405,FORT MORGAN RE-3,6954,PIONEER ELEMENTARY SCHOOL,2ND,0,0,6,58,20,84,64,76%
2405,FORT MORGAN RE-3,6954,PIONEER ELEMENTARY SCHOOL,3RD,0,1,4,65,21,91,70,77%
2405,FORT MORGAN RE-3,6954,PIONEER ELEMENTARY SCHOOL,4TH,0,0,2,48,24,74,50,68%
2405,FORT MORGAN RE-3,6954,PIONEER ELEMENTARY SCHOOL,SCHOOL TOTAL,0,3,18,224,83,328,245,75%
2405,FORT MORGAN RE-3,7856,SHERMAN EARLY CHILDHOOD CENTER,PK,0,0,3,75,70,148,78,53%
2405,FORT MORGAN RE-3,7856,SHERMAN EARLY CHILDHOOD CENTER,KINDERGARTEN,1,1,6,87,123,218,95,44%
2405,FORT MORGAN RE-3,7856,SHERMAN EARLY CHILDHOOD CENTER,SCHOOL TOTAL,1,1,9,162,193,366,173,47%
2405,FORT MORGAN RE-3,,DISTRICT TOTAL,,12,10,89,1733,1388,3232,1844,57%
2505,WELDON VALLEY RE-20(J),9352,WELDON VALLEY ELEMENTARY SCHOOL,PK,0,0,0,0,16,16,0,0%
2505,WELDON VALLEY RE-20(J),9352,WELDON VALLEY ELEMENTARY SCHOOL,KINDERGARTEN,0,0,0,2,16,18,2,11%
2505,WELDON VALLEY RE-20(J),9352,WELDON VALLEY ELEMENTARY SCHOOL,1ST,0,0,0,2,10,12,2,17%
2505,WELDON VALLEY RE-20(J),9352,WELDON VALLEY ELEMENTARY SCHOOL,2ND,0,0,1,5,11,17,6,35%
2505,WELDON VALLEY RE-20(J),9352,WELDON VALLEY ELEMENTARY SCHOOL,3RD,0,0,0,2,11,13,2,15%
2505,WELDON VALLEY RE-20(J),9352,WELDON VALLEY ELEMENTARY SCHOOL,4TH,0,0,0,1,12,13,1,8%
2505,WELDON VALLEY RE-20(J),9352,WELDON VALLEY ELEMENTARY SCHOOL,5TH,0,1,0,2,17,20,3,15%
2505,WELDON VALLEY RE-20(J),9352,WELDON VALLEY ELEMENTARY SCHOOL,6TH,0,0,0,2,17,19,2,11%
2505,WELDON VALLEY RE-20(J),9352,WELDON VALLEY ELEMENTARY SCHOOL,SCHOOL TOTAL,0,1,1,16,110,128,18,14%
2505,WELDON VALLEY RE-20(J),9356,WELDON VALLEY JUNIOR HIGH SCHOOL,7TH,0,2,0,2,11,15,4,27%
2505,WELDON VALLEY RE-20(J),9356,WELDON VALLEY JUNIOR HIGH SCHOOL,8TH,0,1,1,1,11,14,3,21%
2505,WELDON VALLEY RE-20(J),9356,WELDON VALLEY JUNIOR HIGH SCHOOL,SCHOOL TOTAL,0,3,1,3,22,29,7,24%
2505,WELDON VALLEY RE-20(J),9360,WELDON VALLEY HIGH SCHOOL,9TH,0,1,0,2,14,17,3,18%
2505,WELDON VALLEY RE-20(J),9360,WELDON VALLEY HIGH SCHOOL,10TH,0,0,0,0,12,12,0,0%
2505,WELDON VALLEY RE-20(J),9360,WELDON VALLEY HIGH SCHOOL,11TH,0,0,0,4,9,13,4,31%
2505,WELDON VALLEY RE-20(J),9360,WELDON VALLEY HIGH SCHOOL,12TH,0,0,0,2,10,12,2,17%
2505,WELDON VALLEY RE-20(J),9360,WELDON VALLEY HIGH SCHOOL,SCHOOL TOTAL,0,1,0,8,45,54,9,17%
2505,WELDON VALLEY RE-20(J),,DISTRICT TOTAL,,0,5,2,27,177,211,34,16%
2515,WIGGINS RE-50(J),9263,WIGGINS MIDDLE SCHOOL,6TH,0,0,0,4,34,38,4,11%
2515,WIGGINS RE-50(J),9263,WIGGINS MIDDLE SCHOOL,7TH,0,0,0,5,33,38,5,13%
2515,WIGGINS RE-50(J),9263,WIGGINS MIDDLE SCHOOL,8TH,0,0,0,12,32,44,12,27%
2515,WIGGINS RE-50(J),9263,WIGGINS MIDDLE SCHOOL,SCHOOL TOTAL,0,0,0,21,99,120,21,18%
2515,WIGGINS RE-50(J),9576,WIGGINS ELEMENTARY SCHOOL,PK,0,0,1,11,42,54,12,22%
2515,WIGGINS RE-50(J),9576,WIGGINS ELEMENTARY SCHOOL,KINDERGARTEN,1,1,0,10,31,43,12,28%
2515,WIGGINS RE-50(J),9576,WIGGINS ELEMENTARY SCHOOL,1ST,1,2,1,13,20,37,17,46%
2515,WIGGINS RE-50(J),9576,WIGGINS ELEMENTARY SCHOOL,2ND,1,0,0,15,27,43,16,37%
2515,WIGGINS RE-50(J),9576,WIGGINS ELEMENTARY SCHOOL,3RD,0,0,0,8,20,28,8,29%
2515,WIGGINS RE-50(J),9576,WIGGINS ELEMENTARY SCHOOL,4TH,1,0,1,8,24,34,10,29%
2515,WIGGINS RE-50(J),9576,WIGGINS ELEMENTARY SCHOOL,5TH,1,2,0,10,25,38,13,34%
2515,WIGGINS RE-50(J),9576,WIGGINS ELEMENTARY SCHOOL,SCHOOL TOTAL,5,5,3,75,189,277,88,32%
2515,WIGGINS RE-50(J),9582,WIGGINS HIGH SCHOOL,9TH,0,0,0,9,26,35,9,26%
2515,WIGGINS RE-50(J),9582,WIGGINS HIGH SCHOOL,10TH,0,1,0,12,34,47,13,28%
2515,WIGGINS RE-50(J),9582,WIGGINS HIGH SCHOOL,11TH,0,1,0,8,32,41,9,22%
2515,WIGGINS RE-50(J),9582,WIGGINS HIGH SCHOOL,12TH,0,1,0,8,37,46,9,20%
2515,WIGGINS RE-50(J),9582,WIGGINS HIGH SCHOOL,SCHOOL TOTAL,0,3,0,37,129,169,40,24%
2515,WIGGINS RE-50(J),,DISTRICT TOTAL,,5,8,3,133,417,566,149,26%
2520,EAST OTERO R-1,4841,LA JUNTA INTERMEDIATE SCHOOL,3RD,0,1,1,57,31,90,59,66%
2520,EAST OTERO R-1,4841,LA JUNTA INTERMEDIATE SCHOOL,4TH,0,1,1,58,36,96,60,63%
2520,EAST OTERO R-1,4841,LA JUNTA INTERMEDIATE SCHOOL,5TH,2,0,0,54,30,86,56,65%
2520,EAST OTERO R-1,4841,LA JUNTA INTERMEDIATE SCHOOL,SCHOOL TOTAL,2,2,2,169,97,272,175,64%
2520,EAST OTERO R-1,4842,LA JUNTA MIDDLE SCHOOL,6TH,2,0,0,55,40,97,57,59%
2520,EAST OTERO R-1,4842,LA JUNTA MIDDLE SCHOOL,7TH,4,1,1,46,45,97,52,54%
2520,EAST OTERO R-1,4842,LA JUNTA MIDDLE SCHOOL,8TH,1,3,0,52,31,87,56,64%
2520,EAST OTERO R-1,4842,LA JUNTA MIDDLE SCHOOL,SCHOOL TOTAL,7,4,1,153,116,281,165,59%
2520,EAST OTERO R-1,4843,LA JUNTA PRIMARY SCHOOL,KINDERGARTEN,0,1,0,66,42,109,67,61%
2520,EAST OTERO R-1,4843,LA JUNTA PRIMARY SCHOOL,1ST,0,1,3,81,44,129,85,66%
2520,EAST OTERO R-1,4843,LA JUNTA PRIMARY SCHOOL,2ND,1,0,1,65,42,109,67,61%
2520,EAST OTERO R-1,4843,LA JUNTA PRIMARY SCHOOL,SCHOOL TOTAL,1,2,4,212,128,347,219,63%
2520,EAST OTERO R-1,4844,LA JUNTA HIGH SCHOOL,9TH,1,0,1,49,42,93,51,55%
2520,EAST OTERO R-1,4844,LA JUNTA HIGH SCHOOL,10TH,2,3,1,50,47,103,56,54%
2520,EAST OTERO R-1,4844,LA JUNTA HIGH SCHOOL,11TH,2,1,3,53,36,95,59,62%
2520,EAST OTERO R-1,4844,LA JUNTA HIGH SCHOOL,12TH,2,0,0,53,42,97,55,57%
2520,EAST OTERO R-1,4844,LA JUNTA HIGH SCHOOL,SCHOOL TOTAL,7,4,5,205,167,388,221,57%
2520,EAST OTERO R-1,8849,TIGER LEARNING CENTER,9TH,0,0,0,0,1,1,0,0%
2520,EAST OTERO R-1,8849,TIGER LEARNING CENTER,10TH,1,0,0,6,3,10,7,70%
2520,EAST OTERO R-1,8849,TIGER LEARNING CENTER,11TH,0,0,0,10,0,10,10,100%
2520,EAST OTERO R-1,8849,TIGER LEARNING CENTER,12TH,0,0,0,7,2,9,7,78%
2520,EAST OTERO R-1,8849,TIGER LEARNING CENTER,SCHOOL TOTAL,1,0,0,23,6,30,24,80%
2520,EAST OTERO R-1,,DISTRICT TOTAL,,18,12,12,762,514,1318,804,61%
2530,ROCKY FORD R-2,4418,JEFFERSON MIDDLE SCHOOL,6TH,1,0,0,33,20,54,34,63%
2530,ROCKY FORD R-2,4418,JEFFERSON MIDDLE SCHOOL,7TH,0,2,0,43,11,56,45,80%
2530,ROCKY FORD R-2,4418,JEFFERSON MIDDLE SCHOOL,8TH,0,0,1,42,15,58,43,74%
2530,ROCKY FORD R-2,4418,JEFFERSON MIDDLE SCHOOL,SCHOOL TOTAL,1,2,1,118,46,168,122,73%
2530,ROCKY FORD R-2,5114,LIBERTY ELEMENTARY SCHOOL,3RD,1,2,0,44,22,69,47,68%
2530,ROCKY FORD R-2,5114,LIBERTY ELEMENTARY SCHOOL,4TH,0,1,0,47,30,78,48,62%
2530,ROCKY FORD R-2,5114,LIBERTY ELEMENTARY SCHOOL,5TH,0,0,1,48,17,66,49,74%
2530,ROCKY FORD R-2,5114,LIBERTY ELEMENTARY SCHOOL,SCHOOL TOTAL,1,3,1,139,69,213,144,68%
2530,ROCKY FORD R-2,7442,ROCKY FORD HIGH SCHOOL,9TH,0,1,0,44,17,62,45,73%
2530,ROCKY FORD R-2,7442,ROCKY FORD HIGH SCHOOL,10TH,0,2,1,37,11,51,40,78%
2530,ROCKY FORD R-2,7442,ROCKY FORD HIGH SCHOOL,11TH,0,1,0,36,22,59,37,63%
2530,ROCKY FORD R-2,7442,ROCKY FORD HIGH SCHOOL,12TH,0,1,0,28,23,52,29,56%
2530,ROCKY FORD R-2,7442,ROCKY FORD HIGH SCHOOL,SCHOOL TOTAL,0,5,1,145,73,224,151,67%
2530,ROCKY FORD R-2,9264,WASHINGTON PRIMARY SCHOOL,PK,0,0,0,28,26,54,28,52%
2530,ROCKY FORD R-2,9264,WASHINGTON PRIMARY SCHOOL,KINDERGARTEN,0,1,3,51,18,73,55,75%
2530,ROCKY FORD R-2,9264,WASHINGTON PRIMARY SCHOOL,1ST,0,0,0,58,22,80,58,73%
2530,ROCKY FORD R-2,9264,WASHINGTON PRIMARY SCHOOL,2ND,0,0,1,52,13,66,53,80%
2530,ROCKY FORD R-2,9264,WASHINGTON PRIMARY SCHOOL,SCHOOL TOTAL,0,1,4,189,79,273,194,71%
2530,ROCKY FORD R-2,,DISTRICT TOTAL,,2,11,7,591,267,878,611,70%
2535,MANZANOLA 3J,5498,MANZANOLA ELEMENTARY SCHOOL,KINDERGARTEN,0,0,1,6,5,12,7,58%
2535,MANZANOLA 3J,5498,MANZANOLA ELEMENTARY SCHOOL,1ST,0,0,0,8,3,11,8,73%
2535,MANZANOLA 3J,5498,MANZANOLA ELEMENTARY SCHOOL,2ND,0,0,1,8,0,9,9,100%
2535,MANZANOLA 3J,5498,MANZANOLA ELEMENTARY SCHOOL,3RD,1,0,0,6,7,14,7,50%
2535,MANZANOLA 3J,5498,MANZANOLA ELEMENTARY SCHOOL,4TH,1,0,0,9,3,13,10,77%
2535,MANZANOLA 3J,5498,MANZANOLA ELEMENTARY SCHOOL,5TH,0,0,0,9,5,14,9,64%
2535,MANZANOLA 3J,5498,MANZANOLA ELEMENTARY SCHOOL,6TH,0,0,0,10,3,13,10,77%
2535,MANZANOLA 3J,5498,MANZANOLA ELEMENTARY SCHOOL,SCHOOL TOTAL,2,0,2,56,26,86,60,70%
2535,MANZANOLA 3J,5506,MANZANOLA JUNIOR-SENIOR HIGH SCHOOL,7TH,0,0,0,14,0,14,14,100%
2535,MANZANOLA 3J,5506,MANZANOLA JUNIOR-SENIOR HIGH SCHOOL,8TH,0,0,1,12,9,22,13,59%
2535,MANZANOLA 3J,5506,MANZANOLA JUNIOR-SENIOR HIGH SCHOOL,9TH,0,0,0,11,1,12,11,92%
2535,MANZANOLA 3J,5506,MANZANOLA JUNIOR-SENIOR HIGH SCHOOL,10TH,0,0,0,10,6,16,10,63%
2535,MANZANOLA 3J,5506,MANZANOLA JUNIOR-SENIOR HIGH SCHOOL,11TH,0,0,0,10,3,13,10,77%
2535,MANZANOLA 3J,5506,MANZANOLA JUNIOR-SENIOR HIGH SCHOOL,12TH,0,0,0,9,5,14,9,64%
2535,MANZANOLA 3J,5506,MANZANOLA JUNIOR-SENIOR HIGH SCHOOL,SCHOOL TOTAL,0,0,1,66,24,91,67,74%
2535,MANZANOLA 3J,,DISTRICT TOTAL,,2,0,3,122,50,177,127,72%
2540,FOWLER R-4J,0056,FOWLER ELEMENTARY SCHOOL,KINDERGARTEN,0,0,0,9,25,34,9,26%
2540,FOWLER R-4J,0056,FOWLER ELEMENTARY SCHOOL,1ST,0,0,0,7,30,37,7,19%
2540,FOWLER R-4J,0056,FOWLER ELEMENTARY SCHOOL,2ND,0,0,0,6,27,33,6,18%
2540,FOWLER R-4J,0056,FOWLER ELEMENTARY SCHOOL,3RD,0,0,0,6,26,32,6,19%
2540,FOWLER R-4J,0056,FOWLER ELEMENTARY SCHOOL,4TH,0,0,0,7,23,30,7,23%
2540,FOWLER R-4J,0056,FOWLER ELEMENTARY SCHOOL,5TH,0,0,1,4,29,34,5,15%
2540,FOWLER R-4J,0056,FOWLER ELEMENTARY SCHOOL,6TH,0,0,1,7,21,29,8,28%
2540,FOWLER R-4J,0056,FOWLER ELEMENTARY SCHOOL,SCHOOL TOTAL,0,0,2,46,181,229,48,21%
2540,FOWLER R-4J,3130,FOWLER JUNIOR HIGH SCHOOL,7TH,0,0,0,4,29,33,4,12%
2540,FOWLER R-4J,3130,FOWLER JUNIOR HIGH SCHOOL,8TH,0,0,0,6,24,30,6,20%
2540,FOWLER R-4J,3130,FOWLER JUNIOR HIGH SCHOOL,SCHOOL TOTAL,0,0,0,10,53,63,10,16%
2540,FOWLER R-4J,3134,FOWLER HIGH SCHOOL,9TH,0,0,1,5,16,22,6,27%
2540,FOWLER R-4J,3134,FOWLER HIGH SCHOOL,10TH,0,0,0,1,28,29,1,3%
2540,FOWLER R-4J,3134,FOWLER HIGH SCHOOL,11TH,0,0,0,8,25,33,8,24%
2540,FOWLER R-4J,3134,FOWLER HIGH SCHOOL,12TH,0,0,0,5,21,26,5,19%
2540,FOWLER R-4J,3134,FOWLER HIGH SCHOOL,SCHOOL TOTAL,0,0,1,19,90,110,20,18%
2540,FOWLER R-4J,,DISTRICT TOTAL,,0,0,3,75,324,402,78,19%
2560,CHERAW 31,1538,CHERAW ELEMENTARY SCHOOL,PK,0,0,0,2,11,13,2,15%
2560,CHERAW 31,1538,CHERAW ELEMENTARY SCHOOL,KINDERGARTEN,0,0,1,1,9,11,2,18%
2560,CHERAW 31,1538,CHERAW ELEMENTARY SCHOOL,1ST,0,0,0,5,6,11,5,45%
2560,CHERAW 31,1538,CHERAW ELEMENTARY SCHOOL,2ND,0,0,0,4,9,13,4,31%
2560,CHERAW 31,1538,CHERAW ELEMENTARY SCHOOL,3RD,0,0,0,4,13,17,4,24%
2560,CHERAW 31,1538,CHERAW ELEMENTARY SCHOOL,4TH,0,0,0,5,12,17,5,29%
2560,CHERAW 31,1538,CHERAW ELEMENTARY SCHOOL,5TH,0,0,0,3,12,15,3,20%
2560,CHERAW 31,1538,CHERAW ELEMENTARY SCHOOL,SCHOOL TOTAL,0,0,1,24,72,97,25,26%
2560,CHERAW 31,1546,CHERAW HIGH SCHOOL,9TH,0,0,0,5,8,13,5,38%
2560,CHERAW 31,1546,CHERAW HIGH SCHOOL,10TH,0,0,0,3,19,22,3,14%
2560,CHERAW 31,1546,CHERAW HIGH SCHOOL,11TH,0,0,1,2,7,10,3,30%
2560,CHERAW 31,1546,CHERAW HIGH SCHOOL,12TH,0,0,0,2,11,13,2,15%
2560,CHERAW 31,1546,CHERAW HIGH SCHOOL,SCHOOL TOTAL,0,0,1,12,45,58,13,22%
2560,CHERAW 31,1548,CHERAW MIDDLE SCHOOL,6TH,0,0,0,5,17,22,5,23%
2560,CHERAW 31,1548,CHERAW MIDDLE SCHOOL,7TH,0,0,1,5,17,23,6,26%
2560,CHERAW 31,1548,CHERAW MIDDLE SCHOOL,8TH,0,0,0,0,10,10,0,0%
2560,CHERAW 31,1548,CHERAW MIDDLE SCHOOL,SCHOOL TOTAL,0,0,1,10,44,55,11,20%
2560,CHERAW 31,,DISTRICT TOTAL,,0,0,3,46,161,210,49,23%
2570,SWINK 33,8452,SWINK ELEMENTARY SCHOOL,HALF DAY K,1,1,0,6,16,24,8,33%
2570,SWINK 33,8452,SWINK ELEMENTARY SCHOOL,1ST,0,2,0,10,19,31,12,39%
2570,SWINK 33,8452,SWINK ELEMENTARY SCHOOL,2ND,0,0,0,11,16,27,11,41%
2570,SWINK 33,8452,SWINK ELEMENTARY SCHOOL,3RD,1,1,0,4,22,28,6,21%
2570,SWINK 33,8452,SWINK ELEMENTARY SCHOOL,4TH,0,2,0,8,12,22,10,45%
2570,SWINK 33,8452,SWINK ELEMENTARY SCHOOL,5TH,0,2,0,7,23,32,9,28%
2570,SWINK 33,8452,SWINK ELEMENTARY SCHOOL,6TH,0,3,0,5,20,28,8,29%
2570,SWINK 33,8452,SWINK ELEMENTARY SCHOOL,SCHOOL TOTAL,2,11,0,51,128,192,64,33%
2570,SWINK 33,8456,SWINK JUNIOR-SENIOR HIGH SCHOOL,7TH,0,1,1,11,18,31,13,42%
2570,SWINK 33,8456,SWINK JUNIOR-SENIOR HIGH SCHOOL,8TH,0,1,1,12,19,33,14,42%
2570,SWINK 33,8456,SWINK JUNIOR-SENIOR HIGH SCHOOL,9TH,0,0,1,8,19,28,9,32%
2570,SWINK 33,8456,SWINK JUNIOR-SENIOR HIGH SCHOOL,10TH,0,3,1,3,28,35,7,20%
2570,SWINK 33,8456,SWINK JUNIOR-SENIOR HIGH SCHOOL,11TH,0,0,0,6,22,28,6,21%
2570,SWINK 33,8456,SWINK JUNIOR-SENIOR HIGH SCHOOL,12TH,0,0,0,5,26,31,5,16%
2570,SWINK 33,8456,SWINK JUNIOR-SENIOR HIGH SCHOOL,SCHOOL TOTAL,0,5,4,45,132,186,54,29%
2570,SWINK 33,,DISTRICT TOTAL,,2,16,4,96,260,378,118,31%
2580,OURAY R-1,6596,OURAY ELEMENTARY SCHOOL,PK,0,0,0,3,11,14,3,21%
2580,OURAY R-1,6596,OURAY ELEMENTARY SCHOOL,KINDERGARTEN,0,0,0,1,7,8,1,13%
2580,OURAY R-1,6596,OURAY ELEMENTARY SCHOOL,1ST,0,0,0,1,14,15,1,7%
2580,OURAY R-1,6596,OURAY ELEMENTARY SCHOOL,2ND,0,1,0,1,9,11,2,18%
2580,OURAY R-1,6596,OURAY ELEMENTARY SCHOOL,3RD,1,0,0,1,12,14,2,14%
2580,OURAY R-1,6596,OURAY ELEMENTARY SCHOOL,4TH,0,0,0,1,14,15,1,7%
2580,OURAY R-1,6596,OURAY ELEMENTARY SCHOOL,5TH,0,1,0,2,17,20,3,15%
2580,OURAY R-1,6596,OURAY ELEMENTARY SCHOOL,6TH,0,0,0,1,17,18,1,6%
2580,OURAY R-1,6596,OURAY ELEMENTARY SCHOOL,SCHOOL TOTAL,1,2,0,11,101,115,14,12%
2580,OURAY R-1,6598,OURAY MIDDLE SCHOOL,7TH,0,0,0,2,14,16,2,13%
2580,OURAY R-1,6598,OURAY MIDDLE SCHOOL,8TH,0,0,0,0,16,16,0,0%
2580,OURAY R-1,6598,OURAY MIDDLE SCHOOL,SCHOOL TOTAL,0,0,0,2,30,32,2,6%
2580,OURAY R-1,6600,OURAY SENIOR HIGH SCHOOL,9TH,0,0,0,4,9,13,4,31%
2580,OURAY R-1,6600,OURAY SENIOR HIGH SCHOOL,10TH,0,0,0,3,24,27,3,11%
2580,OURAY R-1,6600,OURAY SENIOR HIGH SCHOOL,11TH,0,1,0,1,17,19,2,11%
2580,OURAY R-1,6600,OURAY SENIOR HIGH SCHOOL,12TH,0,0,1,4,19,24,5,21%
2580,OURAY R-1,6600,OURAY SENIOR HIGH SCHOOL,SCHOOL TOTAL,0,1,1,12,69,83,14,17%
2580,OURAY R-1,,DISTRICT TOTAL,,1,3,1,25,200,230,30,13%
2590,RIDGWAY R-2,7342,RIDGWAY ELEMENTARY SCHOOL,PK,0,1,0,5,29,35,6,17%
2590,RIDGWAY R-2,7342,RIDGWAY ELEMENTARY SCHOOL,KINDERGARTEN,0,0,0,1,26,27,1,4%
2590,RIDGWAY R-2,7342,RIDGWAY ELEMENTARY SCHOOL,1ST,0,0,0,1,18,19,1,5%
2590,RIDGWAY R-2,7342,RIDGWAY ELEMENTARY SCHOOL,2ND,0,1,1,2,23,27,4,15%
2590,RIDGWAY R-2,7342,RIDGWAY ELEMENTARY SCHOOL,3RD,0,0,0,4,25,29,4,14%
2590,RIDGWAY R-2,7342,RIDGWAY ELEMENTARY SCHOOL,4TH,1,1,1,0,20,23,3,13%
2590,RIDGWAY R-2,7342,RIDGWAY ELEMENTARY SCHOOL,5TH,0,0,1,0,17,18,1,6%
2590,RIDGWAY R-2,7342,RIDGWAY ELEMENTARY SCHOOL,SCHOOL TOTAL,1,3,3,13,158,178,20,11%
2590,RIDGWAY R-2,7344,RIDGWAY MIDDLE SCHOOL,6TH,0,2,0,2,25,29,4,14%
2590,RIDGWAY R-2,7344,RIDGWAY MIDDLE SCHOOL,7TH,1,0,1,1,20,23,3,13%
2590,RIDGWAY R-2,7344,RIDGWAY MIDDLE SCHOOL,8TH,0,1,0,4,20,25,5,20%
2590,RIDGWAY R-2,7344,RIDGWAY MIDDLE SCHOOL,SCHOOL TOTAL,1,3,1,7,65,77,12,16%
2590,RIDGWAY R-2,7346,RIDGWAY HIGH SCHOOL,9TH,1,0,0,2,33,36,3,8%
2590,RIDGWAY R-2,7346,RIDGWAY HIGH SCHOOL,10TH,0,0,0,2,20,22,2,9%
2590,RIDGWAY R-2,7346,RIDGWAY HIGH SCHOOL,11TH,0,2,0,2,30,34,4,12%
2590,RIDGWAY R-2,7346,RIDGWAY HIGH SCHOOL,12TH,0,1,0,2,30,33,3,9%
2590,RIDGWAY R-2,7346,RIDGWAY HIGH SCHOOL,SCHOOL TOTAL,1,3,0,8,113,125,12,10%
2590,RIDGWAY R-2,,DISTRICT TOTAL,,3,9,4,28,336,380,44,12%
2600,PLATTE CANYON 1,7042,DEER CREEK ELEMENTARY SCHOOL,PK,4,1,2,3,92,102,10,10%
2600,PLATTE CANYON 1,7042,DEER CREEK ELEMENTARY SCHOOL,KINDERGARTEN,0,1,1,5,76,83,7,8%
2600,PLATTE CANYON 1,7042,DEER CREEK ELEMENTARY SCHOOL,1ST,2,2,1,14,66,85,19,22%
2600,PLATTE CANYON 1,7042,DEER CREEK ELEMENTARY SCHOOL,2ND,0,1,0,6,72,79,7,9%
2600,PLATTE CANYON 1,7042,DEER CREEK ELEMENTARY SCHOOL,3RD,4,0,0,5,80,89,9,10%
2600,PLATTE CANYON 1,7042,DEER CREEK ELEMENTARY SCHOOL,4TH,0,1,0,4,78,83,5,6%
2600,PLATTE CANYON 1,7042,DEER CREEK ELEMENTARY SCHOOL,5TH,1,1,2,3,73,80,7,9%
2600,PLATTE CANYON 1,7042,DEER CREEK ELEMENTARY SCHOOL,SCHOOL TOTAL,11,7,6,40,537,601,64,11%
2600,PLATTE CANYON 1,7046,PLATTE CANYON HIGH SCHOOL,9TH,0,4,1,2,76,83,7,8%
2600,PLATTE CANYON 1,7046,PLATTE CANYON HIGH SCHOOL,10TH,2,2,2,4,85,95,10,11%
2600,PLATTE CANYON 1,7046,PLATTE CANYON HIGH SCHOOL,11TH,0,2,2,3,106,113,7,6%
2600,PLATTE CANYON 1,7046,PLATTE CANYON HIGH SCHOOL,12TH,3,0,0,5,101,109,8,7%
2600,PLATTE CANYON 1,7046,PLATTE CANYON HIGH SCHOOL,SCHOOL TOTAL,5,8,5,14,368,400,32,8%
2600,PLATTE CANYON 1,7048,FITZSIMMONS MIDDLE SCHOOL,6TH,2,0,0,6,76,84,8,10%
2600,PLATTE CANYON 1,7048,FITZSIMMONS MIDDLE SCHOOL,7TH,2,1,3,3,69,78,9,12%
2600,PLATTE CANYON 1,7048,FITZSIMMONS MIDDLE SCHOOL,8TH,3,1,0,3,78,85,7,8%
2600,PLATTE CANYON 1,7048,FITZSIMMONS MIDDLE SCHOOL,SCHOOL TOTAL,7,2,3,12,223,247,24,10%
2600,PLATTE CANYON 1,,DISTRICT TOTAL,,23,17,14,66,1128,1248,120,10%
2610,PARK COUNTY RE-2,3681,GUFFEY CHARTER SCHOOL,PK,0,0,0,0,3,3,0,0%
2610,PARK COUNTY RE-2,3681,GUFFEY CHARTER SCHOOL,KINDERGARTEN,0,0,0,0,3,3,0,0%
2610,PARK COUNTY RE-2,3681,GUFFEY CHARTER SCHOOL,2ND,0,0,0,0,3,3,0,0%
2610,PARK COUNTY RE-2,3681,GUFFEY CHARTER SCHOOL,3RD,0,0,0,0,3,3,0,0%
2610,PARK COUNTY RE-2,3681,GUFFEY CHARTER SCHOOL,4TH,0,0,0,0,4,4,0,0%
2610,PARK COUNTY RE-2,3681,GUFFEY CHARTER SCHOOL,5TH,0,0,0,0,2,2,0,0%
2610,PARK COUNTY RE-2,3681,GUFFEY CHARTER SCHOOL,6TH,0,0,0,0,7,7,0,0%
2610,PARK COUNTY RE-2,3681,GUFFEY CHARTER SCHOOL,7TH,1,0,0,0,1,2,1,50%
2610,PARK COUNTY RE-2,3681,GUFFEY CHARTER SCHOOL,8TH,1,0,0,0,3,4,1,25%
2610,PARK COUNTY RE-2,3681,GUFFEY CHARTER SCHOOL,SCHOOL TOTAL,2,0,0,0,29,31,2,6%
2610,PARK COUNTY RE-2,4908,LAKE GEORGE CHARTER SCHOOL,PK,0,0,0,3,12,15,3,20%
2610,PARK COUNTY RE-2,4908,LAKE GEORGE CHARTER SCHOOL,KINDERGARTEN,0,0,0,1,15,16,1,6%
2610,PARK COUNTY RE-2,4908,LAKE GEORGE CHARTER SCHOOL,1ST,0,0,0,2,12,14,2,14%
2610,PARK COUNTY RE-2,4908,LAKE GEORGE CHARTER SCHOOL,2ND,0,0,0,0,8,8,0,0%
2610,PARK COUNTY RE-2,4908,LAKE GEORGE CHARTER SCHOOL,3RD,0,0,0,0,11,11,0,0%
2610,PARK COUNTY RE-2,4908,LAKE GEORGE CHARTER SCHOOL,4TH,0,0,0,1,7,8,1,13%
2610,PARK COUNTY RE-2,4908,LAKE GEORGE CHARTER SCHOOL,5TH,0,0,0,0,6,6,0,0%
2610,PARK COUNTY RE-2,4908,LAKE GEORGE CHARTER SCHOOL,6TH,0,0,0,0,7,7,0,0%
2610,PARK COUNTY RE-2,4908,LAKE GEORGE CHARTER SCHOOL,SCHOOL TOTAL,0,0,0,7,78,85,7,8%
2610,PARK COUNTY RE-2,7891,SILVERHEELS MIDDLE SCHOOL,6TH,0,0,0,2,25,27,2,7%
2610,PARK COUNTY RE-2,7891,SILVERHEELS MIDDLE SCHOOL,7TH,0,0,2,1,31,34,3,9%
2610,PARK COUNTY RE-2,7891,SILVERHEELS MIDDLE SCHOOL,8TH,0,0,0,1,35,36,1,3%
2610,PARK COUNTY RE-2,7891,SILVERHEELS MIDDLE SCHOOL,SCHOOL TOTAL,0,0,2,4,91,97,6,6%
2610,PARK COUNTY RE-2,8114,EDITH TETER ELEMENTARY SCHOOL,PK,0,0,2,0,63,65,2,3%
2610,PARK COUNTY RE-2,8114,EDITH TETER ELEMENTARY SCHOOL,HALF DAY K,0,0,1,2,31,34,3,9%
2610,PARK COUNTY RE-2,8114,EDITH TETER ELEMENTARY SCHOOL,1ST,0,1,0,5,32,38,6,16%
2610,PARK COUNTY RE-2,8114,EDITH TETER ELEMENTARY SCHOOL,2ND,0,0,0,2,31,33,2,6%
2610,PARK COUNTY RE-2,8114,EDITH TETER ELEMENTARY SCHOOL,3RD,0,0,1,3,24,28,4,14%
2610,PARK COUNTY RE-2,8114,EDITH TETER ELEMENTARY SCHOOL,4TH,0,0,0,0,24,24,0,0%
2610,PARK COUNTY RE-2,8114,EDITH TETER ELEMENTARY SCHOOL,5TH,0,0,0,2,25,27,2,7%
2610,PARK COUNTY RE-2,8114,EDITH TETER ELEMENTARY SCHOOL,SCHOOL TOTAL,0,1,4,14,230,249,19,8%
2610,PARK COUNTY RE-2,8118,SOUTH PARK HIGH SCHOOL,9TH,1,0,0,6,37,44,7,16%
2610,PARK COUNTY RE-2,8118,SOUTH PARK HIGH SCHOOL,10TH,1,2,0,3,24,30,6,20%
2610,PARK COUNTY RE-2,8118,SOUTH PARK HIGH SCHOOL,11TH,2,0,0,3,28,33,5,15%
2610,PARK COUNTY RE-2,8118,SOUTH PARK HIGH SCHOOL,12TH,0,0,1,3,32,36,4,11%
2610,PARK COUNTY RE-2,8118,SOUTH PARK HIGH SCHOOL,SCHOOL TOTAL,4,2,1,15,121,143,22,15%
2610,PARK COUNTY RE-2,,DISTRICT TOTAL,,6,3,7,40,549,605,56,9%
2620,HOLYOKE RE-1J,0000,NOT IN A SCHOOL,PK,0,0,0,22,20,42,22,52%
2620,HOLYOKE RE-1J,0000,NOT IN A SCHOOL,SCHOOL TOTAL,0,0,0,22,20,42,22,52%
2620,HOLYOKE RE-1J,4076,HOLYOKE ELEMENTARY SCHOOL,KINDERGARTEN,0,0,0,22,34,56,22,39%
2620,HOLYOKE RE-1J,4076,HOLYOKE ELEMENTARY SCHOOL,1ST,0,1,1,27,27,56,29,52%
2620,HOLYOKE RE-1J,4076,HOLYOKE ELEMENTARY SCHOOL,2ND,0,1,0,22,27,50,23,46%
2620,HOLYOKE RE-1J,4076,HOLYOKE ELEMENTARY SCHOOL,3RD,0,0,0,13,24,37,13,35%
2620,HOLYOKE RE-1J,4076,HOLYOKE ELEMENTARY SCHOOL,4TH,0,1,0,15,27,43,16,37%
2620,HOLYOKE RE-1J,4076,HOLYOKE ELEMENTARY SCHOOL,5TH,0,0,0,23,32,55,23,42%
2620,HOLYOKE RE-1J,4076,HOLYOKE ELEMENTARY SCHOOL,SCHOOL TOTAL,0,3,1,122,171,297,126,42%
2620,HOLYOKE RE-1J,4079,HOLYOKE JUNIOR HIGH SCHOOL,6TH,0,0,0,19,25,44,19,43%
2620,HOLYOKE RE-1J,4079,HOLYOKE JUNIOR HIGH SCHOOL,7TH,0,0,0,14,22,36,14,39%
2620,HOLYOKE RE-1J,4079,HOLYOKE JUNIOR HIGH SCHOOL,8TH,0,0,1,13,21,35,14,40%
2620,HOLYOKE RE-1J,4079,HOLYOKE JUNIOR HIGH SCHOOL,SCHOOL TOTAL,0,0,1,46,68,115,47,41%
2620,HOLYOKE RE-1J,4080,HOLYOKE SENIOR HIGH SCHOOL,9TH,0,0,0,14,33,47,14,30%
2620,HOLYOKE RE-1J,4080,HOLYOKE SENIOR HIGH SCHOOL,10TH,0,0,0,16,30,46,16,35%
2620,HOLYOKE RE-1J,4080,HOLYOKE SENIOR HIGH SCHOOL,11TH,0,0,0,11,38,49,11,22%
2620,HOLYOKE RE-1J,4080,HOLYOKE SENIOR HIGH SCHOOL,12TH,0,0,0,5,30,35,5,14%
2620,HOLYOKE RE-1J,4080,HOLYOKE SENIOR HIGH SCHOOL,SCHOOL TOTAL,0,0,0,46,131,177,46,26%
2620,HOLYOKE RE-1J,,DISTRICT TOTAL,,0,3,2,236,390,631,241,38%
2630,HAXTUN RE-2J,3846,HAXTUN ELEMENTARY SCHOOL,PK,0,0,0,0,31,31,0,0%
2630,HAXTUN RE-2J,3846,HAXTUN ELEMENTARY SCHOOL,KINDERGARTEN,0,0,0,2,20,22,2,9%
2630,HAXTUN RE-2J,3846,HAXTUN ELEMENTARY SCHOOL,1ST,0,0,0,2,13,15,2,13%
2630,HAXTUN RE-2J,3846,HAXTUN ELEMENTARY SCHOOL,2ND,0,0,0,1,13,14,1,7%
2630,HAXTUN RE-2J,3846,HAXTUN ELEMENTARY SCHOOL,3RD,0,0,0,1,20,21,1,5%
2630,HAXTUN RE-2J,3846,HAXTUN ELEMENTARY SCHOOL,4TH,0,0,0,4,17,21,4,19%
2630,HAXTUN RE-2J,3846,HAXTUN ELEMENTARY SCHOOL,5TH,0,0,1,1,18,20,2,10%
2630,HAXTUN RE-2J,3846,HAXTUN ELEMENTARY SCHOOL,6TH,0,1,1,1,23,26,3,12%
2630,HAXTUN RE-2J,3846,HAXTUN ELEMENTARY SCHOOL,7TH,0,0,0,2,29,31,2,6%
2630,HAXTUN RE-2J,3846,HAXTUN ELEMENTARY SCHOOL,8TH,1,1,2,1,24,29,5,17%
2630,HAXTUN RE-2J,3846,HAXTUN ELEMENTARY SCHOOL,SCHOOL TOTAL,1,2,4,15,208,230,22,10%
2630,HAXTUN RE-2J,3850,HAXTUN HIGH SCHOOL,9TH,0,1,0,2,17,20,3,15%
2630,HAXTUN RE-2J,3850,HAXTUN HIGH SCHOOL,10TH,0,0,0,2,21,23,2,9%
2630,HAXTUN RE-2J,3850,HAXTUN HIGH SCHOOL,11TH,0,0,0,2,21,23,2,9%
2630,HAXTUN RE-2J,3850,HAXTUN HIGH SCHOOL,12TH,0,0,0,0,21,21,0,0%
2630,HAXTUN RE-2J,3850,HAXTUN HIGH SCHOOL,SCHOOL TOTAL,0,1,0,6,80,87,7,8%
2630,HAXTUN RE-2J,,DISTRICT TOTAL,,1,3,4,21,288,317,29,9%
2640,ASPEN 1,0042,ASPEN COMMUNITY CHARTER SCHOOL,KINDERGARTEN,0,0,0,1,13,14,1,7%
2640,ASPEN 1,0042,ASPEN COMMUNITY CHARTER SCHOOL,1ST,0,0,0,1,13,14,1,7%
2640,ASPEN 1,0042,ASPEN COMMUNITY CHARTER SCHOOL,2ND,0,0,0,0,14,14,0,0%
2640,ASPEN 1,0042,ASPEN COMMUNITY CHARTER SCHOOL,3RD,0,0,0,0,13,13,0,0%
2640,ASPEN 1,0042,ASPEN COMMUNITY CHARTER SCHOOL,4TH,0,0,0,1,13,14,1,7%
2640,ASPEN 1,0042,ASPEN COMMUNITY CHARTER SCHOOL,5TH,0,0,0,0,14,14,0,0%
2640,ASPEN 1,0042,ASPEN COMMUNITY CHARTER SCHOOL,6TH,0,1,0,1,12,14,2,14%
2640,ASPEN 1,0042,ASPEN COMMUNITY CHARTER SCHOOL,7TH,0,0,0,0,11,11,0,0%
2640,ASPEN 1,0042,ASPEN COMMUNITY CHARTER SCHOOL,8TH,0,0,0,0,14,14,0,0%
2640,ASPEN 1,0042,ASPEN COMMUNITY CHARTER SCHOOL,SCHOOL TOTAL,0,1,0,4,117,122,5,4%
2640,ASPEN 1,0428,ASPEN ELEMENTARY SCHOOL,KINDERGARTEN,0,2,2,15,89,108,19,18%
2640,ASPEN 1,0428,ASPEN ELEMENTARY SCHOOL,1ST,0,1,0,11,89,101,12,12%
2640,ASPEN 1,0428,ASPEN ELEMENTARY SCHOOL,2ND,0,4,2,21,86,113,27,24%
2640,ASPEN 1,0428,ASPEN ELEMENTARY SCHOOL,3RD,0,1,1,10,99,111,12,11%
2640,ASPEN 1,0428,ASPEN ELEMENTARY SCHOOL,4TH,0,2,0,11,79,92,13,14%
2640,ASPEN 1,0428,ASPEN ELEMENTARY SCHOOL,SCHOOL TOTAL,0,10,5,68,442,525,83,16%
2640,ASPEN 1,0430,ASPEN MIDDLE SCHOOL,5TH,0,5,0,12,88,105,17,16%
2640,ASPEN 1,0430,ASPEN MIDDLE SCHOOL,6TH,0,0,0,21,95,116,21,18%
2640,ASPEN 1,0430,ASPEN MIDDLE SCHOOL,7TH,0,0,0,14,110,124,14,11%
2640,ASPEN 1,0430,ASPEN MIDDLE SCHOOL,8TH,1,4,0,18,104,127,23,18%
2640,ASPEN 1,0430,ASPEN MIDDLE SCHOOL,SCHOOL TOTAL,1,9,0,65,397,472,75,16%
2640,ASPEN 1,0432,ASPEN HIGH SCHOOL,9TH,1,3,0,16,102,122,20,16%
2640,ASPEN 1,0432,ASPEN HIGH SCHOOL,10TH,1,3,3,12,122,141,19,13%
2640,ASPEN 1,0432,ASPEN HIGH SCHOOL,11TH,0,1,1,13,116,131,15,11%
2640,ASPEN 1,0432,ASPEN HIGH SCHOOL,12TH,0,3,0,11,122,136,14,10%
2640,ASPEN 1,0432,ASPEN HIGH SCHOOL,SCHOOL TOTAL,2,10,4,52,462,530,68,13%
2640,ASPEN 1,0447,ASPEN PRE-SCHOOL,PK,0,1,1,19,28,49,21,43%
2640,ASPEN 1,0447,ASPEN PRE-SCHOOL,SCHOOL TOTAL,0,1,1,19,28,49,21,43%
2640,ASPEN 1,,DISTRICT TOTAL,,3,31,10,208,1446,1698,252,15%
2650,GRANADA RE-1,3542,GRANADA ELEMENTARY SCHOOL,PK,0,0,0,16,6,22,16,73%
2650,GRANADA RE-1,3542,GRANADA ELEMENTARY SCHOOL,KINDERGARTEN,0,0,0,6,5,11,6,55%
2650,GRANADA RE-1,3542,GRANADA ELEMENTARY SCHOOL,1ST,0,0,0,7,8,15,7,47%
2650,GRANADA RE-1,3542,GRANADA ELEMENTARY SCHOOL,2ND,0,0,0,5,4,9,5,56%
2650,GRANADA RE-1,3542,GRANADA ELEMENTARY SCHOOL,3RD,0,0,0,15,7,22,15,68%
2650,GRANADA RE-1,3542,GRANADA ELEMENTARY SCHOOL,4TH,0,0,0,9,8,17,9,53%
2650,GRANADA RE-1,3542,GRANADA ELEMENTARY SCHOOL,5TH,0,0,0,13,6,19,13,68%
2650,GRANADA RE-1,3542,GRANADA ELEMENTARY SCHOOL,6TH,0,0,0,6,5,11,6,55%
2650,GRANADA RE-1,3542,GRANADA ELEMENTARY SCHOOL,SCHOOL TOTAL,0,0,0,77,49,126,77,61%
2650,GRANADA RE-1,3546,GRANADA UNDIVIDED HIGH SCHOOL,7TH,0,0,1,17,3,21,18,86%
2650,GRANADA RE-1,3546,GRANADA UNDIVIDED HIGH SCHOOL,8TH,0,0,0,13,5,18,13,72%
2650,GRANADA RE-1,3546,GRANADA UNDIVIDED HIGH SCHOOL,9TH,0,0,1,21,11,33,22,67%
2650,GRANADA RE-1,3546,GRANADA UNDIVIDED HIGH SCHOOL,10TH,0,0,0,9,4,13,9,69%
2650,GRANADA RE-1,3546,GRANADA UNDIVIDED HIGH SCHOOL,11TH,0,0,0,15,2,17,15,88%
2650,GRANADA RE-1,3546,GRANADA UNDIVIDED HIGH SCHOOL,12TH,0,0,0,10,5,15,10,67%
2650,GRANADA RE-1,3546,GRANADA UNDIVIDED HIGH SCHOOL,SCHOOL TOTAL,0,0,2,85,30,117,87,74%
2650,GRANADA RE-1,,DISTRICT TOTAL,,0,0,2,162,79,243,164,67%
2660,LAMAR RE-2,0200,ALTA VISTA CHARTER SCHOOL,KINDERGARTEN,0,0,0,4,9,13,4,31%
2660,LAMAR RE-2,0200,ALTA VISTA CHARTER SCHOOL,1ST,0,0,0,1,18,19,1,5%
2660,LAMAR RE-2,0200,ALTA VISTA CHARTER SCHOOL,2ND,0,1,1,2,13,17,4,24%
2660,LAMAR RE-2,0200,ALTA VISTA CHARTER SCHOOL,3RD,0,0,0,3,11,14,3,21%
2660,LAMAR RE-2,0200,ALTA VISTA CHARTER SCHOOL,4TH,0,1,1,2,15,19,4,21%
2660,LAMAR RE-2,0200,ALTA VISTA CHARTER SCHOOL,5TH,0,0,0,2,14,16,2,13%
2660,LAMAR RE-2,0200,ALTA VISTA CHARTER SCHOOL,6TH,0,0,0,0,13,13,0,0%
2660,LAMAR RE-2,0200,ALTA VISTA CHARTER SCHOOL,SCHOOL TOTAL,0,2,2,14,93,111,18,16%
2660,LAMAR RE-2,4956,LAMAR MIDDLE SCHOOL,7TH,0,1,3,47,57,108,51,47%
2660,LAMAR RE-2,4956,LAMAR MIDDLE SCHOOL,8TH,2,0,0,58,54,114,60,53%
2660,LAMAR RE-2,4956,LAMAR MIDDLE SCHOOL,SCHOOL TOTAL,2,1,3,105,111,222,111,50%
2660,LAMAR RE-2,4960,LAMAR HIGH SCHOOL,9TH,0,2,2,64,55,123,68,55%
2660,LAMAR RE-2,4960,LAMAR HIGH SCHOOL,10TH,1,1,1,66,52,121,69,57%
2660,LAMAR RE-2,4960,LAMAR HIGH SCHOOL,11TH,0,1,1,54,58,114,56,49%
2660,LAMAR RE-2,4960,LAMAR HIGH SCHOOL,12TH,1,0,1,63,55,120,65,54%
2660,LAMAR RE-2,4960,LAMAR HIGH SCHOOL,SCHOOL TOTAL,2,4,5,247,220,478,258,54%
2660,LAMAR RE-2,5190,LINCOLN ELEMENTARY SCHOOL,5TH,1,0,0,61,43,105,62,59%
2660,LAMAR RE-2,5190,LINCOLN ELEMENTARY SCHOOL,6TH,0,1,0,62,42,105,63,60%
2660,LAMAR RE-2,5190,LINCOLN ELEMENTARY SCHOOL,SCHOOL TOTAL,1,1,0,123,85,210,125,60%
2660,LAMAR RE-2,5777,MELVIN HENDRICKSON DEVELOPMENT CENTER,PK,0,0,5,62,50,117,67,57%
2660,LAMAR RE-2,5777,MELVIN HENDRICKSON DEVELOPMENT CENTER,SCHOOL TOTAL,0,0,5,62,50,117,67,57%
2660,LAMAR RE-2,6794,PARKVIEW ELEMENTARY SCHOOL,3RD,2,0,2,69,40,113,73,65%
2660,LAMAR RE-2,6794,PARKVIEW ELEMENTARY SCHOOL,4TH,1,0,0,58,54,113,59,52%
2660,LAMAR RE-2,6794,PARKVIEW ELEMENTARY SCHOOL,SCHOOL TOTAL,3,0,2,127,94,226,132,58%
2660,LAMAR RE-2,9268,WASHINGTON ELEMENTARY SCHOOL,KINDERGARTEN,1,2,3,72,48,126,78,62%
2660,LAMAR RE-2,9268,WASHINGTON ELEMENTARY SCHOOL,1ST,1,1,2,71,36,111,75,68%
2660,LAMAR RE-2,9268,WASHINGTON ELEMENTARY SCHOOL,2ND,1,0,1,66,49,117,68,58%
2660,LAMAR RE-2,9268,WASHINGTON ELEMENTARY SCHOOL,SCHOOL TOTAL,3,3,6,209,133,354,221,62%
2660,LAMAR RE-2,,DISTRICT TOTAL,,11,11,23,887,786,1718,932,54%
2670,HOLLY RE-3,4058,HOLLY HIGH SCHOOL,9TH,0,0,0,6,12,18,6,33%
2670,HOLLY RE-3,4058,HOLLY HIGH SCHOOL,10TH,0,0,0,6,14,20,6,30%
2670,HOLLY RE-3,4058,HOLLY HIGH SCHOOL,11TH,0,0,0,9,11,20,9,45%
2670,HOLLY RE-3,4058,HOLLY HIGH SCHOOL,12TH,0,0,0,5,11,16,5,31%
2670,HOLLY RE-3,4058,HOLLY HIGH SCHOOL,SCHOOL TOTAL,0,0,0,26,48,74,26,35%
2670,HOLLY RE-3,4069,HOLLY JUNIOR HIGH SCHOOL,7TH,1,0,0,11,6,18,12,67%
2670,HOLLY RE-3,4069,HOLLY JUNIOR HIGH SCHOOL,8TH,0,0,0,12,9,21,12,57%
2670,HOLLY RE-3,4069,HOLLY JUNIOR HIGH SCHOOL,SCHOOL TOTAL,1,0,0,23,15,39,24,62%
2670,HOLLY RE-3,7794,SHANNER ELEMENTARY SCHOOL,PK,0,0,0,15,11,26,15,58%
2670,HOLLY RE-3,7794,SHANNER ELEMENTARY SCHOOL,KINDERGARTEN,0,0,0,15,10,25,15,60%
2670,HOLLY RE-3,7794,SHANNER ELEMENTARY SCHOOL,1ST,0,0,0,14,11,25,14,56%
2670,HOLLY RE-3,7794,SHANNER ELEMENTARY SCHOOL,2ND,0,0,0,9,8,17,9,53%
2670,HOLLY RE-3,7794,SHANNER ELEMENTARY SCHOOL,3RD,0,0,0,10,13,23,10,43%
2670,HOLLY RE-3,7794,SHANNER ELEMENTARY SCHOOL,4TH,1,0,0,14,10,25,15,60%
2670,HOLLY RE-3,7794,SHANNER ELEMENTARY SCHOOL,5TH,0,0,0,8,11,19,8,42%
2670,HOLLY RE-3,7794,SHANNER ELEMENTARY SCHOOL,6TH,1,0,0,7,10,18,8,44%
2670,HOLLY RE-3,7794,SHANNER ELEMENTARY SCHOOL,SCHOOL TOTAL,2,0,0,92,84,178,94,53%
2670,HOLLY RE-3,,DISTRICT TOTAL,,3,0,0,141,147,291,144,49%
2680,WILEY RE-13 JT,9604,WILEY ELEMENTARY SCHOOL,PK,0,0,0,6,22,28,6,21%
2680,WILEY RE-13 JT,9604,WILEY ELEMENTARY SCHOOL,KINDERGARTEN,0,0,0,4,6,10,4,40%
2680,WILEY RE-13 JT,9604,WILEY ELEMENTARY SCHOOL,1ST,0,0,0,4,9,13,4,31%
2680,WILEY RE-13 JT,9604,WILEY ELEMENTARY SCHOOL,2ND,1,1,0,2,3,7,4,57%
2680,WILEY RE-13 JT,9604,WILEY ELEMENTARY SCHOOL,3RD,0,0,0,5,15,20,5,25%
2680,WILEY RE-13 JT,9604,WILEY ELEMENTARY SCHOOL,4TH,0,1,0,2,10,13,3,23%
2680,WILEY RE-13 JT,9604,WILEY ELEMENTARY SCHOOL,5TH,0,0,0,2,12,14,2,14%
2680,WILEY RE-13 JT,9604,WILEY ELEMENTARY SCHOOL,6TH,0,1,0,7,16,24,8,33%
2680,WILEY RE-13 JT,9604,WILEY ELEMENTARY SCHOOL,SCHOOL TOTAL,1,3,0,32,93,129,36,28%
2680,WILEY RE-13 JT,9608,WILEY JUNIOR-SENIOR HIGH SCHOOL,7TH,0,0,0,4,20,24,4,17%
2680,WILEY RE-13 JT,9608,WILEY JUNIOR-SENIOR HIGH SCHOOL,8TH,0,0,0,0,11,11,0,0%
2680,WILEY RE-13 JT,9608,WILEY JUNIOR-SENIOR HIGH SCHOOL,9TH,0,0,0,6,21,27,6,22%
2680,WILEY RE-13 JT,9608,WILEY JUNIOR-SENIOR HIGH SCHOOL,10TH,0,0,1,8,9,18,9,50%
2680,WILEY RE-13 JT,9608,WILEY JUNIOR-SENIOR HIGH SCHOOL,11TH,0,0,0,2,13,15,2,13%
2680,WILEY RE-13 JT,9608,WILEY JUNIOR-SENIOR HIGH SCHOOL,12TH,0,0,0,2,10,12,2,17%
2680,WILEY RE-13 JT,9608,WILEY JUNIOR-SENIOR HIGH SCHOOL,SCHOOL TOTAL,0,0,1,22,84,107,23,21%
2680,WILEY RE-13 JT,,DISTRICT TOTAL,,1,3,1,54,177,236,59,25%
2690,PUEBLO CITY 60,0738,BELMONT ELEMENTARY SCHOOL,PK,0,1,1,46,12,60,48,80%
2690,PUEBLO CITY 60,0738,BELMONT ELEMENTARY SCHOOL,HALF DAY K,0,1,3,43,26,73,47,64%
2690,PUEBLO CITY 60,0738,BELMONT ELEMENTARY SCHOOL,1ST,0,1,2,39,29,71,42,59%
2690,PUEBLO CITY 60,0738,BELMONT ELEMENTARY SCHOOL,2ND,0,0,1,41,27,69,42,61%
2690,PUEBLO CITY 60,0738,BELMONT ELEMENTARY SCHOOL,3RD,1,3,1,43,31,79,48,61%
2690,PUEBLO CITY 60,0738,BELMONT ELEMENTARY SCHOOL,4TH,0,1,0,49,27,77,50,65%
2690,PUEBLO CITY 60,0738,BELMONT ELEMENTARY SCHOOL,5TH,0,2,1,43,31,77,46,60%
2690,PUEBLO CITY 60,0738,BELMONT ELEMENTARY SCHOOL,SCHOOL TOTAL,1,9,9,304,183,506,323,64%
2690,PUEBLO CITY 60,0756,BENJAMIN FRANKLIN ELEMENTARY SCHOOL,PK,0,1,0,8,23,32,9,28%
2690,PUEBLO CITY 60,0756,BENJAMIN FRANKLIN ELEMENTARY SCHOOL,HALF DAY K,1,1,0,24,28,54,26,48%
2690,PUEBLO CITY 60,0756,BENJAMIN FRANKLIN ELEMENTARY SCHOOL,1ST,2,0,4,53,12,71,59,83%
2690,PUEBLO CITY 60,0756,BENJAMIN FRANKLIN ELEMENTARY SCHOOL,2ND,1,0,2,39,18,60,42,70%
2690,PUEBLO CITY 60,0756,BENJAMIN FRANKLIN ELEMENTARY SCHOOL,3RD,0,1,1,52,22,76,54,71%
2690,PUEBLO CITY 60,0756,BENJAMIN FRANKLIN ELEMENTARY SCHOOL,4TH,0,4,1,52,14,71,57,80%
2690,PUEBLO CITY 60,0756,BENJAMIN FRANKLIN ELEMENTARY SCHOOL,5TH,0,2,0,47,20,69,49,71%
2690,PUEBLO CITY 60,0756,BENJAMIN FRANKLIN ELEMENTARY SCHOOL,SCHOOL TOTAL,4,9,8,275,137,433,296,68%
2690,PUEBLO CITY 60,0822,BESSEMER ELEMENTARY SCHOOL,PK,0,0,0,23,7,30,23,77%
2690,PUEBLO CITY 60,0822,BESSEMER ELEMENTARY SCHOOL,KINDERGARTEN,0,0,4,37,6,47,41,87%
2690,PUEBLO CITY 60,0822,BESSEMER ELEMENTARY SCHOOL,1ST,0,0,1,33,12,46,34,74%
2690,PUEBLO CITY 60,0822,BESSEMER ELEMENTARY SCHOOL,2ND,1,0,3,49,10,63,53,84%
2690,PUEBLO CITY 60,0822,BESSEMER ELEMENTARY SCHOOL,3RD,1,0,1,47,8,57,49,86%
2690,PUEBLO CITY 60,0822,BESSEMER ELEMENTARY SCHOOL,4TH,0,0,1,39,6,46,40,87%
2690,PUEBLO CITY 60,0822,BESSEMER ELEMENTARY SCHOOL,5TH,2,0,5,37,5,49,44,90%
2690,PUEBLO CITY 60,0822,BESSEMER ELEMENTARY SCHOOL,6TH,0,0,2,24,3,29,26,90%
2690,PUEBLO CITY 60,0822,BESSEMER ELEMENTARY SCHOOL,7TH,1,0,3,17,4,25,21,84%
2690,PUEBLO CITY 60,0822,BESSEMER ELEMENTARY SCHOOL,8TH,0,0,0,24,5,29,24,83%
2690,PUEBLO CITY 60,0822,BESSEMER ELEMENTARY SCHOOL,SCHOOL TOTAL,5,0,20,330,66,421,355,84%
2690,PUEBLO CITY 60,0860,BEULAH HEIGHTS ELEMENTARY SCHOOL,PK,0,1,0,23,7,31,24,77%
2690,PUEBLO CITY 60,0860,BEULAH HEIGHTS ELEMENTARY SCHOOL,KINDERGARTEN,1,0,1,26,18,46,28,61%
2690,PUEBLO CITY 60,0860,BEULAH HEIGHTS ELEMENTARY SCHOOL,1ST,0,1,1,34,14,50,36,72%
2690,PUEBLO CITY 60,0860,BEULAH HEIGHTS ELEMENTARY SCHOOL,2ND,1,1,2,26,12,42,30,71%
2690,PUEBLO CITY 60,0860,BEULAH HEIGHTS ELEMENTARY SCHOOL,3RD,0,0,0,40,16,56,40,71%
2690,PUEBLO CITY 60,0860,BEULAH HEIGHTS ELEMENTARY SCHOOL,4TH,0,0,2,25,11,38,27,71%
2690,PUEBLO CITY 60,0860,BEULAH HEIGHTS ELEMENTARY SCHOOL,5TH,0,0,1,27,13,41,28,68%
2690,PUEBLO CITY 60,0860,BEULAH HEIGHTS ELEMENTARY SCHOOL,SCHOOL TOTAL,2,3,7,201,91,304,213,70%
2690,PUEBLO CITY 60,0954,BRADFORD ELEMENTARY SCHOOL,PK,0,0,0,49,11,60,49,82%
2690,PUEBLO CITY 60,0954,BRADFORD ELEMENTARY SCHOOL,KINDERGARTEN,1,0,1,38,9,49,40,82%
2690,PUEBLO CITY 60,0954,BRADFORD ELEMENTARY SCHOOL,1ST,0,0,0,32,6,38,32,84%
2690,PUEBLO CITY 60,0954,BRADFORD ELEMENTARY SCHOOL,2ND,0,0,1,45,6,52,46,88%
2690,PUEBLO CITY 60,0954,BRADFORD ELEMENTARY SCHOOL,3RD,0,0,1,42,4,47,43,91%
2690,PUEBLO CITY 60,0954,BRADFORD ELEMENTARY SCHOOL,4TH,0,0,1,35,3,39,36,92%
2690,PUEBLO CITY 60,0954,BRADFORD ELEMENTARY SCHOOL,5TH,1,0,0,32,3,36,33,92%
2690,PUEBLO CITY 60,0954,BRADFORD ELEMENTARY SCHOOL,SCHOOL TOTAL,2,0,4,273,42,321,279,87%
2690,PUEBLO CITY 60,1304,CARLILE ELEMENTARY SCHOOL,PK,0,0,1,19,25,45,20,44%
2690,PUEBLO CITY 60,1304,CARLILE ELEMENTARY SCHOOL,KINDERGARTEN,1,0,3,22,17,43,26,60%
2690,PUEBLO CITY 60,1304,CARLILE ELEMENTARY SCHOOL,1ST,0,0,1,21,17,39,22,56%
2690,PUEBLO CITY 60,1304,CARLILE ELEMENTARY SCHOOL,2ND,0,0,1,25,24,50,26,52%
2690,PUEBLO CITY 60,1304,CARLILE ELEMENTARY SCHOOL,3RD,0,0,2,30,12,44,32,73%
2690,PUEBLO CITY 60,1304,CARLILE ELEMENTARY SCHOOL,4TH,0,0,1,23,18,42,24,57%
2690,PUEBLO CITY 60,1304,CARLILE ELEMENTARY SCHOOL,5TH,0,0,3,18,18,39,21,54%
2690,PUEBLO CITY 60,1304,CARLILE ELEMENTARY SCHOOL,SCHOOL TOTAL,1,0,12,158,131,302,171,57%
2690,PUEBLO CITY 60,1402,CENTENNIAL HIGH SCHOOL,9TH,5,2,6,154,159,326,167,51%
2690,PUEBLO CITY 60,1402,CENTENNIAL HIGH SCHOOL,10TH,2,2,7,126,123,260,137,53%
2690,PUEBLO CITY 60,1402,CENTENNIAL HIGH SCHOOL,11TH,2,2,2,102,109,217,108,50%
2690,PUEBLO CITY 60,1402,CENTENNIAL HIGH SCHOOL,12TH,1,7,2,74,92,176,84,48%
2690,PUEBLO CITY 60,1402,CENTENNIAL HIGH SCHOOL,SCHOOL TOTAL,10,13,17,456,483,979,496,51%
2690,PUEBLO CITY 60,1454,CENTRAL HIGH SCHOOL,9TH,12,1,19,196,127,355,228,64%
2690,PUEBLO CITY 60,1454,CENTRAL HIGH SCHOOL,10TH,6,2,11,148,78,245,167,68%
2690,PUEBLO CITY 60,1454,CENTRAL HIGH SCHOOL,11TH,1,1,9,130,78,219,141,64%
2690,PUEBLO CITY 60,1454,CENTRAL HIGH SCHOOL,12TH,4,1,6,98,73,182,109,60%
2690,PUEBLO CITY 60,1454,CENTRAL HIGH SCHOOL,SCHOOL TOTAL,23,5,45,572,356,1001,645,64%
2690,PUEBLO CITY 60,1488,CESAR CHAVEZ ACADEMY,HALF DAY K,0,1,1,60,12,74,62,84%
2690,PUEBLO CITY 60,1488,CESAR CHAVEZ ACADEMY,KINDERGARTEN,1,2,0,23,16,42,26,62%
2690,PUEBLO CITY 60,1488,CESAR CHAVEZ ACADEMY,1ST,2,1,4,83,12,102,90,88%
2690,PUEBLO CITY 60,1488,CESAR CHAVEZ ACADEMY,2ND,1,1,4,95,25,126,101,80%
2690,PUEBLO CITY 60,1488,CESAR CHAVEZ ACADEMY,3RD,1,3,1,102,21,128,107,84%
2690,PUEBLO CITY 60,1488,CESAR CHAVEZ ACADEMY,4TH,1,0,2,103,19,125,106,85%
2690,PUEBLO CITY 60,1488,CESAR CHAVEZ ACADEMY,5TH,0,2,3,94,21,120,99,83%
2690,PUEBLO CITY 60,1488,CESAR CHAVEZ ACADEMY,6TH,0,1,2,114,24,141,117,83%
2690,PUEBLO CITY 60,1488,CESAR CHAVEZ ACADEMY,7TH,1,3,5,94,33,136,103,76%
2690,PUEBLO CITY 60,1488,CESAR CHAVEZ ACADEMY,8TH,2,0,2,111,26,141,115,82%
2690,PUEBLO CITY 60,1488,CESAR CHAVEZ ACADEMY,SCHOOL TOTAL,9,14,24,879,209,1135,926,82%
2690,PUEBLO CITY 60,1504,GOODNIGHT ELEMENTARY SCHOOL,PK,1,2,1,14,14,32,18,56%
2690,PUEBLO CITY 60,1504,GOODNIGHT ELEMENTARY SCHOOL,KINDERGARTEN,2,2,1,23,25,53,28,53%
2690,PUEBLO CITY 60,1504,GOODNIGHT ELEMENTARY SCHOOL,1ST,2,2,5,48,35,92,57,62%
2690,PUEBLO CITY 60,1504,GOODNIGHT ELEMENTARY SCHOOL,2ND,2,1,6,49,40,98,58,59%
2690,PUEBLO CITY 60,1504,GOODNIGHT ELEMENTARY SCHOOL,3RD,0,2,5,51,29,87,58,67%
2690,PUEBLO CITY 60,1504,GOODNIGHT ELEMENTARY SCHOOL,4TH,0,1,4,49,23,77,54,70%
2690,PUEBLO CITY 60,1504,GOODNIGHT ELEMENTARY SCHOOL,5TH,1,1,5,48,27,82,55,67%
2690,PUEBLO CITY 60,1504,GOODNIGHT ELEMENTARY SCHOOL,6TH,0,1,2,11,16,30,14,47%
2690,PUEBLO CITY 60,1504,GOODNIGHT ELEMENTARY SCHOOL,7TH,0,1,2,9,15,27,12,44%
2690,PUEBLO CITY 60,1504,GOODNIGHT ELEMENTARY SCHOOL,8TH,0,0,4,13,13,30,17,57%
2690,PUEBLO CITY 60,1504,GOODNIGHT ELEMENTARY SCHOOL,SCHOOL TOTAL,8,13,35,315,237,608,371,61%
2690,PUEBLO CITY 60,1828,COLUMBIAN ELEMENTARY SCHOOL,PK,2,0,3,51,9,65,56,86%
2690,PUEBLO CITY 60,1828,COLUMBIAN ELEMENTARY SCHOOL,KINDERGARTEN,0,0,1,37,5,43,38,88%
2690,PUEBLO CITY 60,1828,COLUMBIAN ELEMENTARY SCHOOL,1ST,3,0,1,37,7,48,41,85%
2690,PUEBLO CITY 60,1828,COLUMBIAN ELEMENTARY SCHOOL,2ND,2,0,2,37,7,48,41,85%
2690,PUEBLO CITY 60,1828,COLUMBIAN ELEMENTARY SCHOOL,3RD,1,0,0,32,10,43,33,77%
2690,PUEBLO CITY 60,1828,COLUMBIAN ELEMENTARY SCHOOL,4TH,2,0,0,35,7,44,37,84%
2690,PUEBLO CITY 60,1828,COLUMBIAN ELEMENTARY SCHOOL,5TH,0,0,1,34,8,43,35,81%
2690,PUEBLO CITY 60,1828,COLUMBIAN ELEMENTARY SCHOOL,SCHOOL TOTAL,10,0,8,263,53,334,281,84%
2690,PUEBLO CITY 60,1872,COMMUNITY TRANSITION HOUSE,11TH,0,0,0,1,0,1,1,100%
2690,PUEBLO CITY 60,1872,COMMUNITY TRANSITION HOUSE,12TH,1,1,4,44,36,86,50,58%
2690,PUEBLO CITY 60,1872,COMMUNITY TRANSITION HOUSE,SCHOOL TOTAL,1,1,4,45,36,87,51,59%
2690,PUEBLO CITY 60,2096,CORWIN INTERNATIONAL MAGNET SCHOOL,4TH,2,0,0,44,39,85,46,54%
2690,PUEBLO CITY 60,2096,CORWIN INTERNATIONAL MAGNET SCHOOL,5TH,0,1,2,49,56,108,52,48%
2690,PUEBLO CITY 60,2096,CORWIN INTERNATIONAL MAGNET SCHOOL,6TH,2,3,6,82,83,176,93,53%
2690,PUEBLO CITY 60,2096,CORWIN INTERNATIONAL MAGNET SCHOOL,7TH,0,2,1,63,70,136,66,49%
2690,PUEBLO CITY 60,2096,CORWIN INTERNATIONAL MAGNET SCHOOL,8TH,2,0,2,36,50,90,40,44%
2690,PUEBLO CITY 60,2096,CORWIN INTERNATIONAL MAGNET SCHOOL,SCHOOL TOTAL,6,6,11,274,298,595,297,50%
2690,PUEBLO CITY 60,2217,DOLORES HUERTA PREPARATORY HIGH SCHOOL,9TH,0,1,3,97,34,135,101,75%
2690,PUEBLO CITY 60,2217,DOLORES HUERTA PREPARATORY HIGH SCHOOL,10TH,0,2,8,82,33,125,92,74%
2690,PUEBLO CITY 60,2217,DOLORES HUERTA PREPARATORY HIGH SCHOOL,11TH,1,2,2,79,25,109,84,77%
2690,PUEBLO CITY 60,2217,DOLORES HUERTA PREPARATORY HIGH SCHOOL,12TH,0,0,2,47,25,74,49,66%
2690,PUEBLO CITY 60,2217,DOLORES HUERTA PREPARATORY HIGH SCHOOL,SCHOOL TOTAL,1,5,15,305,117,443,326,74%
2690,PUEBLO CITY 60,2394,EAST HIGH SCHOOL,9TH,2,3,4,223,81,313,232,74%
2690,PUEBLO CITY 60,2394,EAST HIGH SCHOOL,10TH,4,2,7,165,71,249,178,71%
2690,PUEBLO CITY 60,2394,EAST HIGH SCHOOL,11TH,1,5,8,111,65,190,125,66%
2690,PUEBLO CITY 60,2394,EAST HIGH SCHOOL,12TH,2,2,4,99,60,167,107,64%
2690,PUEBLO CITY 60,2394,EAST HIGH SCHOOL,SCHOOL TOTAL,9,12,23,598,277,919,642,70%
2690,PUEBLO CITY 60,2438,EVA R BACA ELEMENTARY SCHOOL,PK,0,0,0,4,12,16,4,25%
2690,PUEBLO CITY 60,2438,EVA R BACA ELEMENTARY SCHOOL,KINDERGARTEN,0,0,0,27,13,40,27,68%
2690,PUEBLO CITY 60,2438,EVA R BACA ELEMENTARY SCHOOL,1ST,0,0,1,35,3,39,36,92%
2690,PUEBLO CITY 60,2438,EVA R BACA ELEMENTARY SCHOOL,2ND,0,0,1,28,1,30,29,97%
2690,PUEBLO CITY 60,2438,EVA R BACA ELEMENTARY SCHOOL,3RD,0,0,0,23,4,27,23,85%
2690,PUEBLO CITY 60,2438,EVA R BACA ELEMENTARY SCHOOL,4TH,0,0,1,29,3,33,30,91%
2690,PUEBLO CITY 60,2438,EVA R BACA ELEMENTARY SCHOOL,5TH,0,0,0,24,7,31,24,77%
2690,PUEBLO CITY 60,2438,EVA R BACA ELEMENTARY SCHOOL,SCHOOL TOTAL,0,0,3,170,43,216,173,80%
2690,PUEBLO CITY 60,2620,FOUNTAIN INTERNATIONAL MAGNET SCHOOL,PK,0,0,0,4,28,32,4,13%
2690,PUEBLO CITY 60,2620,FOUNTAIN INTERNATIONAL MAGNET SCHOOL,KINDERGARTEN,0,1,0,26,57,84,27,32%
2690,PUEBLO CITY 60,2620,FOUNTAIN INTERNATIONAL MAGNET SCHOOL,1ST,0,1,4,41,46,92,46,50%
2690,PUEBLO CITY 60,2620,FOUNTAIN INTERNATIONAL MAGNET SCHOOL,2ND,1,1,4,34,34,74,40,54%
2690,PUEBLO CITY 60,2620,FOUNTAIN INTERNATIONAL MAGNET SCHOOL,3RD,0,1,0,43,33,77,44,57%
2690,PUEBLO CITY 60,2620,FOUNTAIN INTERNATIONAL MAGNET SCHOOL,SCHOOL TOTAL,1,4,8,148,198,359,161,45%
2690,PUEBLO CITY 60,3206,FREED MIDDLE SCHOOL,6TH,2,0,2,55,35,94,59,63%
2690,PUEBLO CITY 60,3206,FREED MIDDLE SCHOOL,7TH,1,2,3,58,55,119,64,54%
2690,PUEBLO CITY 60,3206,FREED MIDDLE SCHOOL,8TH,1,1,0,64,60,126,66,52%
2690,PUEBLO CITY 60,3206,FREED MIDDLE SCHOOL,SCHOOL TOTAL,4,3,5,177,150,339,189,56%
2690,PUEBLO CITY 60,3724,HAAFF ELEMENTARY SCHOOL,PK,0,0,0,35,23,58,35,60%
2690,PUEBLO CITY 60,3724,HAAFF ELEMENTARY SCHOOL,KINDERGARTEN,0,1,3,19,19,42,23,55%
2690,PUEBLO CITY 60,3724,HAAFF ELEMENTARY SCHOOL,1ST,0,2,1,24,20,47,27,57%
2690,PUEBLO CITY 60,3724,HAAFF ELEMENTARY SCHOOL,2ND,0,3,1,18,18,40,22,55%
2690,PUEBLO CITY 60,3724,HAAFF ELEMENTARY SCHOOL,3RD,0,0,0,26,22,48,26,54%
2690,PUEBLO CITY 60,3724,HAAFF ELEMENTARY SCHOOL,4TH,0,2,0,22,21,45,24,53%
2690,PUEBLO CITY 60,3724,HAAFF ELEMENTARY SCHOOL,5TH,1,2,3,17,28,51,23,45%
2690,PUEBLO CITY 60,3724,HAAFF ELEMENTARY SCHOOL,SCHOOL TOTAL,1,10,8,161,151,331,180,54%
2690,PUEBLO CITY 60,3924,HERITAGE ELEMENTARY SCHOOL,PK,0,0,1,33,25,59,34,58%
2690,PUEBLO CITY 60,3924,HERITAGE ELEMENTARY SCHOOL,KINDERGARTEN,1,0,0,38,27,66,39,59%
2690,PUEBLO CITY 60,3924,HERITAGE ELEMENTARY SCHOOL,1ST,0,0,0,28,25,53,28,53%
2690,PUEBLO CITY 60,3924,HERITAGE ELEMENTARY SCHOOL,2ND,2,0,3,29,17,51,34,67%
2690,PUEBLO CITY 60,3924,HERITAGE ELEMENTARY SCHOOL,3RD,1,0,2,33,18,54,36,67%
2690,PUEBLO CITY 60,3924,HERITAGE ELEMENTARY SCHOOL,4TH,0,0,1,28,13,42,29,69%
2690,PUEBLO CITY 60,3924,HERITAGE ELEMENTARY SCHOOL,5TH,0,0,0,28,14,42,28,67%
2690,PUEBLO CITY 60,3924,HERITAGE ELEMENTARY SCHOOL,SCHOOL TOTAL,4,0,7,217,139,367,228,62%
2690,PUEBLO CITY 60,3976,HIGHLAND PARK ELEMENTARY SCHOOL,PK,0,0,0,11,40,51,11,22%
2690,PUEBLO CITY 60,3976,HIGHLAND PARK ELEMENTARY SCHOOL,KINDERGARTEN,0,0,1,21,32,54,22,41%
2690,PUEBLO CITY 60,3976,HIGHLAND PARK ELEMENTARY SCHOOL,1ST,0,0,1,44,30,75,45,60%
2690,PUEBLO CITY 60,3976,HIGHLAND PARK ELEMENTARY SCHOOL,2ND,0,2,3,46,24,75,51,68%
2690,PUEBLO CITY 60,3976,HIGHLAND PARK ELEMENTARY SCHOOL,3RD,0,0,2,47,24,73,49,67%
2690,PUEBLO CITY 60,3976,HIGHLAND PARK ELEMENTARY SCHOOL,4TH,1,1,3,48,28,81,53,65%
2690,PUEBLO CITY 60,3976,HIGHLAND PARK ELEMENTARY SCHOOL,5TH,0,0,0,51,33,84,51,61%
2690,PUEBLO CITY 60,3976,HIGHLAND PARK ELEMENTARY SCHOOL,SCHOOL TOTAL,1,3,10,268,211,493,282,57%
2690,PUEBLO CITY 60,4302,IRVING ELEMENTARY SCHOOL,PK,0,0,0,13,19,32,13,41%
2690,PUEBLO CITY 60,4302,IRVING ELEMENTARY SCHOOL,KINDERGARTEN,0,0,0,32,26,58,32,55%
2690,PUEBLO CITY 60,4302,IRVING ELEMENTARY SCHOOL,1ST,1,1,2,38,13,55,42,76%
2690,PUEBLO CITY 60,4302,IRVING ELEMENTARY SCHOOL,2ND,1,0,3,26,8,38,30,79%
2690,PUEBLO CITY 60,4302,IRVING ELEMENTARY SCHOOL,3RD,0,0,3,32,9,44,35,80%
2690,PUEBLO CITY 60,4302,IRVING ELEMENTARY SCHOOL,4TH,0,0,3,42,16,61,45,74%
2690,PUEBLO CITY 60,4302,IRVING ELEMENTARY SCHOOL,5TH,1,0,2,29,14,46,32,70%
2690,PUEBLO CITY 60,4302,IRVING ELEMENTARY SCHOOL,SCHOOL TOTAL,3,1,13,212,105,334,229,69%
2690,PUEBLO CITY 60,4376,JAMES H RISLEY MIDDLE SCHOOL,6TH,0,1,3,94,7,105,98,93%
2690,PUEBLO CITY 60,4376,JAMES H RISLEY MIDDLE SCHOOL,7TH,0,1,2,96,9,108,99,92%
2690,PUEBLO CITY 60,4376,JAMES H RISLEY MIDDLE SCHOOL,8TH,0,0,1,73,8,82,74,90%
2690,PUEBLO CITY 60,4376,JAMES H RISLEY MIDDLE SCHOOL,SCHOOL TOTAL,0,2,6,263,24,295,271,92%
2690,PUEBLO CITY 60,5048,LEMUEL PITTS MIDDLE SCHOOL,6TH,2,0,6,86,44,138,94,68%
2690,PUEBLO CITY 60,5048,LEMUEL PITTS MIDDLE SCHOOL,7TH,0,0,5,106,55,166,111,67%
2690,PUEBLO CITY 60,5048,LEMUEL PITTS MIDDLE SCHOOL,8TH,4,0,9,118,75,206,131,64%
2690,PUEBLO CITY 60,5048,LEMUEL PITTS MIDDLE SCHOOL,SCHOOL TOTAL,6,0,20,310,174,510,336,66%
2690,PUEBLO CITY 60,5916,MINNEQUA ELEMENTARY SCHOOL,PK,0,0,2,36,22,60,38,63%
2690,PUEBLO CITY 60,5916,MINNEQUA ELEMENTARY SCHOOL,KINDERGARTEN,1,0,2,33,13,49,36,73%
2690,PUEBLO CITY 60,5916,MINNEQUA ELEMENTARY SCHOOL,1ST,1,0,3,44,9,57,48,84%
2690,PUEBLO CITY 60,5916,MINNEQUA ELEMENTARY SCHOOL,2ND,1,0,2,37,10,50,40,80%
2690,PUEBLO CITY 60,5916,MINNEQUA ELEMENTARY SCHOOL,3RD,2,0,0,45,11,58,47,81%
2690,PUEBLO CITY 60,5916,MINNEQUA ELEMENTARY SCHOOL,4TH,1,0,2,28,9,40,31,78%
2690,PUEBLO CITY 60,5916,MINNEQUA ELEMENTARY SCHOOL,5TH,0,0,3,27,9,39,30,77%
2690,PUEBLO CITY 60,5916,MINNEQUA ELEMENTARY SCHOOL,SCHOOL TOTAL,6,0,14,250,83,353,270,76%
2690,PUEBLO CITY 60,6132,MORTON ELEMENTARY SCHOOL,PK,2,4,2,94,42,144,102,71%
2690,PUEBLO CITY 60,6132,MORTON ELEMENTARY SCHOOL,KINDERGARTEN,0,1,0,29,24,54,30,56%
2690,PUEBLO CITY 60,6132,MORTON ELEMENTARY SCHOOL,1ST,1,1,1,29,29,61,32,52%
2690,PUEBLO CITY 60,6132,MORTON ELEMENTARY SCHOOL,2ND,0,3,2,27,20,52,32,62%
2690,PUEBLO CITY 60,6132,MORTON ELEMENTARY SCHOOL,3RD,0,1,0,26,32,59,27,46%
2690,PUEBLO CITY 60,6132,MORTON ELEMENTARY SCHOOL,4TH,0,0,1,24,26,51,25,49%
2690,PUEBLO CITY 60,6132,MORTON ELEMENTARY SCHOOL,5TH,0,0,0,31,26,57,31,54%
2690,PUEBLO CITY 60,6132,MORTON ELEMENTARY SCHOOL,SCHOOL TOTAL,3,10,6,260,199,478,279,58%
2690,PUEBLO CITY 60,6504,OLGA A HELLBECK ELEMENTARY SCHOOL,PK,0,0,1,42,19,62,43,69%
2690,PUEBLO CITY 60,6504,OLGA A HELLBECK ELEMENTARY SCHOOL,KINDERGARTEN,0,0,1,33,8,42,34,81%
2690,PUEBLO CITY 60,6504,OLGA A HELLBECK ELEMENTARY SCHOOL,1ST,2,0,1,41,12,56,44,79%
2690,PUEBLO CITY 60,6504,OLGA A HELLBECK ELEMENTARY SCHOOL,2ND,0,0,1,34,7,42,35,83%
2690,PUEBLO CITY 60,6504,OLGA A HELLBECK ELEMENTARY SCHOOL,3RD,1,1,3,33,7,45,38,84%
2690,PUEBLO CITY 60,6504,OLGA A HELLBECK ELEMENTARY SCHOOL,4TH,2,0,1,35,9,47,38,81%
2690,PUEBLO CITY 60,6504,OLGA A HELLBECK ELEMENTARY SCHOOL,5TH,0,0,0,35,8,43,35,81%
2690,PUEBLO CITY 60,6504,OLGA A HELLBECK ELEMENTARY SCHOOL,SCHOOL TOTAL,5,1,8,253,70,337,267,79%
2690,PUEBLO CITY 60,6770,PARK VIEW ELEMENTARY SCHOOL,PK,0,0,1,17,7,25,18,72%
2690,PUEBLO CITY 60,6770,PARK VIEW ELEMENTARY SCHOOL,KINDERGARTEN,1,1,1,53,6,62,56,90%
2690,PUEBLO CITY 60,6770,PARK VIEW ELEMENTARY SCHOOL,1ST,1,1,0,48,9,59,50,85%
2690,PUEBLO CITY 60,6770,PARK VIEW ELEMENTARY SCHOOL,2ND,1,0,0,57,8,66,58,88%
2690,PUEBLO CITY 60,6770,PARK VIEW ELEMENTARY SCHOOL,3RD,0,0,0,48,13,61,48,79%
2690,PUEBLO CITY 60,6770,PARK VIEW ELEMENTARY SCHOOL,4TH,2,2,2,50,15,71,56,79%
2690,PUEBLO CITY 60,6770,PARK VIEW ELEMENTARY SCHOOL,5TH,0,0,1,49,13,63,50,79%
2690,PUEBLO CITY 60,6770,PARK VIEW ELEMENTARY SCHOOL,SCHOOL TOTAL,5,4,5,322,71,407,336,83%
2690,PUEBLO CITY 60,7209,PUEBLO CHARTER SCHOOL FOR THE ARTS & SCIENCES,KINDERGARTEN,0,1,3,26,19,49,30,61%
2690,PUEBLO CITY 60,7209,PUEBLO CHARTER SCHOOL FOR THE ARTS & SCIENCES,1ST,2,0,2,26,14,44,30,68%
2690,PUEBLO CITY 60,7209,PUEBLO CHARTER SCHOOL FOR THE ARTS & SCIENCES,2ND,0,0,2,23,23,48,25,52%
2690,PUEBLO CITY 60,7209,PUEBLO CHARTER SCHOOL FOR THE ARTS & SCIENCES,3RD,1,0,0,26,20,47,27,57%
2690,PUEBLO CITY 60,7209,PUEBLO CHARTER SCHOOL FOR THE ARTS & SCIENCES,4TH,1,0,2,26,15,44,29,66%
2690,PUEBLO CITY 60,7209,PUEBLO CHARTER SCHOOL FOR THE ARTS & SCIENCES,5TH,0,0,2,24,13,39,26,67%
2690,PUEBLO CITY 60,7209,PUEBLO CHARTER SCHOOL FOR THE ARTS & SCIENCES,6TH,0,0,2,19,25,46,21,46%
2690,PUEBLO CITY 60,7209,PUEBLO CHARTER SCHOOL FOR THE ARTS & SCIENCES,7TH,0,0,2,27,13,42,29,69%
2690,PUEBLO CITY 60,7209,PUEBLO CHARTER SCHOOL FOR THE ARTS & SCIENCES,8TH,0,1,1,22,12,36,24,67%
2690,PUEBLO CITY 60,7209,PUEBLO CHARTER SCHOOL FOR THE ARTS & SCIENCES,SCHOOL TOTAL,4,2,16,219,154,395,241,61%
2690,PUEBLO CITY 60,7481,RONCALLI MIDDLE SCHOOL,6TH,1,1,7,129,60,198,138,70%
2690,PUEBLO CITY 60,7481,RONCALLI MIDDLE SCHOOL,7TH,1,1,10,122,61,195,134,69%
2690,PUEBLO CITY 60,7481,RONCALLI MIDDLE SCHOOL,8TH,2,1,7,128,88,226,138,61%
2690,PUEBLO CITY 60,7481,RONCALLI MIDDLE SCHOOL,SCHOOL TOTAL,4,3,24,379,209,619,410,66%
2690,PUEBLO CITY 60,7748,KEATING CONTINUING EDUCATION,7TH,0,0,0,3,1,4,3,75%
2690,PUEBLO CITY 60,7748,KEATING CONTINUING EDUCATION,8TH,0,0,0,4,2,6,4,67%
2690,PUEBLO CITY 60,7748,KEATING CONTINUING EDUCATION,9TH,0,0,1,30,3,34,31,91%
2690,PUEBLO CITY 60,7748,KEATING CONTINUING EDUCATION,10TH,1,0,0,26,15,42,27,64%
2690,PUEBLO CITY 60,7748,KEATING CONTINUING EDUCATION,11TH,0,0,1,36,25,62,37,60%
2690,PUEBLO CITY 60,7748,KEATING CONTINUING EDUCATION,12TH,1,0,2,83,39,125,86,69%
2690,PUEBLO CITY 60,7748,KEATING CONTINUING EDUCATION,SCHOOL TOTAL,2,0,4,182,85,273,188,69%
2690,PUEBLO CITY 60,8030,SOMERLID ELEMENTARY SCHOOL,PK,1,1,0,20,36,58,22,38%
2690,PUEBLO CITY 60,8030,SOMERLID ELEMENTARY SCHOOL,KINDERGARTEN,0,1,4,22,39,66,27,41%
2690,PUEBLO CITY 60,8030,SOMERLID ELEMENTARY SCHOOL,1ST,0,0,0,37,25,62,37,60%
2690,PUEBLO CITY 60,8030,SOMERLID ELEMENTARY SCHOOL,2ND,0,0,4,36,34,74,40,54%
2690,PUEBLO CITY 60,8030,SOMERLID ELEMENTARY SCHOOL,3RD,0,1,1,37,27,66,39,59%
2690,PUEBLO CITY 60,8030,SOMERLID ELEMENTARY SCHOOL,4TH,0,0,2,22,28,52,24,46%
2690,PUEBLO CITY 60,8030,SOMERLID ELEMENTARY SCHOOL,5TH,1,0,1,21,18,41,23,56%
2690,PUEBLO CITY 60,8030,SOMERLID ELEMENTARY SCHOOL,SCHOOL TOTAL,2,3,12,195,207,419,212,51%
2690,PUEBLO CITY 60,8082,SOUTH HIGH SCHOOL,9TH,1,1,21,215,217,455,238,52%
2690,PUEBLO CITY 60,8082,SOUTH HIGH SCHOOL,10TH,3,2,12,167,180,364,184,51%
2690,PUEBLO CITY 60,8082,SOUTH HIGH SCHOOL,11TH,4,0,10,133,159,306,147,48%
2690,PUEBLO CITY 60,8082,SOUTH HIGH SCHOOL,12TH,1,3,9,81,146,240,94,39%
2690,PUEBLO CITY 60,8082,SOUTH HIGH SCHOOL,SCHOOL TOTAL,9,6,52,596,702,1365,663,49%
2690,PUEBLO CITY 60,8116,SOUTH PARK ELEMENTARY SCHOOL,PK,0,1,2,20,7,30,23,77%
2690,PUEBLO CITY 60,8116,SOUTH PARK ELEMENTARY SCHOOL,KINDERGARTEN,1,1,3,44,19,68,49,72%
2690,PUEBLO CITY 60,8116,SOUTH PARK ELEMENTARY SCHOOL,1ST,0,0,1,41,11,53,42,79%
2690,PUEBLO CITY 60,8116,SOUTH PARK ELEMENTARY SCHOOL,2ND,1,1,2,39,12,55,43,78%
2690,PUEBLO CITY 60,8116,SOUTH PARK ELEMENTARY SCHOOL,3RD,0,0,1,39,13,53,40,75%
2690,PUEBLO CITY 60,8116,SOUTH PARK ELEMENTARY SCHOOL,4TH,0,1,0,40,14,55,41,75%
2690,PUEBLO CITY 60,8116,SOUTH PARK ELEMENTARY SCHOOL,5TH,1,0,0,42,17,60,43,72%
2690,PUEBLO CITY 60,8116,SOUTH PARK ELEMENTARY SCHOOL,SCHOOL TOTAL,3,4,9,265,93,374,281,75%
2690,PUEBLO CITY 60,8143,SPANN ELEMENTARY SCHOOL,PK,0,0,1,38,9,48,39,81%
2690,PUEBLO CITY 60,8143,SPANN ELEMENTARY SCHOOL,KINDERGARTEN,0,0,1,31,10,42,32,76%
2690,PUEBLO CITY 60,8143,SPANN ELEMENTARY SCHOOL,1ST,0,0,2,34,5,41,36,88%
2690,PUEBLO CITY 60,8143,SPANN ELEMENTARY SCHOOL,2ND,0,0,3,24,10,37,27,73%
2690,PUEBLO CITY 60,8143,SPANN ELEMENTARY SCHOOL,3RD,0,0,0,38,3,41,38,93%
2690,PUEBLO CITY 60,8143,SPANN ELEMENTARY SCHOOL,4TH,0,0,2,36,7,45,38,84%
2690,PUEBLO CITY 60,8143,SPANN ELEMENTARY SCHOOL,5TH,0,0,2,34,6,42,36,86%
2690,PUEBLO CITY 60,8143,SPANN ELEMENTARY SCHOOL,SCHOOL TOTAL,0,0,11,235,50,296,246,83%
2690,PUEBLO CITY 60,8402,SUNSET PARK ELEMENTARY SCHOOL,PK,0,0,0,39,22,61,39,64%
2690,PUEBLO CITY 60,8402,SUNSET PARK ELEMENTARY SCHOOL,HALF DAY K,0,0,0,0,1,1,0,0%
2690,PUEBLO CITY 60,8402,SUNSET PARK ELEMENTARY SCHOOL,KINDERGARTEN,0,0,1,29,33,63,30,48%
2690,PUEBLO CITY 60,8402,SUNSET PARK ELEMENTARY SCHOOL,1ST,0,0,0,37,37,74,37,50%
2690,PUEBLO CITY 60,8402,SUNSET PARK ELEMENTARY SCHOOL,2ND,0,1,1,38,37,77,40,52%
2690,PUEBLO CITY 60,8402,SUNSET PARK ELEMENTARY SCHOOL,3RD,0,1,1,34,33,69,36,52%
2690,PUEBLO CITY 60,8402,SUNSET PARK ELEMENTARY SCHOOL,4TH,0,0,0,40,36,76,40,53%
2690,PUEBLO CITY 60,8402,SUNSET PARK ELEMENTARY SCHOOL,5TH,0,1,2,27,37,67,30,45%
2690,PUEBLO CITY 60,8402,SUNSET PARK ELEMENTARY SCHOOL,SCHOOL TOTAL,0,3,5,244,236,488,252,52%
2690,PUEBLO CITY 60,9188,W H HEATON MIDDLE SCHOOL,6TH,4,2,5,144,71,226,155,69%
2690,PUEBLO CITY 60,9188,W H HEATON MIDDLE SCHOOL,7TH,2,1,4,130,76,213,137,64%
2690,PUEBLO CITY 60,9188,W H HEATON MIDDLE SCHOOL,8TH,1,2,7,135,84,229,145,63%
2690,PUEBLO CITY 60,9188,W H HEATON MIDDLE SCHOOL,SCHOOL TOTAL,7,5,16,409,231,668,437,65%
2690,PUEBLO CITY 60,9785,YOUTH & FAMILY ACADEMY CHARTER,7TH,0,0,0,10,1,11,10,91%
2690,PUEBLO CITY 60,9785,YOUTH & FAMILY ACADEMY CHARTER,8TH,0,0,1,15,3,19,16,84%
2690,PUEBLO CITY 60,9785,YOUTH & FAMILY ACADEMY CHARTER,9TH,0,0,1,20,10,31,21,68%
2690,PUEBLO CITY 60,9785,YOUTH & FAMILY ACADEMY CHARTER,10TH,0,0,0,33,13,46,33,72%
2690,PUEBLO CITY 60,9785,YOUTH & FAMILY ACADEMY CHARTER,11TH,2,1,2,47,13,65,52,80%
2690,PUEBLO CITY 60,9785,YOUTH & FAMILY ACADEMY CHARTER,12TH,0,0,0,22,6,28,22,79%
2690,PUEBLO CITY 60,9785,YOUTH & FAMILY ACADEMY CHARTER,SCHOOL TOTAL,2,1,4,147,46,200,154,77%
2690,PUEBLO CITY 60,,DISTRICT TOTAL,,164,155,508,11130,6347,18304,11957,65%
2700,PUEBLO COUNTY 70,0025,SKY VIEW MIDDLE SCHOOL,6TH,2,0,5,46,137,190,53,28%
2700,PUEBLO COUNTY 70,0025,SKY VIEW MIDDLE SCHOOL,7TH,1,3,7,27,142,180,38,21%
2700,PUEBLO COUNTY 70,0025,SKY VIEW MIDDLE SCHOOL,8TH,1,1,3,48,149,202,53,26%
2700,PUEBLO COUNTY 70,0025,SKY VIEW MIDDLE SCHOOL,SCHOOL TOTAL,4,4,15,121,428,572,144,25%
2700,PUEBLO COUNTY 70,0026,DESERT SAGE ELEMENTARY SCHOOL,PK,1,1,0,7,15,24,9,38%
2700,PUEBLO COUNTY 70,0026,DESERT SAGE ELEMENTARY SCHOOL,KINDERGARTEN,1,2,1,20,32,56,24,43%
2700,PUEBLO COUNTY 70,0026,DESERT SAGE ELEMENTARY SCHOOL,1ST,1,0,3,19,40,63,23,37%
2700,PUEBLO COUNTY 70,0026,DESERT SAGE ELEMENTARY SCHOOL,2ND,3,0,2,19,50,74,24,32%
2700,PUEBLO COUNTY 70,0026,DESERT SAGE ELEMENTARY SCHOOL,3RD,2,0,1,27,36,66,30,45%
2700,PUEBLO COUNTY 70,0026,DESERT SAGE ELEMENTARY SCHOOL,4TH,2,1,5,31,54,93,39,42%
2700,PUEBLO COUNTY 70,0026,DESERT SAGE ELEMENTARY SCHOOL,5TH,1,1,2,25,41,70,29,41%
2700,PUEBLO COUNTY 70,0026,DESERT SAGE ELEMENTARY SCHOOL,SCHOOL TOTAL,11,5,14,148,268,446,178,40%
2700,PUEBLO COUNTY 70,0472,AVONDALE ELEMENTARY SCHOOL,PK,0,0,0,15,4,19,15,79%
2700,PUEBLO COUNTY 70,0472,AVONDALE ELEMENTARY SCHOOL,KINDERGARTEN,0,0,0,14,14,28,14,50%
2700,PUEBLO COUNTY 70,0472,AVONDALE ELEMENTARY SCHOOL,1ST,0,0,0,26,11,37,26,70%
2700,PUEBLO COUNTY 70,0472,AVONDALE ELEMENTARY SCHOOL,2ND,0,0,0,17,13,30,17,57%
2700,PUEBLO COUNTY 70,0472,AVONDALE ELEMENTARY SCHOOL,3RD,0,0,1,22,6,29,23,79%
2700,PUEBLO COUNTY 70,0472,AVONDALE ELEMENTARY SCHOOL,4TH,0,1,0,20,13,34,21,62%
2700,PUEBLO COUNTY 70,0472,AVONDALE ELEMENTARY SCHOOL,5TH,0,0,0,18,9,27,18,67%
2700,PUEBLO COUNTY 70,0472,AVONDALE ELEMENTARY SCHOOL,SCHOOL TOTAL,0,1,1,132,70,204,134,66%
2700,PUEBLO COUNTY 70,0852,BEULAH ELEMENTARY SCHOOL,KINDERGARTEN,0,0,0,3,13,16,3,19%
2700,PUEBLO COUNTY 70,0852,BEULAH ELEMENTARY SCHOOL,1ST,0,0,0,4,13,17,4,24%
2700,PUEBLO COUNTY 70,0852,BEULAH ELEMENTARY SCHOOL,2ND,0,0,0,0,9,9,0,0%
2700,PUEBLO COUNTY 70,0852,BEULAH ELEMENTARY SCHOOL,3RD,0,0,0,0,21,21,0,0%
2700,PUEBLO COUNTY 70,0852,BEULAH ELEMENTARY SCHOOL,4TH,0,0,0,4,6,10,4,40%
2700,PUEBLO COUNTY 70,0852,BEULAH ELEMENTARY SCHOOL,5TH,0,0,1,0,15,16,1,6%
2700,PUEBLO COUNTY 70,0852,BEULAH ELEMENTARY SCHOOL,SCHOOL TOTAL,0,0,1,11,77,89,12,13%
2700,PUEBLO COUNTY 70,0856,BEULAH MIDDLE SCHOOL,6TH,0,0,1,0,19,20,1,5%
2700,PUEBLO COUNTY 70,0856,BEULAH MIDDLE SCHOOL,7TH,0,0,0,2,12,14,2,14%
2700,PUEBLO COUNTY 70,0856,BEULAH MIDDLE SCHOOL,8TH,0,0,1,2,10,13,3,23%
2700,PUEBLO COUNTY 70,0856,BEULAH MIDDLE SCHOOL,SCHOOL TOTAL,0,0,2,4,41,47,6,13%
2700,PUEBLO COUNTY 70,1377,CEDAR RIDGE ELEMENTARY SCHOOL,PK,0,0,0,5,26,31,5,16%
2700,PUEBLO COUNTY 70,1377,CEDAR RIDGE ELEMENTARY SCHOOL,HALF DAY K,1,1,2,4,43,51,8,16%
2700,PUEBLO COUNTY 70,1377,CEDAR RIDGE ELEMENTARY SCHOOL,1ST,1,3,0,7,54,65,11,17%
2700,PUEBLO COUNTY 70,1377,CEDAR RIDGE ELEMENTARY SCHOOL,2ND,0,0,1,4,59,64,5,8%
2700,PUEBLO COUNTY 70,1377,CEDAR RIDGE ELEMENTARY SCHOOL,3RD,2,1,0,14,55,72,17,24%
2700,PUEBLO COUNTY 70,1377,CEDAR RIDGE ELEMENTARY SCHOOL,4TH,0,1,0,5,46,52,6,12%
2700,PUEBLO COUNTY 70,1377,CEDAR RIDGE ELEMENTARY SCHOOL,5TH,3,3,1,6,57,70,13,19%
2700,PUEBLO COUNTY 70,1377,CEDAR RIDGE ELEMENTARY SCHOOL,SCHOOL TOTAL,7,9,4,45,340,405,65,16%
2700,PUEBLO COUNTY 70,3279,FUTURES ACADEMY,7TH,0,0,0,0,2,2,0,0%
2700,PUEBLO COUNTY 70,3279,FUTURES ACADEMY,8TH,0,0,0,3,4,7,3,43%
2700,PUEBLO COUNTY 70,3279,FUTURES ACADEMY,9TH,0,0,0,5,7,12,5,42%
2700,PUEBLO COUNTY 70,3279,FUTURES ACADEMY,10TH,0,0,0,2,6,8,2,25%
2700,PUEBLO COUNTY 70,3279,FUTURES ACADEMY,11TH,0,0,0,8,14,22,8,36%
2700,PUEBLO COUNTY 70,3279,FUTURES ACADEMY,12TH,0,0,1,17,18,36,18,50%
2700,PUEBLO COUNTY 70,3279,FUTURES ACADEMY,SCHOOL TOTAL,0,0,1,35,51,87,36,41%
2700,PUEBLO COUNTY 70,6354,NORTH MESA ELEMENTARY SCHOOL,PK,0,0,1,12,16,29,13,45%
2700,PUEBLO COUNTY 70,6354,NORTH MESA ELEMENTARY SCHOOL,HALF DAY K,0,0,0,13,29,42,13,31%
2700,PUEBLO COUNTY 70,6354,NORTH MESA ELEMENTARY SCHOOL,1ST,0,1,2,21,31,55,24,44%
2700,PUEBLO COUNTY 70,6354,NORTH MESA ELEMENTARY SCHOOL,2ND,0,0,2,15,28,45,17,38%
2700,PUEBLO COUNTY 70,6354,NORTH MESA ELEMENTARY SCHOOL,3RD,0,0,0,18,39,57,18,32%
2700,PUEBLO COUNTY 70,6354,NORTH MESA ELEMENTARY SCHOOL,4TH,3,0,1,27,33,64,31,48%
2700,PUEBLO COUNTY 70,6354,NORTH MESA ELEMENTARY SCHOOL,5TH,0,0,1,20,40,61,21,34%
2700,PUEBLO COUNTY 70,6354,NORTH MESA ELEMENTARY SCHOOL,SCHOOL TOTAL,3,1,7,126,216,353,137,39%
2700,PUEBLO COUNTY 70,7086,PLEASANT VIEW MIDDLE SCHOOL,6TH,3,0,1,32,59,95,36,38%
2700,PUEBLO COUNTY 70,7086,PLEASANT VIEW MIDDLE SCHOOL,7TH,1,0,2,42,76,121,45,37%
2700,PUEBLO COUNTY 70,7086,PLEASANT VIEW MIDDLE SCHOOL,8TH,0,0,0,46,83,129,46,36%
2700,PUEBLO COUNTY 70,7086,PLEASANT VIEW MIDDLE SCHOOL,SCHOOL TOTAL,4,0,3,120,218,345,127,37%
2700,PUEBLO COUNTY 70,7153,PRAIRIE WINDS ELEMENTARY SCHOOL,PK,0,1,0,8,19,28,9,32%
2700,PUEBLO COUNTY 70,7153,PRAIRIE WINDS ELEMENTARY SCHOOL,HALF DAY K,3,0,1,15,52,71,19,27%
2700,PUEBLO COUNTY 70,7153,PRAIRIE WINDS ELEMENTARY SCHOOL,1ST,0,2,2,24,64,92,28,30%
2700,PUEBLO COUNTY 70,7153,PRAIRIE WINDS ELEMENTARY SCHOOL,2ND,1,4,1,21,71,98,27,28%
2700,PUEBLO COUNTY 70,7153,PRAIRIE WINDS ELEMENTARY SCHOOL,3RD,2,0,0,17,59,78,19,24%
2700,PUEBLO COUNTY 70,7153,PRAIRIE WINDS ELEMENTARY SCHOOL,4TH,2,2,0,17,62,83,21,25%
2700,PUEBLO COUNTY 70,7153,PRAIRIE WINDS ELEMENTARY SCHOOL,5TH,0,0,2,30,72,104,32,31%
2700,PUEBLO COUNTY 70,7153,PRAIRIE WINDS ELEMENTARY SCHOOL,SCHOOL TOTAL,8,9,6,132,399,554,155,28%
2700,PUEBLO COUNTY 70,7208,PUEBLO COUNTY HIGH SCHOOL,9TH,0,2,2,64,131,199,68,34%
2700,PUEBLO COUNTY 70,7208,PUEBLO COUNTY HIGH SCHOOL,10TH,0,0,0,65,152,217,65,30%
2700,PUEBLO COUNTY 70,7208,PUEBLO COUNTY HIGH SCHOOL,11TH,2,0,0,42,138,182,44,24%
2700,PUEBLO COUNTY 70,7208,PUEBLO COUNTY HIGH SCHOOL,12TH,0,0,1,62,126,189,63,33%
2700,PUEBLO COUNTY 70,7208,PUEBLO COUNTY HIGH SCHOOL,SCHOOL TOTAL,2,2,3,233,547,787,240,30%
2700,PUEBLO COUNTY 70,7210,PUEBLO WEST ELEMENTARY SCHOOL,PK,0,0,1,7,16,24,8,33%
2700,PUEBLO COUNTY 70,7210,PUEBLO WEST ELEMENTARY SCHOOL,HALF DAY K,1,0,2,10,23,36,13,36%
2700,PUEBLO COUNTY 70,7210,PUEBLO WEST ELEMENTARY SCHOOL,KINDERGARTEN,0,0,1,8,14,23,9,39%
2700,PUEBLO COUNTY 70,7210,PUEBLO WEST ELEMENTARY SCHOOL,1ST,2,0,1,16,49,68,19,28%
2700,PUEBLO COUNTY 70,7210,PUEBLO WEST ELEMENTARY SCHOOL,2ND,1,0,1,17,41,60,19,32%
2700,PUEBLO COUNTY 70,7210,PUEBLO WEST ELEMENTARY SCHOOL,3RD,1,0,4,20,33,58,25,43%
2700,PUEBLO COUNTY 70,7210,PUEBLO WEST ELEMENTARY SCHOOL,4TH,2,2,3,27,29,63,34,54%
2700,PUEBLO COUNTY 70,7210,PUEBLO WEST ELEMENTARY SCHOOL,5TH,1,1,2,16,39,59,20,34%
2700,PUEBLO COUNTY 70,7210,PUEBLO WEST ELEMENTARY SCHOOL,SCHOOL TOTAL,8,3,15,121,244,391,147,38%
2700,PUEBLO COUNTY 70,7211,PUEBLO TECHNICAL ACADEMY,9TH,0,1,2,5,30,38,8,21%
2700,PUEBLO COUNTY 70,7211,PUEBLO TECHNICAL ACADEMY,10TH,0,0,0,8,18,26,8,31%
2700,PUEBLO COUNTY 70,7211,PUEBLO TECHNICAL ACADEMY,11TH,1,0,0,0,19,20,1,5%
2700,PUEBLO COUNTY 70,7211,PUEBLO TECHNICAL ACADEMY,12TH,0,1,0,5,9,15,6,40%
2700,PUEBLO COUNTY 70,7211,PUEBLO TECHNICAL ACADEMY,SCHOOL TOTAL,1,2,2,18,76,99,23,23%
2700,PUEBLO COUNTY 70,7212,PUEBLO WEST MIDDLE SCHOOL,6TH,1,3,5,57,113,179,66,37%
2700,PUEBLO COUNTY 70,7212,PUEBLO WEST MIDDLE SCHOOL,7TH,4,0,5,60,115,184,69,38%
2700,PUEBLO COUNTY 70,7212,PUEBLO WEST MIDDLE SCHOOL,8TH,3,0,5,48,115,171,56,33%
2700,PUEBLO COUNTY 70,7212,PUEBLO WEST MIDDLE SCHOOL,SCHOOL TOTAL,8,3,15,165,343,534,191,36%
2700,PUEBLO COUNTY 70,7214,PUEBLO WEST HIGH SCHOOL,9TH,3,6,10,97,243,359,116,32%
2700,PUEBLO COUNTY 70,7214,PUEBLO WEST HIGH SCHOOL,10TH,5,7,3,79,234,328,94,29%
2700,PUEBLO COUNTY 70,7214,PUEBLO WEST HIGH SCHOOL,11TH,2,3,10,70,227,312,85,27%
2700,PUEBLO COUNTY 70,7214,PUEBLO WEST HIGH SCHOOL,12TH,3,2,2,50,212,269,57,21%
2700,PUEBLO COUNTY 70,7214,PUEBLO WEST HIGH SCHOOL,SCHOOL TOTAL,13,18,25,296,916,1268,352,28%
2700,PUEBLO COUNTY 70,7530,RYE ELEMENTARY SCHOOL,PK,0,0,0,2,28,30,2,7%
2700,PUEBLO COUNTY 70,7530,RYE ELEMENTARY SCHOOL,KINDERGARTEN,0,0,0,3,42,45,3,7%
2700,PUEBLO COUNTY 70,7530,RYE ELEMENTARY SCHOOL,1ST,1,1,1,7,36,46,10,22%
2700,PUEBLO COUNTY 70,7530,RYE ELEMENTARY SCHOOL,2ND,0,1,0,2,51,54,3,6%
2700,PUEBLO COUNTY 70,7530,RYE ELEMENTARY SCHOOL,3RD,0,0,0,7,41,48,7,15%
2700,PUEBLO COUNTY 70,7530,RYE ELEMENTARY SCHOOL,4TH,1,1,0,2,43,47,4,9%
2700,PUEBLO COUNTY 70,7530,RYE ELEMENTARY SCHOOL,5TH,4,0,0,4,47,55,8,15%
2700,PUEBLO COUNTY 70,7530,RYE ELEMENTARY SCHOOL,SCHOOL TOTAL,6,3,1,27,288,325,37,11%
2700,PUEBLO COUNTY 70,7532,CRAVER MIDDLE SCHOOL,6TH,3,0,0,6,43,52,9,17%
2700,PUEBLO COUNTY 70,7532,CRAVER MIDDLE SCHOOL,7TH,0,0,0,3,46,49,3,6%
2700,PUEBLO COUNTY 70,7532,CRAVER MIDDLE SCHOOL,8TH,1,0,0,3,54,58,4,7%
2700,PUEBLO COUNTY 70,7532,CRAVER MIDDLE SCHOOL,SCHOOL TOTAL,4,0,0,12,143,159,16,10%
2700,PUEBLO COUNTY 70,7534,RYE HIGH SCHOOL,9TH,0,1,0,7,63,71,8,11%
2700,PUEBLO COUNTY 70,7534,RYE HIGH SCHOOL,10TH,1,0,0,3,46,50,4,8%
2700,PUEBLO COUNTY 70,7534,RYE HIGH SCHOOL,11TH,1,0,1,6,51,59,8,14%
2700,PUEBLO COUNTY 70,7534,RYE HIGH SCHOOL,12TH,0,1,0,11,58,70,12,17%
2700,PUEBLO COUNTY 70,7534,RYE HIGH SCHOOL,SCHOOL TOTAL,2,2,1,27,218,250,32,13%
2700,PUEBLO COUNTY 70,7879,SOUTHERN COLORADO EARLY COLLEGE,9TH,1,0,0,10,34,45,11,24%
2700,PUEBLO COUNTY 70,7879,SOUTHERN COLORADO EARLY COLLEGE,10TH,0,0,1,8,35,44,9,20%
2700,PUEBLO COUNTY 70,7879,SOUTHERN COLORADO EARLY COLLEGE,11TH,0,0,1,6,31,38,7,18%
2700,PUEBLO COUNTY 70,7879,SOUTHERN COLORADO EARLY COLLEGE,12TH,0,0,1,10,33,44,11,25%
2700,PUEBLO COUNTY 70,7879,SOUTHERN COLORADO EARLY COLLEGE,SCHOOL TOTAL,1,0,3,34,133,171,38,22%
2700,PUEBLO COUNTY 70,7886,SIERRA VISTA ELEMENTARY SCHOOL,PK,0,3,1,7,16,27,11,41%
2700,PUEBLO COUNTY 70,7886,SIERRA VISTA ELEMENTARY SCHOOL,HALF DAY K,0,1,1,19,43,64,21,33%
2700,PUEBLO COUNTY 70,7886,SIERRA VISTA ELEMENTARY SCHOOL,1ST,0,2,3,27,70,102,32,31%
2700,PUEBLO COUNTY 70,7886,SIERRA VISTA ELEMENTARY SCHOOL,2ND,0,4,1,13,46,64,18,28%
2700,PUEBLO COUNTY 70,7886,SIERRA VISTA ELEMENTARY SCHOOL,3RD,0,2,3,25,66,96,30,31%
2700,PUEBLO COUNTY 70,7886,SIERRA VISTA ELEMENTARY SCHOOL,4TH,0,2,4,23,63,92,29,32%
2700,PUEBLO COUNTY 70,7886,SIERRA VISTA ELEMENTARY SCHOOL,5TH,0,1,4,25,66,96,30,31%
2700,PUEBLO COUNTY 70,7886,SIERRA VISTA ELEMENTARY SCHOOL,SCHOOL TOTAL,0,15,17,139,370,541,171,32%
2700,PUEBLO COUNTY 70,8110,SOUTH MESA ELEMENTARY SCHOOL,PK,0,0,0,9,20,29,9,31%
2700,PUEBLO COUNTY 70,8110,SOUTH MESA ELEMENTARY SCHOOL,HALF DAY K,1,2,0,20,20,43,23,53%
2700,PUEBLO COUNTY 70,8110,SOUTH MESA ELEMENTARY SCHOOL,1ST,0,1,0,20,33,54,21,39%
2700,PUEBLO COUNTY 70,8110,SOUTH MESA ELEMENTARY SCHOOL,2ND,1,0,1,21,28,51,23,45%
2700,PUEBLO COUNTY 70,8110,SOUTH MESA ELEMENTARY SCHOOL,3RD,1,2,0,20,27,50,23,46%
2700,PUEBLO COUNTY 70,8110,SOUTH MESA ELEMENTARY SCHOOL,4TH,0,0,0,23,31,54,23,43%
2700,PUEBLO COUNTY 70,8110,SOUTH MESA ELEMENTARY SCHOOL,5TH,1,0,0,16,24,41,17,41%
2700,PUEBLO COUNTY 70,8110,SOUTH MESA ELEMENTARY SCHOOL,SCHOOL TOTAL,4,5,1,129,183,322,139,43%
2700,PUEBLO COUNTY 70,8420,SWALLOWS CHARTER ACADEMY,HALF DAY K,0,0,1,7,14,22,8,36%
2700,PUEBLO COUNTY 70,8420,SWALLOWS CHARTER ACADEMY,1ST,0,1,0,3,18,22,4,18%
2700,PUEBLO COUNTY 70,8420,SWALLOWS CHARTER ACADEMY,2ND,0,0,1,4,17,22,5,23%
2700,PUEBLO COUNTY 70,8420,SWALLOWS CHARTER ACADEMY,3RD,0,0,0,4,18,22,4,18%
2700,PUEBLO COUNTY 70,8420,SWALLOWS CHARTER ACADEMY,4TH,0,1,0,9,12,22,10,45%
2700,PUEBLO COUNTY 70,8420,SWALLOWS CHARTER ACADEMY,5TH,0,0,0,8,14,22,8,36%
2700,PUEBLO COUNTY 70,8420,SWALLOWS CHARTER ACADEMY,6TH,1,1,1,11,30,44,14,32%
2700,PUEBLO COUNTY 70,8420,SWALLOWS CHARTER ACADEMY,7TH,0,0,1,8,35,44,9,20%
2700,PUEBLO COUNTY 70,8420,SWALLOWS CHARTER ACADEMY,8TH,0,0,2,9,33,44,11,25%
2700,PUEBLO COUNTY 70,8420,SWALLOWS CHARTER ACADEMY,SCHOOL TOTAL,1,3,6,63,191,264,73,28%
2700,PUEBLO COUNTY 70,8810,THE CONNECT CHARTER SCHOOL,6TH,0,2,2,30,70,104,34,33%
2700,PUEBLO COUNTY 70,8810,THE CONNECT CHARTER SCHOOL,7TH,0,4,0,17,51,72,21,29%
2700,PUEBLO COUNTY 70,8810,THE CONNECT CHARTER SCHOOL,8TH,0,3,1,11,49,64,15,23%
2700,PUEBLO COUNTY 70,8810,THE CONNECT CHARTER SCHOOL,SCHOOL TOTAL,0,9,3,58,170,240,70,29%
2700,PUEBLO COUNTY 70,9130,VINELAND ELEMENTARY SCHOOL,PK,0,0,0,8,13,21,8,38%
2700,PUEBLO COUNTY 70,9130,VINELAND ELEMENTARY SCHOOL,KINDERGARTEN,0,0,1,12,37,50,13,26%
2700,PUEBLO COUNTY 70,9130,VINELAND ELEMENTARY SCHOOL,1ST,0,0,1,8,26,35,9,26%
2700,PUEBLO COUNTY 70,9130,VINELAND ELEMENTARY SCHOOL,2ND,0,0,0,12,30,42,12,29%
2700,PUEBLO COUNTY 70,9130,VINELAND ELEMENTARY SCHOOL,3RD,0,0,0,3,28,31,3,10%
2700,PUEBLO COUNTY 70,9130,VINELAND ELEMENTARY SCHOOL,4TH,0,0,2,11,20,33,13,39%
2700,PUEBLO COUNTY 70,9130,VINELAND ELEMENTARY SCHOOL,5TH,0,0,0,7,26,33,7,21%
2700,PUEBLO COUNTY 70,9130,VINELAND ELEMENTARY SCHOOL,SCHOOL TOTAL,0,0,4,61,180,245,65,27%
2700,PUEBLO COUNTY 70,9134,VINELAND MIDDLE SCHOOL,6TH,0,0,0,41,49,90,41,46%
2700,PUEBLO COUNTY 70,9134,VINELAND MIDDLE SCHOOL,7TH,1,0,0,26,48,75,27,36%
2700,PUEBLO COUNTY 70,9134,VINELAND MIDDLE SCHOOL,8TH,0,2,1,20,43,66,23,35%
2700,PUEBLO COUNTY 70,9134,VINELAND MIDDLE SCHOOL,SCHOOL TOTAL,1,2,1,87,140,231,91,39%
2700,PUEBLO COUNTY 70,,DISTRICT TOTAL,,88,96,151,2344,6250,8929,2679,30%
2710,MEEKER RE1,5750,MEEKER ELEMENTARY SCHOOL,PK,1,1,0,13,38,53,15,28%
2710,MEEKER RE1,5750,MEEKER ELEMENTARY SCHOOL,HALF DAY K,0,0,0,6,48,54,6,11%
2710,MEEKER RE1,5750,MEEKER ELEMENTARY SCHOOL,1ST,0,0,0,8,38,46,8,17%
2710,MEEKER RE1,5750,MEEKER ELEMENTARY SCHOOL,2ND,0,0,0,6,42,48,6,13%
2710,MEEKER RE1,5750,MEEKER ELEMENTARY SCHOOL,3RD,0,0,0,11,45,56,11,20%
2710,MEEKER RE1,5750,MEEKER ELEMENTARY SCHOOL,4TH,0,0,0,11,48,59,11,19%
2710,MEEKER RE1,5750,MEEKER ELEMENTARY SCHOOL,5TH,0,2,0,8,40,50,10,20%
2710,MEEKER RE1,5750,MEEKER ELEMENTARY SCHOOL,SCHOOL TOTAL,1,3,0,63,299,366,67,18%
2710,MEEKER RE1,5754,BARONE MIDDLE SCHOOL,6TH,1,0,0,8,41,50,9,18%
2710,MEEKER RE1,5754,BARONE MIDDLE SCHOOL,7TH,0,0,0,9,35,44,9,20%
2710,MEEKER RE1,5754,BARONE MIDDLE SCHOOL,8TH,2,2,0,10,47,61,14,23%
2710,MEEKER RE1,5754,BARONE MIDDLE SCHOOL,SCHOOL TOTAL,3,2,0,27,123,155,32,21%
2710,MEEKER RE1,5762,MEEKER HIGH SCHOOL,9TH,1,0,1,6,49,57,8,14%
2710,MEEKER RE1,5762,MEEKER HIGH SCHOOL,10TH,1,1,0,9,29,40,11,28%
2710,MEEKER RE1,5762,MEEKER HIGH SCHOOL,11TH,1,0,1,6,32,40,8,20%
2710,MEEKER RE1,5762,MEEKER HIGH SCHOOL,12TH,0,1,0,8,40,49,9,18%
2710,MEEKER RE1,5762,MEEKER HIGH SCHOOL,SCHOOL TOTAL,3,2,2,29,150,186,36,19%
2710,MEEKER RE1,,DISTRICT TOTAL,,7,7,2,119,572,707,135,19%
2720,RANGELY RE-4,7268,PARKVIEW ELEMENTARY SCHOOL,PK,0,0,0,9,35,44,9,20%
2720,RANGELY RE-4,7268,PARKVIEW ELEMENTARY SCHOOL,HALF DAY K,3,1,0,5,30,39,9,23%
2720,RANGELY RE-4,7268,PARKVIEW ELEMENTARY SCHOOL,1ST,0,0,0,5,37,42,5,12%
2720,RANGELY RE-4,7268,PARKVIEW ELEMENTARY SCHOOL,2ND,0,0,0,5,27,32,5,16%
2720,RANGELY RE-4,7268,PARKVIEW ELEMENTARY SCHOOL,3RD,0,0,1,5,36,42,6,14%
2720,RANGELY RE-4,7268,PARKVIEW ELEMENTARY SCHOOL,4TH,1,0,0,3,29,33,4,12%
2720,RANGELY RE-4,7268,PARKVIEW ELEMENTARY SCHOOL,5TH,0,1,0,4,31,36,5,14%
2720,RANGELY RE-4,7268,PARKVIEW ELEMENTARY SCHOOL,SCHOOL TOTAL,4,2,1,36,225,268,43,16%
2720,RANGELY RE-4,7272,RANGELY MIDDLE SCHOOL,6TH,0,1,0,2,27,30,3,10%
2720,RANGELY RE-4,7272,RANGELY MIDDLE SCHOOL,7TH,0,0,0,3,26,29,3,10%
2720,RANGELY RE-4,7272,RANGELY MIDDLE SCHOOL,8TH,0,1,1,0,34,36,2,6%
2720,RANGELY RE-4,7272,RANGELY MIDDLE SCHOOL,SCHOOL TOTAL,0,2,1,5,87,95,8,8%
2720,RANGELY RE-4,7276,RANGELY HIGH SCHOOL,9TH,0,1,0,6,28,35,7,20%
2720,RANGELY RE-4,7276,RANGELY HIGH SCHOOL,10TH,0,0,1,2,24,27,3,11%
2720,RANGELY RE-4,7276,RANGELY HIGH SCHOOL,11TH,3,0,0,4,40,47,7,15%
2720,RANGELY RE-4,7276,RANGELY HIGH SCHOOL,12TH,1,0,0,4,28,33,5,15%
2720,RANGELY RE-4,7276,RANGELY HIGH SCHOOL,SCHOOL TOTAL,4,1,1,16,120,142,22,15%
2720,RANGELY RE-4,,DISTRICT TOTAL,,8,5,3,57,432,505,73,14%
2730,DEL NORTE C-7,2148,DEL NORTE MIDDLE SCHOOL,6TH,0,0,0,27,23,50,27,54%
2730,DEL NORTE C-7,2148,DEL NORTE MIDDLE SCHOOL,7TH,1,0,1,26,22,50,28,56%
2730,DEL NORTE C-7,2148,DEL NORTE MIDDLE SCHOOL,8TH,1,0,0,22,21,44,23,52%
2730,DEL NORTE C-7,2148,DEL NORTE MIDDLE SCHOOL,SCHOOL TOTAL,2,0,1,75,66,144,78,54%
2730,DEL NORTE C-7,2150,DEL NORTE HIGH SCHOOL,9TH,0,0,0,24,23,47,24,51%
2730,DEL NORTE C-7,2150,DEL NORTE HIGH SCHOOL,10TH,0,0,0,23,28,51,23,45%
2730,DEL NORTE C-7,2150,DEL NORTE HIGH SCHOOL,11TH,0,0,0,18,18,36,18,50%
2730,DEL NORTE C-7,2150,DEL NORTE HIGH SCHOOL,12TH,1,2,0,21,21,45,24,53%
2730,DEL NORTE C-7,2150,DEL NORTE HIGH SCHOOL,SCHOOL TOTAL,1,2,0,86,90,179,89,50%
2730,DEL NORTE C-7,5840,MESA ELEMENTARY SCHOOL,KINDERGARTEN,0,0,0,21,19,40,21,53%
2730,DEL NORTE C-7,5840,MESA ELEMENTARY SCHOOL,1ST,0,0,0,20,19,39,20,51%
2730,DEL NORTE C-7,5840,MESA ELEMENTARY SCHOOL,SCHOOL TOTAL,0,0,0,41,38,79,41,52%
2730,DEL NORTE C-7,8960,UNDERWOOD ELEMENTARY SCHOOL,2ND,0,0,0,24,21,45,24,53%
2730,DEL NORTE C-7,8960,UNDERWOOD ELEMENTARY SCHOOL,3RD,2,0,1,25,29,57,28,49%
2730,DEL NORTE C-7,8960,UNDERWOOD ELEMENTARY SCHOOL,4TH,1,0,0,20,22,43,21,49%
2730,DEL NORTE C-7,8960,UNDERWOOD ELEMENTARY SCHOOL,5TH,0,0,0,31,19,50,31,62%
2730,DEL NORTE C-7,8960,UNDERWOOD ELEMENTARY SCHOOL,SCHOOL TOTAL,3,0,1,100,91,195,104,53%
2730,DEL NORTE C-7,,DISTRICT TOTAL,,6,2,2,302,285,597,312,52%
2740,MONTE VISTA C-8,5579,MARSH ELEMENTARY SCHOOL,PK,2,0,0,29,14,45,31,69%
2740,MONTE VISTA C-8,5579,MARSH ELEMENTARY SCHOOL,KINDERGARTEN,4,1,1,57,31,94,63,67%
2740,MONTE VISTA C-8,5579,MARSH ELEMENTARY SCHOOL,1ST,5,1,1,61,25,93,68,73%
2740,MONTE VISTA C-8,5579,MARSH ELEMENTARY SCHOOL,SCHOOL TOTAL,11,2,2,147,70,232,162,70%
2740,MONTE VISTA C-8,6030,BYRON SYRING DELTA CENTER,10TH,1,0,1,11,5,18,13,72%
2740,MONTE VISTA C-8,6030,BYRON SYRING DELTA CENTER,11TH,1,0,1,16,3,21,18,86%
2740,MONTE VISTA C-8,6030,BYRON SYRING DELTA CENTER,12TH,1,0,0,23,6,30,24,80%
2740,MONTE VISTA C-8,6030,BYRON SYRING DELTA CENTER,SCHOOL TOTAL,3,0,2,50,14,69,55,80%
2740,MONTE VISTA C-8,6036,BILL METZ ELEMENTARY SCHOOL,2ND,0,1,1,54,22,78,56,72%
2740,MONTE VISTA C-8,6036,BILL METZ ELEMENTARY SCHOOL,3RD,3,0,2,59,24,88,64,73%
2740,MONTE VISTA C-8,6036,BILL METZ ELEMENTARY SCHOOL,4TH,3,0,0,58,21,82,61,74%
2740,MONTE VISTA C-8,6036,BILL METZ ELEMENTARY SCHOOL,5TH,1,0,0,65,16,82,66,80%
2740,MONTE VISTA C-8,6036,BILL METZ ELEMENTARY SCHOOL,SCHOOL TOTAL,7,1,3,236,83,330,247,75%
2740,MONTE VISTA C-8,6044,MONTE VISTA MIDDLE SCHOOL,6TH,2,0,1,52,11,66,55,83%
2740,MONTE VISTA C-8,6044,MONTE VISTA MIDDLE SCHOOL,7TH,2,0,2,32,32,68,36,53%
2740,MONTE VISTA C-8,6044,MONTE VISTA MIDDLE SCHOOL,8TH,2,1,2,48,14,67,53,79%
2740,MONTE VISTA C-8,6044,MONTE VISTA MIDDLE SCHOOL,SCHOOL TOTAL,6,1,5,132,57,201,144,72%
2740,MONTE VISTA C-8,6046,MONTE VISTA SENIOR HIGH SCHOOL,9TH,2,0,0,42,20,64,44,69%
2740,MONTE VISTA C-8,6046,MONTE VISTA SENIOR HIGH SCHOOL,10TH,2,1,1,40,28,72,44,61%
2740,MONTE VISTA C-8,6046,MONTE VISTA SENIOR HIGH SCHOOL,11TH,2,1,1,41,27,72,45,63%
2740,MONTE VISTA C-8,6046,MONTE VISTA SENIOR HIGH SCHOOL,12TH,0,1,0,27,32,60,28,47%
2740,MONTE VISTA C-8,6046,MONTE VISTA SENIOR HIGH SCHOOL,SCHOOL TOTAL,6,3,2,150,107,268,161,60%
2740,MONTE VISTA C-8,6520,MONTE VISTA ON-LINE ACADEMY,6TH,0,0,0,2,0,2,2,100%
2740,MONTE VISTA C-8,6520,MONTE VISTA ON-LINE ACADEMY,7TH,0,0,0,2,5,7,2,29%
2740,MONTE VISTA C-8,6520,MONTE VISTA ON-LINE ACADEMY,8TH,0,0,0,4,5,9,4,44%
2740,MONTE VISTA C-8,6520,MONTE VISTA ON-LINE ACADEMY,9TH,0,0,0,5,10,15,5,33%
2740,MONTE VISTA C-8,6520,MONTE VISTA ON-LINE ACADEMY,10TH,0,0,0,7,11,18,7,39%
2740,MONTE VISTA C-8,6520,MONTE VISTA ON-LINE ACADEMY,11TH,1,0,0,6,12,19,7,37%
2740,MONTE VISTA C-8,6520,MONTE VISTA ON-LINE ACADEMY,12TH,0,0,0,2,9,11,2,18%
2740,MONTE VISTA C-8,6520,MONTE VISTA ON-LINE ACADEMY,SCHOOL TOTAL,1,0,0,28,52,81,29,36%
2740,MONTE VISTA C-8,,DISTRICT TOTAL,,34,7,14,743,383,1181,798,68%
2750,SARGENT RE-33J,7660,SARGENT ELEMENTARY SCHOOL,KINDERGARTEN,0,0,0,7,33,40,7,18%
2750,SARGENT RE-33J,7660,SARGENT ELEMENTARY SCHOOL,1ST,0,0,0,12,30,42,12,29%
2750,SARGENT RE-33J,7660,SARGENT ELEMENTARY SCHOOL,2ND,0,0,1,11,28,40,12,30%
2750,SARGENT RE-33J,7660,SARGENT ELEMENTARY SCHOOL,3RD,2,1,0,12,25,40,15,38%
2750,SARGENT RE-33J,7660,SARGENT ELEMENTARY SCHOOL,4TH,0,0,0,8,33,41,8,20%
2750,SARGENT RE-33J,7660,SARGENT ELEMENTARY SCHOOL,5TH,0,1,0,9,31,41,10,24%
2750,SARGENT RE-33J,7660,SARGENT ELEMENTARY SCHOOL,6TH,0,0,0,9,25,34,9,26%
2750,SARGENT RE-33J,7660,SARGENT ELEMENTARY SCHOOL,SCHOOL TOTAL,2,2,1,68,205,278,73,26%
2750,SARGENT RE-33J,7664,SARGENT SENIOR HIGH SCHOOL,9TH,0,1,0,7,24,32,8,25%
2750,SARGENT RE-33J,7664,SARGENT SENIOR HIGH SCHOOL,10TH,0,0,0,10,22,32,10,31%
2750,SARGENT RE-33J,7664,SARGENT SENIOR HIGH SCHOOL,11TH,1,0,0,5,33,39,6,15%
2750,SARGENT RE-33J,7664,SARGENT SENIOR HIGH SCHOOL,12TH,0,0,0,6,24,30,6,20%
2750,SARGENT RE-33J,7664,SARGENT SENIOR HIGH SCHOOL,SCHOOL TOTAL,1,1,0,28,103,133,30,23%
2750,SARGENT RE-33J,7668,SARGENT JUNIOR HIGH SCHOOL,7TH,2,0,1,10,26,39,13,33%
2750,SARGENT RE-33J,7668,SARGENT JUNIOR HIGH SCHOOL,8TH,1,0,0,7,26,34,8,24%
2750,SARGENT RE-33J,7668,SARGENT JUNIOR HIGH SCHOOL,SCHOOL TOTAL,3,0,1,17,52,73,21,29%
2750,SARGENT RE-33J,,DISTRICT TOTAL,,6,3,2,113,360,484,124,26%
2760,HAYDEN RE-1,2522,HAYDEN VALLEY ELEMENTARY SCHOOL,PK,0,0,0,1,27,28,1,4%
2760,HAYDEN RE-1,2522,HAYDEN VALLEY ELEMENTARY SCHOOL,KINDERGARTEN,0,0,0,3,27,30,3,10%
2760,HAYDEN RE-1,2522,HAYDEN VALLEY ELEMENTARY SCHOOL,1ST,0,0,0,4,24,28,4,14%
2760,HAYDEN RE-1,2522,HAYDEN VALLEY ELEMENTARY SCHOOL,2ND,0,0,0,6,23,29,6,21%
2760,HAYDEN RE-1,2522,HAYDEN VALLEY ELEMENTARY SCHOOL,3RD,0,1,0,6,19,26,7,27%
2760,HAYDEN RE-1,2522,HAYDEN VALLEY ELEMENTARY SCHOOL,4TH,0,0,0,7,23,30,7,23%
2760,HAYDEN RE-1,2522,HAYDEN VALLEY ELEMENTARY SCHOOL,5TH,1,0,0,0,25,26,1,4%
2760,HAYDEN RE-1,2522,HAYDEN VALLEY ELEMENTARY SCHOOL,SCHOOL TOTAL,1,1,0,27,168,197,29,15%
2760,HAYDEN RE-1,3860,HAYDEN MIDDLE SCHOOL,6TH,0,0,1,3,26,30,4,13%
2760,HAYDEN RE-1,3860,HAYDEN MIDDLE SCHOOL,7TH,0,1,2,4,26,33,7,21%
2760,HAYDEN RE-1,3860,HAYDEN MIDDLE SCHOOL,8TH,1,0,0,1,29,31,2,6%
2760,HAYDEN RE-1,3860,HAYDEN MIDDLE SCHOOL,SCHOOL TOTAL,1,1,3,8,81,94,13,14%
2760,HAYDEN RE-1,3862,HAYDEN HIGH SCHOOL,9TH,0,0,0,3,31,34,3,9%
2760,HAYDEN RE-1,3862,HAYDEN HIGH SCHOOL,10TH,1,0,0,2,30,33,3,9%
2760,HAYDEN RE-1,3862,HAYDEN HIGH SCHOOL,11TH,2,0,0,0,36,38,2,5%
2760,HAYDEN RE-1,3862,HAYDEN HIGH SCHOOL,12TH,0,0,0,5,37,42,5,12%
2760,HAYDEN RE-1,3862,HAYDEN HIGH SCHOOL,SCHOOL TOTAL,3,0,0,10,134,147,13,9%
2760,HAYDEN RE-1,,DISTRICT TOTAL,,5,2,3,45,383,438,55,13%
2770,STEAMBOAT SPRINGS RE-2,6363,NORTH ROUTT CHARTER SCHOOL,KINDERGARTEN,0,0,0,0,8,8,0,0%
2770,STEAMBOAT SPRINGS RE-2,6363,NORTH ROUTT CHARTER SCHOOL,1ST,0,0,0,0,9,9,0,0%
2770,STEAMBOAT SPRINGS RE-2,6363,NORTH ROUTT CHARTER SCHOOL,2ND,0,0,0,0,6,6,0,0%
2770,STEAMBOAT SPRINGS RE-2,6363,NORTH ROUTT CHARTER SCHOOL,3RD,0,0,0,0,11,11,0,0%
2770,STEAMBOAT SPRINGS RE-2,6363,NORTH ROUTT CHARTER SCHOOL,4TH,0,0,0,0,6,6,0,0%
2770,STEAMBOAT SPRINGS RE-2,6363,NORTH ROUTT CHARTER SCHOOL,5TH,0,0,0,0,8,8,0,0%
2770,STEAMBOAT SPRINGS RE-2,6363,NORTH ROUTT CHARTER SCHOOL,6TH,0,0,0,0,10,10,0,0%
2770,STEAMBOAT SPRINGS RE-2,6363,NORTH ROUTT CHARTER SCHOOL,7TH,0,0,0,0,4,4,0,0%
2770,STEAMBOAT SPRINGS RE-2,6363,NORTH ROUTT CHARTER SCHOOL,8TH,0,0,0,0,5,5,0,0%
2770,STEAMBOAT SPRINGS RE-2,6363,NORTH ROUTT CHARTER SCHOOL,SCHOOL TOTAL,0,0,0,0,67,67,0,0%
2770,STEAMBOAT SPRINGS RE-2,8208,SODA CREEK ELEMENTARY SCHOOL,KINDERGARTEN,0,1,0,6,58,65,7,11%
2770,STEAMBOAT SPRINGS RE-2,8208,SODA CREEK ELEMENTARY SCHOOL,1ST,1,1,0,8,80,90,10,11%
2770,STEAMBOAT SPRINGS RE-2,8208,SODA CREEK ELEMENTARY SCHOOL,2ND,0,4,0,7,64,75,11,15%
2770,STEAMBOAT SPRINGS RE-2,8208,SODA CREEK ELEMENTARY SCHOOL,3RD,0,1,0,7,60,68,8,12%
2770,STEAMBOAT SPRINGS RE-2,8208,SODA CREEK ELEMENTARY SCHOOL,4TH,0,3,1,5,71,80,9,11%
2770,STEAMBOAT SPRINGS RE-2,8208,SODA CREEK ELEMENTARY SCHOOL,5TH,0,2,1,8,71,82,11,13%
2770,STEAMBOAT SPRINGS RE-2,8208,SODA CREEK ELEMENTARY SCHOOL,SCHOOL TOTAL,1,12,2,41,404,460,56,12%
2770,STEAMBOAT SPRINGS RE-2,8210,STEAMBOAT SPRINGS MIDDLE SCHOOL,6TH,0,4,0,12,156,172,16,9%
2770,STEAMBOAT SPRINGS RE-2,8210,STEAMBOAT SPRINGS MIDDLE SCHOOL,7TH,1,4,1,12,150,168,18,11%
2770,STEAMBOAT SPRINGS RE-2,8210,STEAMBOAT SPRINGS MIDDLE SCHOOL,8TH,0,5,1,9,140,155,15,10%
2770,STEAMBOAT SPRINGS RE-2,8210,STEAMBOAT SPRINGS MIDDLE SCHOOL,SCHOOL TOTAL,1,13,2,33,446,495,49,10%
2770,STEAMBOAT SPRINGS RE-2,8212,STEAMBOAT SPRINGS HIGH SCHOOL,9TH,0,2,0,16,142,160,18,11%
2770,STEAMBOAT SPRINGS RE-2,8212,STEAMBOAT SPRINGS HIGH SCHOOL,10TH,2,2,0,11,135,150,15,10%
2770,STEAMBOAT SPRINGS RE-2,8212,STEAMBOAT SPRINGS HIGH SCHOOL,11TH,3,2,2,11,155,173,18,10%
2770,STEAMBOAT SPRINGS RE-2,8212,STEAMBOAT SPRINGS HIGH SCHOOL,12TH,1,3,0,14,139,157,18,11%
2770,STEAMBOAT SPRINGS RE-2,8212,STEAMBOAT SPRINGS HIGH SCHOOL,SCHOOL TOTAL,6,9,2,52,571,640,69,11%
2770,STEAMBOAT SPRINGS RE-2,8358,STRAWBERRY PARK ELEMENTARY SCHOOL,HALF DAY K,1,0,0,0,17,18,1,6%
2770,STEAMBOAT SPRINGS RE-2,8358,STRAWBERRY PARK ELEMENTARY SCHOOL,KINDERGARTEN,0,1,1,6,47,55,8,15%
2770,STEAMBOAT SPRINGS RE-2,8358,STRAWBERRY PARK ELEMENTARY SCHOOL,1ST,0,6,0,16,66,88,22,25%
2770,STEAMBOAT SPRINGS RE-2,8358,STRAWBERRY PARK ELEMENTARY SCHOOL,2ND,0,2,0,12,62,76,14,18%
2770,STEAMBOAT SPRINGS RE-2,8358,STRAWBERRY PARK ELEMENTARY SCHOOL,3RD,1,4,0,11,64,80,16,20%
2770,STEAMBOAT SPRINGS RE-2,8358,STRAWBERRY PARK ELEMENTARY SCHOOL,4TH,0,0,0,7,82,89,7,8%
2770,STEAMBOAT SPRINGS RE-2,8358,STRAWBERRY PARK ELEMENTARY SCHOOL,5TH,0,1,0,5,78,84,6,7%
2770,STEAMBOAT SPRINGS RE-2,8358,STRAWBERRY PARK ELEMENTARY SCHOOL,SCHOOL TOTAL,2,14,1,57,416,490,74,15%
2770,STEAMBOAT SPRINGS RE-2,,DISTRICT TOTAL,,10,48,7,183,1904,2152,248,12%
2780,SOUTH ROUTT RE 3,8048,SOROCO MIDDLE SCHOOL,6TH,0,0,0,3,25,28,3,11%
2780,SOUTH ROUTT RE 3,8048,SOROCO MIDDLE SCHOOL,7TH,1,2,0,2,22,27,5,19%
2780,SOUTH ROUTT RE 3,8048,SOROCO MIDDLE SCHOOL,8TH,0,1,0,1,23,25,2,8%
2780,SOUTH ROUTT RE 3,8048,SOROCO MIDDLE SCHOOL,SCHOOL TOTAL,1,3,0,6,70,80,10,13%
2780,SOUTH ROUTT RE 3,8050,SOROCO HIGH SCHOOL,9TH,0,0,1,1,23,25,2,8%
2780,SOUTH ROUTT RE 3,8050,SOROCO HIGH SCHOOL,10TH,0,0,0,2,19,21,2,10%
2780,SOUTH ROUTT RE 3,8050,SOROCO HIGH SCHOOL,11TH,0,1,0,0,34,35,1,3%
2780,SOUTH ROUTT RE 3,8050,SOROCO HIGH SCHOOL,12TH,0,0,0,2,26,28,2,7%
2780,SOUTH ROUTT RE 3,8050,SOROCO HIGH SCHOOL,SCHOOL TOTAL,0,1,1,5,102,109,7,6%
2780,SOUTH ROUTT RE 3,8119,SOUTH ROUTT EARLY LEARNING CENTER,PK,0,0,1,1,43,45,2,4%
2780,SOUTH ROUTT RE 3,8119,SOUTH ROUTT EARLY LEARNING CENTER,SCHOOL TOTAL,0,0,1,1,43,45,2,4%
2780,SOUTH ROUTT RE 3,8120,SOUTH ROUTT ELEMENTARY SCHOOL,KINDERGARTEN,1,1,0,3,35,40,5,13%
2780,SOUTH ROUTT RE 3,8120,SOUTH ROUTT ELEMENTARY SCHOOL,1ST,0,0,0,4,33,37,4,11%
2780,SOUTH ROUTT RE 3,8120,SOUTH ROUTT ELEMENTARY SCHOOL,2ND,0,0,0,3,33,36,3,8%
2780,SOUTH ROUTT RE 3,8120,SOUTH ROUTT ELEMENTARY SCHOOL,3RD,0,1,2,2,28,33,5,15%
2780,SOUTH ROUTT RE 3,8120,SOUTH ROUTT ELEMENTARY SCHOOL,4TH,0,0,0,2,28,30,2,7%
2780,SOUTH ROUTT RE 3,8120,SOUTH ROUTT ELEMENTARY SCHOOL,5TH,0,1,0,4,20,25,5,20%
2780,SOUTH ROUTT RE 3,8120,SOUTH ROUTT ELEMENTARY SCHOOL,SCHOOL TOTAL,1,3,2,18,177,201,24,12%
2780,SOUTH ROUTT RE 3,,DISTRICT TOTAL,,2,7,4,30,392,435,43,10%
2790,MOUNTAIN VALLEY RE 1,6142,MOUNTAIN VALLEY ELEMENTARY SCHOOL,PK,1,0,0,2,14,17,3,18%
2790,MOUNTAIN VALLEY RE 1,6142,MOUNTAIN VALLEY ELEMENTARY SCHOOL,KINDERGARTEN,0,0,0,1,3,4,1,25%
2790,MOUNTAIN VALLEY RE 1,6142,MOUNTAIN VALLEY ELEMENTARY SCHOOL,1ST,0,0,0,3,9,12,3,25%
2790,MOUNTAIN VALLEY RE 1,6142,MOUNTAIN VALLEY ELEMENTARY SCHOOL,2ND,1,0,0,3,8,12,4,33%
2790,MOUNTAIN VALLEY RE 1,6142,MOUNTAIN VALLEY ELEMENTARY SCHOOL,3RD,0,0,0,2,7,9,2,22%
2790,MOUNTAIN VALLEY RE 1,6142,MOUNTAIN VALLEY ELEMENTARY SCHOOL,4TH,0,0,0,2,2,4,2,50%
2790,MOUNTAIN VALLEY RE 1,6142,MOUNTAIN VALLEY ELEMENTARY SCHOOL,5TH,0,0,0,1,8,9,1,11%
2790,MOUNTAIN VALLEY RE 1,6142,MOUNTAIN VALLEY ELEMENTARY SCHOOL,SCHOOL TOTAL,2,0,0,14,51,67,16,24%
2790,MOUNTAIN VALLEY RE 1,6144,MOUNTAIN VALLEY MIDDLE SCHOOL,6TH,0,0,0,1,5,6,1,17%
2790,MOUNTAIN VALLEY RE 1,6144,MOUNTAIN VALLEY MIDDLE SCHOOL,7TH,0,0,0,3,0,3,3,100%
2790,MOUNTAIN VALLEY RE 1,6144,MOUNTAIN VALLEY MIDDLE SCHOOL,8TH,0,0,0,2,9,11,2,18%
2790,MOUNTAIN VALLEY RE 1,6144,MOUNTAIN VALLEY MIDDLE SCHOOL,SCHOOL TOTAL,0,0,0,6,14,20,6,30%
2790,MOUNTAIN VALLEY RE 1,6146,MOUNTAIN VALLEY SENIOR HIGH SCHOOL,9TH,0,0,0,1,3,4,1,25%
2790,MOUNTAIN VALLEY RE 1,6146,MOUNTAIN VALLEY SENIOR HIGH SCHOOL,10TH,0,0,0,3,9,12,3,25%
2790,MOUNTAIN VALLEY RE 1,6146,MOUNTAIN VALLEY SENIOR HIGH SCHOOL,11TH,0,0,0,3,8,11,3,27%
2790,MOUNTAIN VALLEY RE 1,6146,MOUNTAIN VALLEY SENIOR HIGH SCHOOL,12TH,0,0,1,7,6,14,8,57%
2790,MOUNTAIN VALLEY RE 1,6146,MOUNTAIN VALLEY SENIOR HIGH SCHOOL,SCHOOL TOTAL,0,0,1,14,26,41,15,37%
2790,MOUNTAIN VALLEY RE 1,,DISTRICT TOTAL,,2,0,1,34,91,128,37,29%
2800,MOFFAT 2,2018,CRESTONE CHARTER SCHOOL,KINDERGARTEN,0,1,0,2,8,11,3,27%
2800,MOFFAT 2,2018,CRESTONE CHARTER SCHOOL,1ST,0,0,0,1,4,5,1,20%
2800,MOFFAT 2,2018,CRESTONE CHARTER SCHOOL,2ND,0,0,1,0,3,4,1,25%
2800,MOFFAT 2,2018,CRESTONE CHARTER SCHOOL,3RD,1,0,0,0,5,6,1,17%
2800,MOFFAT 2,2018,CRESTONE CHARTER SCHOOL,4TH,0,0,0,0,5,5,0,0%
2800,MOFFAT 2,2018,CRESTONE CHARTER SCHOOL,5TH,1,0,0,0,8,9,1,11%
2800,MOFFAT 2,2018,CRESTONE CHARTER SCHOOL,6TH,0,0,0,0,4,4,0,0%
2800,MOFFAT 2,2018,CRESTONE CHARTER SCHOOL,7TH,0,0,0,0,5,5,0,0%
2800,MOFFAT 2,2018,CRESTONE CHARTER SCHOOL,8TH,1,0,0,0,4,5,1,20%
2800,MOFFAT 2,2018,CRESTONE CHARTER SCHOOL,9TH,0,0,0,1,7,8,1,13%
2800,MOFFAT 2,2018,CRESTONE CHARTER SCHOOL,10TH,0,0,0,0,3,3,0,0%
2800,MOFFAT 2,2018,CRESTONE CHARTER SCHOOL,11TH,0,0,0,0,4,4,0,0%
2800,MOFFAT 2,2018,CRESTONE CHARTER SCHOOL,12TH,0,0,0,0,6,6,0,0%
2800,MOFFAT 2,2018,CRESTONE CHARTER SCHOOL,SCHOOL TOTAL,3,1,1,4,66,75,9,12%
2800,MOFFAT 2,5954,MOFFAT ELEMENTARY SCHOOL,PK,0,1,0,3,10,14,4,29%
2800,MOFFAT 2,5954,MOFFAT ELEMENTARY SCHOOL,KINDERGARTEN,1,0,0,2,3,6,3,50%
2800,MOFFAT 2,5954,MOFFAT ELEMENTARY SCHOOL,1ST,1,0,0,0,5,6,1,17%
2800,MOFFAT 2,5954,MOFFAT ELEMENTARY SCHOOL,2ND,1,0,0,1,7,9,2,22%
2800,MOFFAT 2,5954,MOFFAT ELEMENTARY SCHOOL,3RD,0,0,2,0,10,12,2,17%
2800,MOFFAT 2,5954,MOFFAT ELEMENTARY SCHOOL,4TH,0,0,0,2,4,6,2,33%
2800,MOFFAT 2,5954,MOFFAT ELEMENTARY SCHOOL,SCHOOL TOTAL,3,1,2,8,39,53,14,26%
2800,MOFFAT 2,5956,MOFFAT MIDDLE SCHOOL,5TH,0,0,0,4,8,12,4,33%
2800,MOFFAT 2,5956,MOFFAT MIDDLE SCHOOL,6TH,0,0,0,2,5,7,2,29%
2800,MOFFAT 2,5956,MOFFAT MIDDLE SCHOOL,7TH,0,2,0,2,11,15,4,27%
2800,MOFFAT 2,5956,MOFFAT MIDDLE SCHOOL,8TH,0,0,0,2,7,9,2,22%
2800,MOFFAT 2,5956,MOFFAT MIDDLE SCHOOL,SCHOOL TOTAL,0,2,0,10,31,43,12,28%
2800,MOFFAT 2,5958,MOFFAT SENIOR HIGH SCHOOL,9TH,2,0,1,2,6,11,5,45%
2800,MOFFAT 2,5958,MOFFAT SENIOR HIGH SCHOOL,10TH,2,1,1,2,7,13,6,46%
2800,MOFFAT 2,5958,MOFFAT SENIOR HIGH SCHOOL,11TH,0,1,0,1,10,12,2,17%
2800,MOFFAT 2,5958,MOFFAT SENIOR HIGH SCHOOL,12TH,0,0,0,1,15,16,1,6%
2800,MOFFAT 2,5958,MOFFAT SENIOR HIGH SCHOOL,SCHOOL TOTAL,4,2,2,6,38,52,14,27%
2800,MOFFAT 2,,DISTRICT TOTAL,,10,6,5,28,174,223,49,22%
2810,CENTER 26 JT,0051,THE ACADEMIC RECOVERY CENTER OF SAN LUIS VALLEY,9TH,0,0,0,2,1,3,2,67%
2810,CENTER 26 JT,0051,THE ACADEMIC RECOVERY CENTER OF SAN LUIS VALLEY,10TH,1,0,0,8,0,9,9,100%
2810,CENTER 26 JT,0051,THE ACADEMIC RECOVERY CENTER OF SAN LUIS VALLEY,11TH,1,0,0,6,1,8,7,88%
2810,CENTER 26 JT,0051,THE ACADEMIC RECOVERY CENTER OF SAN LUIS VALLEY,SCHOOL TOTAL,2,0,0,16,2,20,18,90%
2810,CENTER 26 JT,1412,HASKIN ELEMENTARY SCHOOL,PK,0,0,0,25,5,30,25,83%
2810,CENTER 26 JT,1412,HASKIN ELEMENTARY SCHOOL,KINDERGARTEN,1,0,0,42,3,46,43,93%
2810,CENTER 26 JT,1412,HASKIN ELEMENTARY SCHOOL,1ST,0,0,0,53,3,56,53,95%
2810,CENTER 26 JT,1412,HASKIN ELEMENTARY SCHOOL,2ND,2,0,0,48,3,53,50,94%
2810,CENTER 26 JT,1412,HASKIN ELEMENTARY SCHOOL,3RD,3,0,0,35,2,40,38,95%
2810,CENTER 26 JT,1412,HASKIN ELEMENTARY SCHOOL,4TH,0,0,0,34,2,36,34,94%
2810,CENTER 26 JT,1412,HASKIN ELEMENTARY SCHOOL,5TH,1,0,1,45,7,54,47,87%
2810,CENTER 26 JT,1412,HASKIN ELEMENTARY SCHOOL,SCHOOL TOTAL,7,0,1,282,25,315,290,92%
2810,CENTER 26 JT,1416,SKOGLUND MIDDLE SCHOOL,6TH,1,0,0,45,2,48,46,96%
2810,CENTER 26 JT,1416,SKOGLUND MIDDLE SCHOOL,7TH,0,0,1,29,3,33,30,91%
2810,CENTER 26 JT,1416,SKOGLUND MIDDLE SCHOOL,8TH,0,0,0,27,3,30,27,90%
2810,CENTER 26 JT,1416,SKOGLUND MIDDLE SCHOOL,SCHOOL TOTAL,1,0,1,101,8,111,103,93%
2810,CENTER 26 JT,1420,CENTER HIGH SCHOOL,9TH,1,0,0,41,6,48,42,88%
2810,CENTER 26 JT,1420,CENTER HIGH SCHOOL,10TH,1,1,0,26,3,31,28,90%
2810,CENTER 26 JT,1420,CENTER HIGH SCHOOL,11TH,1,0,0,40,4,45,41,91%
2810,CENTER 26 JT,1420,CENTER HIGH SCHOOL,12TH,0,1,0,30,4,35,31,89%
2810,CENTER 26 JT,1420,CENTER HIGH SCHOOL,SCHOOL TOTAL,3,2,0,137,17,159,142,89%
2810,CENTER 26 JT,,DISTRICT TOTAL,,13,2,2,536,52,605,553,91%
2820,SILVERTON 1,7900,SILVERTON ELEMENTARY SCHOOL,HALF DAY K,0,0,0,2,5,7,2,29%
2820,SILVERTON 1,7900,SILVERTON ELEMENTARY SCHOOL,1ST,0,0,0,1,5,6,1,17%
2820,SILVERTON 1,7900,SILVERTON ELEMENTARY SCHOOL,2ND,0,0,0,2,6,8,2,25%
2820,SILVERTON 1,7900,SILVERTON ELEMENTARY SCHOOL,3RD,0,0,0,0,5,5,0,0%
2820,SILVERTON 1,7900,SILVERTON ELEMENTARY SCHOOL,4TH,0,0,0,2,5,7,2,29%
2820,SILVERTON 1,7900,SILVERTON ELEMENTARY SCHOOL,5TH,0,0,0,1,3,4,1,25%
2820,SILVERTON 1,7900,SILVERTON ELEMENTARY SCHOOL,SCHOOL TOTAL,0,0,0,8,29,37,8,22%
2820,SILVERTON 1,7902,SILVERTON MIDDLE SCHOOL,6TH,1,0,0,2,7,10,3,30%
2820,SILVERTON 1,7902,SILVERTON MIDDLE SCHOOL,7TH,0,0,0,0,1,1,0,0%
2820,SILVERTON 1,7902,SILVERTON MIDDLE SCHOOL,8TH,0,0,0,2,4,6,2,33%
2820,SILVERTON 1,7902,SILVERTON MIDDLE SCHOOL,SCHOOL TOTAL,1,0,0,4,12,17,5,29%
2820,SILVERTON 1,7904,SILVERTON HIGH SCHOOL,9TH,1,0,0,1,4,6,2,33%
2820,SILVERTON 1,7904,SILVERTON HIGH SCHOOL,10TH,1,0,0,2,1,4,3,75%
2820,SILVERTON 1,7904,SILVERTON HIGH SCHOOL,12TH,0,0,0,0,2,2,0,0%
2820,SILVERTON 1,7904,SILVERTON HIGH SCHOOL,SCHOOL TOTAL,2,0,0,3,7,12,5,42%
2820,SILVERTON 1,,DISTRICT TOTAL,,3,0,0,15,48,66,18,27%
2830,TELLURIDE R-1,8786,TELLURIDE ELEMENTARY SCHOOL,PK,0,0,0,11,7,18,11,61%
2830,TELLURIDE R-1,8786,TELLURIDE ELEMENTARY SCHOOL,KINDERGARTEN,0,2,0,7,64,73,9,12%
2830,TELLURIDE R-1,8786,TELLURIDE ELEMENTARY SCHOOL,1ST,0,4,1,7,48,60,12,20%
2830,TELLURIDE R-1,8786,TELLURIDE ELEMENTARY SCHOOL,2ND,0,2,0,8,58,68,10,15%
2830,TELLURIDE R-1,8786,TELLURIDE ELEMENTARY SCHOOL,3RD,0,0,0,9,54,63,9,14%
2830,TELLURIDE R-1,8786,TELLURIDE ELEMENTARY SCHOOL,4TH,0,0,0,6,37,43,6,14%
2830,TELLURIDE R-1,8786,TELLURIDE ELEMENTARY SCHOOL,5TH,1,0,1,4,46,52,6,12%
2830,TELLURIDE R-1,8786,TELLURIDE ELEMENTARY SCHOOL,6TH,0,2,0,6,43,51,8,16%
2830,TELLURIDE R-1,8786,TELLURIDE ELEMENTARY SCHOOL,SCHOOL TOTAL,1,10,2,58,357,428,71,17%
2830,TELLURIDE R-1,8790,TELLURIDE MIDDLE SCHOOL,7TH,0,0,0,11,45,56,11,20%
2830,TELLURIDE R-1,8790,TELLURIDE MIDDLE SCHOOL,8TH,1,1,0,12,39,53,14,26%
2830,TELLURIDE R-1,8790,TELLURIDE MIDDLE SCHOOL,SCHOOL TOTAL,1,1,0,23,84,109,25,23%
2830,TELLURIDE R-1,8794,TELLURIDE HIGH SCHOOL,9TH,0,1,0,5,47,53,6,11%
2830,TELLURIDE R-1,8794,TELLURIDE HIGH SCHOOL,10TH,0,0,1,4,31,36,5,14%
2830,TELLURIDE R-1,8794,TELLURIDE HIGH SCHOOL,11TH,0,0,0,2,24,26,2,8%
2830,TELLURIDE R-1,8794,TELLURIDE HIGH SCHOOL,12TH,0,0,1,3,43,47,4,9%
2830,TELLURIDE R-1,8794,TELLURIDE HIGH SCHOOL,SCHOOL TOTAL,0,1,2,14,145,162,17,10%
2830,TELLURIDE R-1,,DISTRICT TOTAL,,2,12,4,95,586,699,113,16%
2840,NORWOOD R-2J,6418,NORWOOD ELEMENTARY SCHOOL,PK,1,0,1,3,24,29,5,17%
2840,NORWOOD R-2J,6418,NORWOOD ELEMENTARY SCHOOL,HALF DAY K,0,0,0,0,6,6,0,0%
2840,NORWOOD R-2J,6418,NORWOOD ELEMENTARY SCHOOL,KINDERGARTEN,0,0,0,1,13,14,1,7%
2840,NORWOOD R-2J,6418,NORWOOD ELEMENTARY SCHOOL,1ST,1,0,0,1,14,16,2,13%
2840,NORWOOD R-2J,6418,NORWOOD ELEMENTARY SCHOOL,2ND,0,0,1,1,15,17,2,12%
2840,NORWOOD R-2J,6418,NORWOOD ELEMENTARY SCHOOL,3RD,0,0,0,5,20,25,5,20%
2840,NORWOOD R-2J,6418,NORWOOD ELEMENTARY SCHOOL,4TH,0,0,0,2,19,21,2,10%
2840,NORWOOD R-2J,6418,NORWOOD ELEMENTARY SCHOOL,5TH,0,0,1,3,20,24,4,17%
2840,NORWOOD R-2J,6418,NORWOOD ELEMENTARY SCHOOL,SCHOOL TOTAL,2,0,3,16,131,152,21,14%
2840,NORWOOD R-2J,6422,NORWOOD HIGH SCHOOL,6TH,0,0,0,0,18,18,0,0%
2840,NORWOOD R-2J,6422,NORWOOD HIGH SCHOOL,7TH,0,0,0,2,18,20,2,10%
2840,NORWOOD R-2J,6422,NORWOOD HIGH SCHOOL,8TH,0,0,0,0,15,15,0,0%
2840,NORWOOD R-2J,6422,NORWOOD HIGH SCHOOL,9TH,0,0,0,0,23,23,0,0%
2840,NORWOOD R-2J,6422,NORWOOD HIGH SCHOOL,10TH,0,0,0,2,13,15,2,13%
2840,NORWOOD R-2J,6422,NORWOOD HIGH SCHOOL,11TH,0,0,1,2,15,18,3,17%
2840,NORWOOD R-2J,6422,NORWOOD HIGH SCHOOL,12TH,0,0,0,0,13,13,0,0%
2840,NORWOOD R-2J,6422,NORWOOD HIGH SCHOOL,SCHOOL TOTAL,0,0,1,6,115,122,7,6%
2840,NORWOOD R-2J,,DISTRICT TOTAL,,2,0,4,22,246,274,28,10%
2862,JULESBURG RE-1,4369,INSIGHT SCHOOL OF COLORADO AT JULESBURG,9TH,18,4,12,65,253,352,99,28%
2862,JULESBURG RE-1,4369,INSIGHT SCHOOL OF COLORADO AT JULESBURG,10TH,16,4,19,61,218,318,100,31%
2862,JULESBURG RE-1,4369,INSIGHT SCHOOL OF COLORADO AT JULESBURG,11TH,10,0,15,26,134,185,51,28%
2862,JULESBURG RE-1,4369,INSIGHT SCHOOL OF COLORADO AT JULESBURG,12TH,5,0,6,15,93,119,26,22%
2862,JULESBURG RE-1,4369,INSIGHT SCHOOL OF COLORADO AT JULESBURG,SCHOOL TOTAL,49,8,52,167,698,974,276,28%
2862,JULESBURG RE-1,4488,JULESBURG ELEMENTARY SCHOOL,PK,0,0,0,6,32,38,6,16%
2862,JULESBURG RE-1,4488,JULESBURG ELEMENTARY SCHOOL,KINDERGARTEN,0,1,0,3,11,15,4,27%
2862,JULESBURG RE-1,4488,JULESBURG ELEMENTARY SCHOOL,1ST,0,0,2,7,12,21,9,43%
2862,JULESBURG RE-1,4488,JULESBURG ELEMENTARY SCHOOL,2ND,0,0,0,5,7,12,5,42%
2862,JULESBURG RE-1,4488,JULESBURG ELEMENTARY SCHOOL,3RD,0,0,0,2,10,12,2,17%
2862,JULESBURG RE-1,4488,JULESBURG ELEMENTARY SCHOOL,4TH,1,0,1,2,8,12,4,33%
2862,JULESBURG RE-1,4488,JULESBURG ELEMENTARY SCHOOL,5TH,0,0,0,4,9,13,4,31%
2862,JULESBURG RE-1,4488,JULESBURG ELEMENTARY SCHOOL,6TH,0,0,0,2,19,21,2,10%
2862,JULESBURG RE-1,4488,JULESBURG ELEMENTARY SCHOOL,SCHOOL TOTAL,1,1,3,31,108,144,36,25%
2862,JULESBURG RE-1,4492,JULESBURG HIGH SCHOOL,7TH,0,0,0,6,10,16,6,38%
2862,JULESBURG RE-1,4492,JULESBURG HIGH SCHOOL,8TH,0,0,0,5,10,15,5,33%
2862,JULESBURG RE-1,4492,JULESBURG HIGH SCHOOL,9TH,0,0,0,3,21,24,3,13%
2862,JULESBURG RE-1,4492,JULESBURG HIGH SCHOOL,10TH,0,1,0,6,16,23,7,30%
2862,JULESBURG RE-1,4492,JULESBURG HIGH SCHOOL,11TH,0,0,0,3,18,21,3,14%
2862,JULESBURG RE-1,4492,JULESBURG HIGH SCHOOL,12TH,0,0,0,6,14,20,6,30%
2862,JULESBURG RE-1,4492,JULESBURG HIGH SCHOOL,SCHOOL TOTAL,0,1,0,29,89,119,30,25%
2862,JULESBURG RE-1,,DISTRICT TOTAL,,50,10,55,227,895,1237,342,28%
2865,PLATTE VALLEY RE-3,7050,PLATTE VALLEY ELEMENTARY SCHOOL,KINDERGARTEN,0,0,0,2,8,10,2,20%
2865,PLATTE VALLEY RE-3,7050,PLATTE VALLEY ELEMENTARY SCHOOL,1ST,0,0,0,4,3,7,4,57%
2865,PLATTE VALLEY RE-3,7050,PLATTE VALLEY ELEMENTARY SCHOOL,2ND,0,0,0,5,9,14,5,36%
2865,PLATTE VALLEY RE-3,7050,PLATTE VALLEY ELEMENTARY SCHOOL,3RD,1,0,0,1,8,10,2,20%
2865,PLATTE VALLEY RE-3,7050,PLATTE VALLEY ELEMENTARY SCHOOL,4TH,0,0,0,3,5,8,3,38%
2865,PLATTE VALLEY RE-3,7050,PLATTE VALLEY ELEMENTARY SCHOOL,5TH,1,0,0,3,12,16,4,25%
2865,PLATTE VALLEY RE-3,7050,PLATTE VALLEY ELEMENTARY SCHOOL,6TH,0,0,0,2,10,12,2,17%
2865,PLATTE VALLEY RE-3,7050,PLATTE VALLEY ELEMENTARY SCHOOL,SCHOOL TOTAL,2,0,0,20,55,77,22,29%
2865,PLATTE VALLEY RE-3,7322,REVERE JUNIOR-SENIOR HIGH SCHOOL,7TH,0,0,1,2,4,7,3,43%
2865,PLATTE VALLEY RE-3,7322,REVERE JUNIOR-SENIOR HIGH SCHOOL,8TH,0,0,0,0,6,6,0,0%
2865,PLATTE VALLEY RE-3,7322,REVERE JUNIOR-SENIOR HIGH SCHOOL,9TH,0,0,0,0,6,6,0,0%
2865,PLATTE VALLEY RE-3,7322,REVERE JUNIOR-SENIOR HIGH SCHOOL,10TH,0,0,1,2,4,7,3,43%
2865,PLATTE VALLEY RE-3,7322,REVERE JUNIOR-SENIOR HIGH SCHOOL,11TH,0,0,0,1,6,7,1,14%
2865,PLATTE VALLEY RE-3,7322,REVERE JUNIOR-SENIOR HIGH SCHOOL,12TH,0,0,0,1,4,5,1,20%
2865,PLATTE VALLEY RE-3,7322,REVERE JUNIOR-SENIOR HIGH SCHOOL,SCHOOL TOTAL,0,0,2,6,30,38,8,21%
2865,PLATTE VALLEY RE-3,,DISTRICT TOTAL,,2,0,2,26,85,115,30,26%
3000,SUMMIT RE-1,8370,DILLON VALLEY ELEMENTARY SCHOOL,PK,0,0,0,30,8,38,30,79%
3000,SUMMIT RE-1,8370,DILLON VALLEY ELEMENTARY SCHOOL,KINDERGARTEN,0,1,0,46,39,86,47,55%
3000,SUMMIT RE-1,8370,DILLON VALLEY ELEMENTARY SCHOOL,1ST,0,0,0,28,27,55,28,51%
3000,SUMMIT RE-1,8370,DILLON VALLEY ELEMENTARY SCHOOL,2ND,0,1,0,38,31,70,39,56%
3000,SUMMIT RE-1,8370,DILLON VALLEY ELEMENTARY SCHOOL,3RD,0,1,0,43,25,69,44,64%
3000,SUMMIT RE-1,8370,DILLON VALLEY ELEMENTARY SCHOOL,4TH,1,0,0,21,18,40,22,55%
3000,SUMMIT RE-1,8370,DILLON VALLEY ELEMENTARY SCHOOL,5TH,0,1,0,22,9,32,23,72%
3000,SUMMIT RE-1,8370,DILLON VALLEY ELEMENTARY SCHOOL,SCHOOL TOTAL,1,4,0,228,157,390,233,60%
3000,SUMMIT RE-1,8372,BRECKENRIDGE ELEMENTARY SCHOOL,KINDERGARTEN,0,0,0,1,42,43,1,2%
3000,SUMMIT RE-1,8372,BRECKENRIDGE ELEMENTARY SCHOOL,1ST,0,1,0,0,38,39,1,3%
3000,SUMMIT RE-1,8372,BRECKENRIDGE ELEMENTARY SCHOOL,2ND,0,0,0,2,37,39,2,5%
3000,SUMMIT RE-1,8372,BRECKENRIDGE ELEMENTARY SCHOOL,3RD,0,1,0,0,33,34,1,3%
3000,SUMMIT RE-1,8372,BRECKENRIDGE ELEMENTARY SCHOOL,4TH,0,1,0,0,34,35,1,3%
3000,SUMMIT RE-1,8372,BRECKENRIDGE ELEMENTARY SCHOOL,5TH,0,2,0,2,33,37,4,11%
3000,SUMMIT RE-1,8372,BRECKENRIDGE ELEMENTARY SCHOOL,SCHOOL TOTAL,0,5,0,5,217,227,10,4%
3000,SUMMIT RE-1,8374,FRISCO ELEMENTARY SCHOOL,PK,0,0,0,1,23,24,1,4%
3000,SUMMIT RE-1,8374,FRISCO ELEMENTARY SCHOOL,KINDERGARTEN,0,0,0,4,21,25,4,16%
3000,SUMMIT RE-1,8374,FRISCO ELEMENTARY SCHOOL,1ST,0,1,0,3,33,37,4,11%
3000,SUMMIT RE-1,8374,FRISCO ELEMENTARY SCHOOL,2ND,0,1,0,1,40,42,2,5%
3000,SUMMIT RE-1,8374,FRISCO ELEMENTARY SCHOOL,3RD,0,2,0,6,28,36,8,22%
3000,SUMMIT RE-1,8374,FRISCO ELEMENTARY SCHOOL,4TH,0,1,1,4,20,26,6,23%
3000,SUMMIT RE-1,8374,FRISCO ELEMENTARY SCHOOL,5TH,0,0,0,5,20,25,5,20%
3000,SUMMIT RE-1,8374,FRISCO ELEMENTARY SCHOOL,SCHOOL TOTAL,0,5,1,24,185,215,30,14%
3000,SUMMIT RE-1,8376,SILVERTHORNE ELEMENTARY SCHOOL,PK,0,0,1,29,11,41,30,73%
3000,SUMMIT RE-1,8376,SILVERTHORNE ELEMENTARY SCHOOL,KINDERGARTEN,1,2,1,22,28,54,26,48%
3000,SUMMIT RE-1,8376,SILVERTHORNE ELEMENTARY SCHOOL,1ST,0,0,1,27,18,46,28,61%
3000,SUMMIT RE-1,8376,SILVERTHORNE ELEMENTARY SCHOOL,2ND,0,1,1,20,24,46,22,48%
3000,SUMMIT RE-1,8376,SILVERTHORNE ELEMENTARY SCHOOL,3RD,0,1,0,25,39,65,26,40%
3000,SUMMIT RE-1,8376,SILVERTHORNE ELEMENTARY SCHOOL,4TH,0,0,1,26,18,45,27,60%
3000,SUMMIT RE-1,8376,SILVERTHORNE ELEMENTARY SCHOOL,5TH,0,1,3,26,13,43,30,70%
3000,SUMMIT RE-1,8376,SILVERTHORNE ELEMENTARY SCHOOL,SCHOOL TOTAL,1,5,8,175,151,340,189,56%
3000,SUMMIT RE-1,8377,SUMMIT MIDDLE SCHOOL,6TH,0,4,1,52,140,197,57,29%
3000,SUMMIT RE-1,8377,SUMMIT MIDDLE SCHOOL,7TH,0,4,2,44,163,213,50,23%
3000,SUMMIT RE-1,8377,SUMMIT MIDDLE SCHOOL,8TH,1,5,1,43,148,198,50,25%
3000,SUMMIT RE-1,8377,SUMMIT MIDDLE SCHOOL,SCHOOL TOTAL,1,13,4,139,451,608,157,26%
3000,SUMMIT RE-1,8378,SUMMIT HIGH SCHOOL,9TH,0,0,0,50,151,201,50,25%
3000,SUMMIT RE-1,8378,SUMMIT HIGH SCHOOL,10TH,0,5,2,50,173,230,57,25%
3000,SUMMIT RE-1,8378,SUMMIT HIGH SCHOOL,11TH,0,3,2,35,152,192,40,21%
3000,SUMMIT RE-1,8378,SUMMIT HIGH SCHOOL,12TH,0,4,2,35,152,193,41,21%
3000,SUMMIT RE-1,8378,SUMMIT HIGH SCHOOL,SCHOOL TOTAL,0,12,6,170,628,816,188,23%
3000,SUMMIT RE-1,8385,SUMMIT COVE ELEMENTARY SCHOOL,PK,0,0,0,6,15,21,6,29%
3000,SUMMIT RE-1,8385,SUMMIT COVE ELEMENTARY SCHOOL,KINDERGARTEN,0,0,0,3,33,36,3,8%
3000,SUMMIT RE-1,8385,SUMMIT COVE ELEMENTARY SCHOOL,1ST,0,0,1,3,35,39,4,10%
3000,SUMMIT RE-1,8385,SUMMIT COVE ELEMENTARY SCHOOL,2ND,0,1,0,6,31,38,7,18%
3000,SUMMIT RE-1,8385,SUMMIT COVE ELEMENTARY SCHOOL,3RD,0,1,1,4,29,35,6,17%
3000,SUMMIT RE-1,8385,SUMMIT COVE ELEMENTARY SCHOOL,4TH,0,1,0,4,34,39,5,13%
3000,SUMMIT RE-1,8385,SUMMIT COVE ELEMENTARY SCHOOL,5TH,0,0,0,4,32,36,4,11%
3000,SUMMIT RE-1,8385,SUMMIT COVE ELEMENTARY SCHOOL,SCHOOL TOTAL,0,3,2,30,209,244,35,14%
3000,SUMMIT RE-1,8993,UPPER BLUE ELEMENTARY SCHOOL,PK,0,2,0,6,14,22,8,36%
3000,SUMMIT RE-1,8993,UPPER BLUE ELEMENTARY SCHOOL,KINDERGARTEN,0,1,0,8,32,41,9,22%
3000,SUMMIT RE-1,8993,UPPER BLUE ELEMENTARY SCHOOL,1ST,0,0,0,9,29,38,9,24%
3000,SUMMIT RE-1,8993,UPPER BLUE ELEMENTARY SCHOOL,2ND,0,2,0,7,23,32,9,28%
3000,SUMMIT RE-1,8993,UPPER BLUE ELEMENTARY SCHOOL,3RD,0,1,1,8,31,41,10,24%
3000,SUMMIT RE-1,8993,UPPER BLUE ELEMENTARY SCHOOL,4TH,0,1,0,6,33,40,7,18%
3000,SUMMIT RE-1,8993,UPPER BLUE ELEMENTARY SCHOOL,5TH,0,0,0,9,26,35,9,26%
3000,SUMMIT RE-1,8993,UPPER BLUE ELEMENTARY SCHOOL,SCHOOL TOTAL,0,7,1,53,188,249,61,24%
3000,SUMMIT RE-1,,DISTRICT TOTAL,,3,54,22,824,2186,3089,903,29%
3010,CRIPPLE CREEK-VICTOR RE-1,2024,CRIPPLE CREEK-VICTOR JUNIOR-SENIOR HIGH SCHOOL,7TH,0,0,1,1,31,33,2,6%
3010,CRIPPLE CREEK-VICTOR RE-1,2024,CRIPPLE CREEK-VICTOR JUNIOR-SENIOR HIGH SCHOOL,8TH,0,0,3,3,33,39,6,15%
3010,CRIPPLE CREEK-VICTOR RE-1,2024,CRIPPLE CREEK-VICTOR JUNIOR-SENIOR HIGH SCHOOL,9TH,0,0,0,6,29,35,6,17%
3010,CRIPPLE CREEK-VICTOR RE-1,2024,CRIPPLE CREEK-VICTOR JUNIOR-SENIOR HIGH SCHOOL,10TH,0,0,1,3,32,36,4,11%
3010,CRIPPLE CREEK-VICTOR RE-1,2024,CRIPPLE CREEK-VICTOR JUNIOR-SENIOR HIGH SCHOOL,11TH,2,0,2,1,30,35,5,14%
3010,CRIPPLE CREEK-VICTOR RE-1,2024,CRIPPLE CREEK-VICTOR JUNIOR-SENIOR HIGH SCHOOL,12TH,1,0,0,3,45,49,4,8%
3010,CRIPPLE CREEK-VICTOR RE-1,2024,CRIPPLE CREEK-VICTOR JUNIOR-SENIOR HIGH SCHOOL,SCHOOL TOTAL,3,0,7,17,200,227,27,12%
3010,CRIPPLE CREEK-VICTOR RE-1,9080,CRESSON ELEMENTARY SCHOOL,PK,0,0,0,9,34,43,9,21%
3010,CRIPPLE CREEK-VICTOR RE-1,9080,CRESSON ELEMENTARY SCHOOL,KINDERGARTEN,0,1,1,3,25,30,5,17%
3010,CRIPPLE CREEK-VICTOR RE-1,9080,CRESSON ELEMENTARY SCHOOL,1ST,0,0,1,0,29,30,1,3%
3010,CRIPPLE CREEK-VICTOR RE-1,9080,CRESSON ELEMENTARY SCHOOL,2ND,1,0,0,1,27,29,2,7%
3010,CRIPPLE CREEK-VICTOR RE-1,9080,CRESSON ELEMENTARY SCHOOL,3RD,0,0,0,1,22,23,1,4%
3010,CRIPPLE CREEK-VICTOR RE-1,9080,CRESSON ELEMENTARY SCHOOL,4TH,0,0,1,1,24,26,2,8%
3010,CRIPPLE CREEK-VICTOR RE-1,9080,CRESSON ELEMENTARY SCHOOL,5TH,0,1,1,4,28,34,6,18%
3010,CRIPPLE CREEK-VICTOR RE-1,9080,CRESSON ELEMENTARY SCHOOL,6TH,0,0,0,1,26,27,1,4%
3010,CRIPPLE CREEK-VICTOR RE-1,9080,CRESSON ELEMENTARY SCHOOL,SCHOOL TOTAL,1,2,4,20,215,242,27,11%
3010,CRIPPLE CREEK-VICTOR RE-1,,DISTRICT TOTAL,,4,2,11,37,415,469,54,12%
3020,WOODLAND PARK RE-2,0000,NOT IN A SCHOOL,8TH,0,0,0,0,1,1,0,0%
3020,WOODLAND PARK RE-2,0000,NOT IN A SCHOOL,SCHOOL TOTAL,0,0,0,0,1,1,0,0%
3020,WOODLAND PARK RE-2,8379,SUMMIT ELEMENTARY SCHOOL,PK,0,0,1,3,39,43,4,9%
3020,WOODLAND PARK RE-2,8379,SUMMIT ELEMENTARY SCHOOL,KINDERGARTEN,1,0,0,3,62,66,4,6%
3020,WOODLAND PARK RE-2,8379,SUMMIT ELEMENTARY SCHOOL,1ST,0,1,1,5,54,61,7,11%
3020,WOODLAND PARK RE-2,8379,SUMMIT ELEMENTARY SCHOOL,2ND,0,2,0,11,69,82,13,16%
3020,WOODLAND PARK RE-2,8379,SUMMIT ELEMENTARY SCHOOL,3RD,0,1,1,4,60,66,6,9%
3020,WOODLAND PARK RE-2,8379,SUMMIT ELEMENTARY SCHOOL,4TH,1,2,0,5,50,58,8,14%
3020,WOODLAND PARK RE-2,8379,SUMMIT ELEMENTARY SCHOOL,5TH,3,0,1,9,61,74,13,18%
3020,WOODLAND PARK RE-2,8379,SUMMIT ELEMENTARY SCHOOL,SCHOOL TOTAL,5,6,4,40,395,450,55,12%
3020,WOODLAND PARK RE-2,9692,GATEWAY ELEMENTARY SCHOOL,PK,0,0,0,5,28,33,5,15%
3020,WOODLAND PARK RE-2,9692,GATEWAY ELEMENTARY SCHOOL,KINDERGARTEN,1,1,0,4,71,77,6,8%
3020,WOODLAND PARK RE-2,9692,GATEWAY ELEMENTARY SCHOOL,1ST,0,0,1,7,57,65,8,12%
3020,WOODLAND PARK RE-2,9692,GATEWAY ELEMENTARY SCHOOL,2ND,0,0,0,3,47,50,3,6%
3020,WOODLAND PARK RE-2,9692,GATEWAY ELEMENTARY SCHOOL,3RD,0,0,1,6,37,44,7,16%
3020,WOODLAND PARK RE-2,9692,GATEWAY ELEMENTARY SCHOOL,4TH,0,2,2,3,51,58,7,12%
3020,WOODLAND PARK RE-2,9692,GATEWAY ELEMENTARY SCHOOL,5TH,0,1,0,4,54,59,5,8%
3020,WOODLAND PARK RE-2,9692,GATEWAY ELEMENTARY SCHOOL,SCHOOL TOTAL,1,4,4,32,345,386,41,11%
3020,WOODLAND PARK RE-2,9694,WOODLAND PARK MIDDLE SCHOOL,6TH,2,2,3,21,167,195,28,14%
3020,WOODLAND PARK RE-2,9694,WOODLAND PARK MIDDLE SCHOOL,7TH,1,4,0,14,218,237,19,8%
3020,WOODLAND PARK RE-2,9694,WOODLAND PARK MIDDLE SCHOOL,8TH,4,4,2,16,205,231,26,11%
3020,WOODLAND PARK RE-2,9694,WOODLAND PARK MIDDLE SCHOOL,SCHOOL TOTAL,7,10,5,51,590,663,73,11%
3020,WOODLAND PARK RE-2,9696,WOODLAND PARK HIGH SCHOOL,9TH,4,0,4,18,212,238,26,11%
3020,WOODLAND PARK RE-2,9696,WOODLAND PARK HIGH SCHOOL,10TH,0,5,2,11,219,237,18,8%
3020,WOODLAND PARK RE-2,9696,WOODLAND PARK HIGH SCHOOL,11TH,3,3,3,15,207,231,24,10%
3020,WOODLAND PARK RE-2,9696,WOODLAND PARK HIGH SCHOOL,12TH,5,4,6,20,206,241,35,15%
3020,WOODLAND PARK RE-2,9696,WOODLAND PARK HIGH SCHOOL,SCHOOL TOTAL,12,12,15,64,844,947,103,11%
3020,WOODLAND PARK RE-2,9698,COLUMBINE ELEMENTARY SCHOOL,PK,1,0,0,2,23,26,3,12%
3020,WOODLAND PARK RE-2,9698,COLUMBINE ELEMENTARY SCHOOL,KINDERGARTEN,0,2,0,1,34,37,3,8%
3020,WOODLAND PARK RE-2,9698,COLUMBINE ELEMENTARY SCHOOL,1ST,0,1,1,6,47,55,8,15%
3020,WOODLAND PARK RE-2,9698,COLUMBINE ELEMENTARY SCHOOL,2ND,0,1,1,3,39,44,5,11%
3020,WOODLAND PARK RE-2,9698,COLUMBINE ELEMENTARY SCHOOL,3RD,0,0,0,2,56,58,2,3%
3020,WOODLAND PARK RE-2,9698,COLUMBINE ELEMENTARY SCHOOL,4TH,0,2,1,4,59,66,7,11%
3020,WOODLAND PARK RE-2,9698,COLUMBINE ELEMENTARY SCHOOL,5TH,0,1,0,4,59,64,5,8%
3020,WOODLAND PARK RE-2,9698,COLUMBINE ELEMENTARY SCHOOL,SCHOOL TOTAL,1,7,3,22,317,350,33,9%
3020,WOODLAND PARK RE-2,,DISTRICT TOTAL,,26,39,31,209,2492,2797,305,11%
3030,AKRON R-1,0086,AKRON ELEMENTARY SCHOOL,PK,0,0,0,2,12,14,2,14%
3030,AKRON R-1,0086,AKRON ELEMENTARY SCHOOL,HALF DAY K,0,0,0,0,1,1,0,0%
3030,AKRON R-1,0086,AKRON ELEMENTARY SCHOOL,KINDERGARTEN,0,0,0,4,20,24,4,17%
3030,AKRON R-1,0086,AKRON ELEMENTARY SCHOOL,1ST,0,0,0,4,22,26,4,15%
3030,AKRON R-1,0086,AKRON ELEMENTARY SCHOOL,2ND,0,0,0,3,13,16,3,19%
3030,AKRON R-1,0086,AKRON ELEMENTARY SCHOOL,3RD,0,1,1,4,31,37,6,16%
3030,AKRON R-1,0086,AKRON ELEMENTARY SCHOOL,4TH,0,0,0,1,27,28,1,4%
3030,AKRON R-1,0086,AKRON ELEMENTARY SCHOOL,5TH,1,0,1,6,29,37,8,22%
3030,AKRON R-1,0086,AKRON ELEMENTARY SCHOOL,6TH,0,0,1,6,16,23,7,30%
3030,AKRON R-1,0086,AKRON ELEMENTARY SCHOOL,7TH,0,0,0,2,26,28,2,7%
3030,AKRON R-1,0086,AKRON ELEMENTARY SCHOOL,8TH,0,0,0,9,17,26,9,35%
3030,AKRON R-1,0086,AKRON ELEMENTARY SCHOOL,SCHOOL TOTAL,1,1,3,41,214,260,46,18%
3030,AKRON R-1,0090,AKRON HIGH SCHOOL,9TH,0,0,0,2,28,30,2,7%
3030,AKRON R-1,0090,AKRON HIGH SCHOOL,10TH,0,0,0,3,28,31,3,10%
3030,AKRON R-1,0090,AKRON HIGH SCHOOL,11TH,1,0,0,3,28,32,4,13%
3030,AKRON R-1,0090,AKRON HIGH SCHOOL,12TH,0,0,0,3,28,31,3,10%
3030,AKRON R-1,0090,AKRON HIGH SCHOOL,SCHOOL TOTAL,1,0,0,11,112,124,12,10%
3030,AKRON R-1,,DISTRICT TOTAL,,2,1,3,52,326,384,58,15%
3040,ARICKAREE R-2,0304,ARICKAREE ELEMENTARY SCHOOL,PK,0,0,0,2,5,7,2,29%
3040,ARICKAREE R-2,0304,ARICKAREE ELEMENTARY SCHOOL,KINDERGARTEN,0,1,0,3,11,15,4,27%
3040,ARICKAREE R-2,0304,ARICKAREE ELEMENTARY SCHOOL,1ST,0,0,0,4,3,7,4,57%
3040,ARICKAREE R-2,0304,ARICKAREE ELEMENTARY SCHOOL,2ND,0,0,0,3,10,13,3,23%
3040,ARICKAREE R-2,0304,ARICKAREE ELEMENTARY SCHOOL,3RD,0,0,0,1,8,9,1,11%
3040,ARICKAREE R-2,0304,ARICKAREE ELEMENTARY SCHOOL,4TH,0,0,0,0,5,5,0,0%
3040,ARICKAREE R-2,0304,ARICKAREE ELEMENTARY SCHOOL,5TH,0,0,0,4,9,13,4,31%
3040,ARICKAREE R-2,0304,ARICKAREE ELEMENTARY SCHOOL,6TH,0,0,0,3,11,14,3,21%
3040,ARICKAREE R-2,0304,ARICKAREE ELEMENTARY SCHOOL,SCHOOL TOTAL,0,1,0,20,62,83,21,25%
3040,ARICKAREE R-2,0308,ARICKAREE UNDIVIDED HIGH SCHOOL,7TH,0,0,0,0,7,7,0,0%
3040,ARICKAREE R-2,0308,ARICKAREE UNDIVIDED HIGH SCHOOL,8TH,0,0,0,1,7,8,1,13%
3040,ARICKAREE R-2,0308,ARICKAREE UNDIVIDED HIGH SCHOOL,9TH,0,0,0,2,5,7,2,29%
3040,ARICKAREE R-2,0308,ARICKAREE UNDIVIDED HIGH SCHOOL,10TH,0,0,0,0,2,2,0,0%
3040,ARICKAREE R-2,0308,ARICKAREE UNDIVIDED HIGH SCHOOL,11TH,0,0,0,0,3,3,0,0%
3040,ARICKAREE R-2,0308,ARICKAREE UNDIVIDED HIGH SCHOOL,12TH,0,0,0,0,3,3,0,0%
3040,ARICKAREE R-2,0308,ARICKAREE UNDIVIDED HIGH SCHOOL,SCHOOL TOTAL,0,0,0,3,27,30,3,10%
3040,ARICKAREE R-2,,DISTRICT TOTAL,,0,1,0,23,89,113,24,21%
3050,OTIS R-3,6582,OTIS ELEMENTARY SCHOOL,PK,0,0,0,1,15,16,1,6%
3050,OTIS R-3,6582,OTIS ELEMENTARY SCHOOL,KINDERGARTEN,0,0,0,1,10,11,1,9%
3050,OTIS R-3,6582,OTIS ELEMENTARY SCHOOL,1ST,0,0,0,0,17,17,0,0%
3050,OTIS R-3,6582,OTIS ELEMENTARY SCHOOL,2ND,0,0,0,0,9,9,0,0%
3050,OTIS R-3,6582,OTIS ELEMENTARY SCHOOL,3RD,0,0,0,2,15,17,2,12%
3050,OTIS R-3,6582,OTIS ELEMENTARY SCHOOL,4TH,0,0,0,0,9,9,0,0%
3050,OTIS R-3,6582,OTIS ELEMENTARY SCHOOL,5TH,0,0,0,2,13,15,2,13%
3050,OTIS R-3,6582,OTIS ELEMENTARY SCHOOL,6TH,0,0,0,1,12,13,1,8%
3050,OTIS R-3,6582,OTIS ELEMENTARY SCHOOL,SCHOOL TOTAL,0,0,0,7,100,107,7,7%
3050,OTIS R-3,6586,OTIS JUNIOR-SENIOR HIGH SCHOOL,7TH,0,0,0,0,8,8,0,0%
3050,OTIS R-3,6586,OTIS JUNIOR-SENIOR HIGH SCHOOL,8TH,0,0,0,0,14,14,0,0%
3050,OTIS R-3,6586,OTIS JUNIOR-SENIOR HIGH SCHOOL,9TH,0,0,0,0,12,12,0,0%
3050,OTIS R-3,6586,OTIS JUNIOR-SENIOR HIGH SCHOOL,10TH,0,0,0,0,20,20,0,0%
3050,OTIS R-3,6586,OTIS JUNIOR-SENIOR HIGH SCHOOL,11TH,0,0,0,0,19,19,0,0%
3050,OTIS R-3,6586,OTIS JUNIOR-SENIOR HIGH SCHOOL,12TH,0,0,0,1,20,21,1,5%
3050,OTIS R-3,6586,OTIS JUNIOR-SENIOR HIGH SCHOOL,SCHOOL TOTAL,0,0,0,1,93,94,1,1%
3050,OTIS R-3,,DISTRICT TOTAL,,0,0,0,8,193,201,8,4%
3060,LONE STAR 101,5238,LONE STAR MIDDLE SCHOOL,5TH,0,0,0,1,9,10,1,10%
3060,LONE STAR 101,5238,LONE STAR MIDDLE SCHOOL,6TH,0,0,1,0,6,7,1,14%
3060,LONE STAR 101,5238,LONE STAR MIDDLE SCHOOL,7TH,0,0,0,1,14,15,1,7%
3060,LONE STAR 101,5238,LONE STAR MIDDLE SCHOOL,8TH,0,0,0,1,7,8,1,13%
3060,LONE STAR 101,5238,LONE STAR MIDDLE SCHOOL,SCHOOL TOTAL,0,0,1,3,36,40,4,10%
3060,LONE STAR 101,5254,LONE STAR ELEMENTARY SCHOOL,KINDERGARTEN,0,0,0,1,12,13,1,8%
3060,LONE STAR 101,5254,LONE STAR ELEMENTARY SCHOOL,1ST,0,0,0,1,11,12,1,8%
3060,LONE STAR 101,5254,LONE STAR ELEMENTARY SCHOOL,2ND,0,0,0,0,5,5,0,0%
3060,LONE STAR 101,5254,LONE STAR ELEMENTARY SCHOOL,3RD,0,0,0,0,5,5,0,0%
3060,LONE STAR 101,5254,LONE STAR ELEMENTARY SCHOOL,4TH,0,0,0,1,10,11,1,9%
3060,LONE STAR 101,5254,LONE STAR ELEMENTARY SCHOOL,SCHOOL TOTAL,0,0,0,3,43,46,3,7%
3060,LONE STAR 101,5258,LONE STAR UNDIVIDED HIGH SCHOOL,9TH,0,0,0,0,5,5,0,0%
3060,LONE STAR 101,5258,LONE STAR UNDIVIDED HIGH SCHOOL,10TH,0,0,0,0,5,5,0,0%
3060,LONE STAR 101,5258,LONE STAR UNDIVIDED HIGH SCHOOL,11TH,0,0,0,0,13,13,0,0%
3060,LONE STAR 101,5258,LONE STAR UNDIVIDED HIGH SCHOOL,12TH,0,0,0,0,9,9,0,0%
3060,LONE STAR 101,5258,LONE STAR UNDIVIDED HIGH SCHOOL,SCHOOL TOTAL,0,0,0,0,32,32,0,0%
3060,LONE STAR 101,,DISTRICT TOTAL,,0,0,1,6,111,118,7,6%
3070,WOODLIN R-104,9700,WOODLIN ELEMENTARY SCHOOL,PK,0,0,0,3,8,11,3,27%
3070,WOODLIN R-104,9700,WOODLIN ELEMENTARY SCHOOL,KINDERGARTEN,0,0,0,0,8,8,0,0%
3070,WOODLIN R-104,9700,WOODLIN ELEMENTARY SCHOOL,1ST,0,0,0,0,8,8,0,0%
3070,WOODLIN R-104,9700,WOODLIN ELEMENTARY SCHOOL,2ND,0,0,0,0,6,6,0,0%
3070,WOODLIN R-104,9700,WOODLIN ELEMENTARY SCHOOL,3RD,0,0,0,2,8,10,2,20%
3070,WOODLIN R-104,9700,WOODLIN ELEMENTARY SCHOOL,4TH,0,0,0,1,6,7,1,14%
3070,WOODLIN R-104,9700,WOODLIN ELEMENTARY SCHOOL,5TH,0,0,0,0,2,2,0,0%
3070,WOODLIN R-104,9700,WOODLIN ELEMENTARY SCHOOL,6TH,0,0,0,0,7,7,0,0%
3070,WOODLIN R-104,9700,WOODLIN ELEMENTARY SCHOOL,SCHOOL TOTAL,0,0,0,6,53,59,6,10%
3070,WOODLIN R-104,9704,WOODLIN UNDIVIDED HIGH SCHOOL,7TH,0,0,0,0,4,4,0,0%
3070,WOODLIN R-104,9704,WOODLIN UNDIVIDED HIGH SCHOOL,8TH,0,0,0,0,7,7,0,0%
3070,WOODLIN R-104,9704,WOODLIN UNDIVIDED HIGH SCHOOL,9TH,0,0,0,1,7,8,1,13%
3070,WOODLIN R-104,9704,WOODLIN UNDIVIDED HIGH SCHOOL,10TH,0,0,1,1,8,10,2,20%
3070,WOODLIN R-104,9704,WOODLIN UNDIVIDED HIGH SCHOOL,11TH,0,0,0,0,10,10,0,0%
3070,WOODLIN R-104,9704,WOODLIN UNDIVIDED HIGH SCHOOL,12TH,0,0,0,1,6,7,1,14%
3070,WOODLIN R-104,9704,WOODLIN UNDIVIDED HIGH SCHOOL,SCHOOL TOTAL,0,0,1,3,42,46,4,9%
3070,WOODLIN R-104,,DISTRICT TOTAL,,0,0,1,9,95,105,10,10%
3080,WELD COUNTY RE-1,3398,GILCREST ELEMENTARY SCHOOL,KINDERGARTEN,1,1,1,24,16,43,27,63%
3080,WELD COUNTY RE-1,3398,GILCREST ELEMENTARY SCHOOL,1ST,0,0,0,17,12,29,17,59%
3080,WELD COUNTY RE-1,3398,GILCREST ELEMENTARY SCHOOL,2ND,0,0,0,25,13,38,25,66%
3080,WELD COUNTY RE-1,3398,GILCREST ELEMENTARY SCHOOL,3RD,2,0,0,20,17,39,22,56%
3080,WELD COUNTY RE-1,3398,GILCREST ELEMENTARY SCHOOL,4TH,0,1,0,21,13,35,22,63%
3080,WELD COUNTY RE-1,3398,GILCREST ELEMENTARY SCHOOL,5TH,0,0,0,22,17,39,22,56%
3080,WELD COUNTY RE-1,3398,GILCREST ELEMENTARY SCHOOL,SCHOOL TOTAL,3,2,1,129,88,223,135,61%
3080,WELD COUNTY RE-1,4852,PETE MIRICH ELEMENTARY SCHOOL,KINDERGARTEN,0,1,0,20,23,44,21,48%
3080,WELD COUNTY RE-1,4852,PETE MIRICH ELEMENTARY SCHOOL,1ST,1,1,0,13,22,37,15,41%
3080,WELD COUNTY RE-1,4852,PETE MIRICH ELEMENTARY SCHOOL,2ND,1,0,0,17,23,41,18,44%
3080,WELD COUNTY RE-1,4852,PETE MIRICH ELEMENTARY SCHOOL,3RD,1,0,0,26,24,51,27,53%
3080,WELD COUNTY RE-1,4852,PETE MIRICH ELEMENTARY SCHOOL,4TH,1,1,0,19,29,50,21,42%
3080,WELD COUNTY RE-1,4852,PETE MIRICH ELEMENTARY SCHOOL,5TH,0,0,0,20,28,48,20,42%
3080,WELD COUNTY RE-1,4852,PETE MIRICH ELEMENTARY SCHOOL,SCHOOL TOTAL,4,3,0,115,149,271,122,45%
3080,WELD COUNTY RE-1,4854,NORTH VALLEY MIDDLE SCHOOL,6TH,0,0,1,30,35,66,31,47%
3080,WELD COUNTY RE-1,4854,NORTH VALLEY MIDDLE SCHOOL,7TH,0,0,1,39,35,75,40,53%
3080,WELD COUNTY RE-1,4854,NORTH VALLEY MIDDLE SCHOOL,8TH,1,0,0,37,33,71,38,54%
3080,WELD COUNTY RE-1,4854,NORTH VALLEY MIDDLE SCHOOL,SCHOOL TOTAL,1,0,2,106,103,212,109,51%
3080,WELD COUNTY RE-1,7056,PLATTEVILLE ELEMENTARY SCHOOL,KINDERGARTEN,0,3,0,33,24,60,36,60%
3080,WELD COUNTY RE-1,7056,PLATTEVILLE ELEMENTARY SCHOOL,1ST,0,0,0,26,22,48,26,54%
3080,WELD COUNTY RE-1,7056,PLATTEVILLE ELEMENTARY SCHOOL,2ND,0,0,0,20,22,42,20,48%
3080,WELD COUNTY RE-1,7056,PLATTEVILLE ELEMENTARY SCHOOL,3RD,0,1,0,37,29,67,38,57%
3080,WELD COUNTY RE-1,7056,PLATTEVILLE ELEMENTARY SCHOOL,4TH,1,0,1,28,28,58,30,52%
3080,WELD COUNTY RE-1,7056,PLATTEVILLE ELEMENTARY SCHOOL,5TH,0,0,0,24,28,52,24,46%
3080,WELD COUNTY RE-1,7056,PLATTEVILLE ELEMENTARY SCHOOL,SCHOOL TOTAL,1,4,1,168,153,327,174,53%
3080,WELD COUNTY RE-1,7058,SOUTH VALLEY MIDDLE SCHOOL,6TH,0,2,0,34,35,71,36,51%
3080,WELD COUNTY RE-1,7058,SOUTH VALLEY MIDDLE SCHOOL,7TH,1,0,0,34,31,66,35,53%
3080,WELD COUNTY RE-1,7058,SOUTH VALLEY MIDDLE SCHOOL,8TH,0,1,1,34,27,63,36,57%
3080,WELD COUNTY RE-1,7058,SOUTH VALLEY MIDDLE SCHOOL,SCHOOL TOTAL,1,3,1,102,93,200,107,54%
3080,WELD COUNTY RE-1,9032,VALLEY HIGH SCHOOL,9TH,1,0,2,68,74,145,71,49%
3080,WELD COUNTY RE-1,9032,VALLEY HIGH SCHOOL,10TH,1,3,1,69,67,141,74,52%
3080,WELD COUNTY RE-1,9032,VALLEY HIGH SCHOOL,11TH,0,2,0,70,79,151,72,48%
3080,WELD COUNTY RE-1,9032,VALLEY HIGH SCHOOL,12TH,1,0,0,52,61,114,53,46%
3080,WELD COUNTY RE-1,9032,VALLEY HIGH SCHOOL,SCHOOL TOTAL,3,5,3,259,281,551,270,49%
3080,WELD COUNTY RE-1,,DISTRICT TOTAL,,13,17,8,879,867,1784,917,51%
3085,EATON RE-2,0754,BENJAMIN EATON ELEMENTARY SCHOOL,3RD,2,3,2,26,73,106,33,31%
3085,EATON RE-2,0754,BENJAMIN EATON ELEMENTARY SCHOOL,4TH,2,2,2,19,82,107,25,23%
3085,EATON RE-2,0754,BENJAMIN EATON ELEMENTARY SCHOOL,5TH,0,0,1,23,79,103,24,23%
3085,EATON RE-2,0754,BENJAMIN EATON ELEMENTARY SCHOOL,SCHOOL TOTAL,4,5,5,68,234,316,82,26%
3085,EATON RE-2,2448,EATON ELEMENTARY SCHOOL,KINDERGARTEN,0,5,0,25,90,120,30,25%
3085,EATON RE-2,2448,EATON ELEMENTARY SCHOOL,1ST,0,0,2,23,87,112,25,22%
3085,EATON RE-2,2448,EATON ELEMENTARY SCHOOL,2ND,0,0,0,21,90,111,21,19%
3085,EATON RE-2,2448,EATON ELEMENTARY SCHOOL,SCHOOL TOTAL,0,5,2,69,267,343,76,22%
3085,EATON RE-2,2452,EATON MIDDLE SCHOOL,6TH,0,0,1,25,100,126,26,21%
3085,EATON RE-2,2452,EATON MIDDLE SCHOOL,7TH,2,0,1,30,113,146,33,23%
3085,EATON RE-2,2452,EATON MIDDLE SCHOOL,8TH,0,1,1,28,116,146,30,21%
3085,EATON RE-2,2452,EATON MIDDLE SCHOOL,SCHOOL TOTAL,2,1,3,83,329,418,89,21%
3085,EATON RE-2,2456,EATON HIGH SCHOOL,9TH,0,1,1,29,104,135,31,23%
3085,EATON RE-2,2456,EATON HIGH SCHOOL,10TH,0,0,0,28,86,114,28,25%
3085,EATON RE-2,2456,EATON HIGH SCHOOL,11TH,0,0,1,23,106,130,24,18%
3085,EATON RE-2,2456,EATON HIGH SCHOOL,12TH,0,0,1,28,86,115,29,25%
3085,EATON RE-2,2456,EATON HIGH SCHOOL,SCHOOL TOTAL,0,1,3,108,382,494,112,23%
3085,EATON RE-2,3286,GALETON ELEMENTARY SCHOOL,KINDERGARTEN,0,0,0,10,25,35,10,29%
3085,EATON RE-2,3286,GALETON ELEMENTARY SCHOOL,1ST,0,0,0,2,15,17,2,12%
3085,EATON RE-2,3286,GALETON ELEMENTARY SCHOOL,2ND,0,0,1,6,14,21,7,33%
3085,EATON RE-2,3286,GALETON ELEMENTARY SCHOOL,3RD,0,0,0,4,15,19,4,21%
3085,EATON RE-2,3286,GALETON ELEMENTARY SCHOOL,4TH,0,0,1,7,16,24,8,33%
3085,EATON RE-2,3286,GALETON ELEMENTARY SCHOOL,5TH,0,0,0,5,13,18,5,28%
3085,EATON RE-2,3286,GALETON ELEMENTARY SCHOOL,SCHOOL TOTAL,0,0,2,34,98,134,36,27%
3085,EATON RE-2,,DISTRICT TOTAL,,6,12,15,362,1310,1705,395,23%
3090,KEENESBURG RE-3(J),1299,CARDINAL COMMUNITY ACADEMY CHARTER SCHOOL,HALF DAY K,0,0,1,0,17,18,1,6%
3090,KEENESBURG RE-3(J),1299,CARDINAL COMMUNITY ACADEMY CHARTER SCHOOL,1ST,0,0,1,0,12,13,1,8%
3090,KEENESBURG RE-3(J),1299,CARDINAL COMMUNITY ACADEMY CHARTER SCHOOL,2ND,1,0,0,0,19,20,1,5%
3090,KEENESBURG RE-3(J),1299,CARDINAL COMMUNITY ACADEMY CHARTER SCHOOL,3RD,0,0,0,1,15,16,1,6%
3090,KEENESBURG RE-3(J),1299,CARDINAL COMMUNITY ACADEMY CHARTER SCHOOL,4TH,0,0,1,1,18,20,2,10%
3090,KEENESBURG RE-3(J),1299,CARDINAL COMMUNITY ACADEMY CHARTER SCHOOL,5TH,0,0,0,3,14,17,3,18%
3090,KEENESBURG RE-3(J),1299,CARDINAL COMMUNITY ACADEMY CHARTER SCHOOL,6TH,0,0,0,2,16,18,2,11%
3090,KEENESBURG RE-3(J),1299,CARDINAL COMMUNITY ACADEMY CHARTER SCHOOL,7TH,0,1,0,0,4,5,1,20%
3090,KEENESBURG RE-3(J),1299,CARDINAL COMMUNITY ACADEMY CHARTER SCHOOL,8TH,0,0,0,0,8,8,0,0%
3090,KEENESBURG RE-3(J),1299,CARDINAL COMMUNITY ACADEMY CHARTER SCHOOL,SCHOOL TOTAL,1,1,3,7,123,135,12,9%
3090,KEENESBURG RE-3(J),1446,WELD CENTRAL SENIOR HIGH SCHOOL,9TH,2,1,2,51,97,153,56,37%
3090,KEENESBURG RE-3(J),1446,WELD CENTRAL SENIOR HIGH SCHOOL,10TH,1,1,0,44,122,168,46,27%
3090,KEENESBURG RE-3(J),1446,WELD CENTRAL SENIOR HIGH SCHOOL,11TH,3,0,1,45,98,147,49,33%
3090,KEENESBURG RE-3(J),1446,WELD CENTRAL SENIOR HIGH SCHOOL,12TH,1,1,1,35,89,127,38,30%
3090,KEENESBURG RE-3(J),1446,WELD CENTRAL SENIOR HIGH SCHOOL,SCHOOL TOTAL,7,3,4,175,406,595,189,32%
3090,KEENESBURG RE-3(J),3090,LOCHBUIE ELEMENTARY SCHOOL,PK,7,0,3,17,18,45,27,60%
3090,KEENESBURG RE-3(J),3090,LOCHBUIE ELEMENTARY SCHOOL,HALF DAY K,1,0,0,10,20,31,11,35%
3090,KEENESBURG RE-3(J),3090,LOCHBUIE ELEMENTARY SCHOOL,KINDERGARTEN,0,0,0,10,8,18,10,56%
3090,KEENESBURG RE-3(J),3090,LOCHBUIE ELEMENTARY SCHOOL,1ST,0,2,3,32,42,79,37,47%
3090,KEENESBURG RE-3(J),3090,LOCHBUIE ELEMENTARY SCHOOL,2ND,1,1,3,19,30,54,24,44%
3090,KEENESBURG RE-3(J),3090,LOCHBUIE ELEMENTARY SCHOOL,3RD,1,1,2,26,30,60,30,50%
3090,KEENESBURG RE-3(J),3090,LOCHBUIE ELEMENTARY SCHOOL,4TH,1,0,4,27,34,66,32,48%
3090,KEENESBURG RE-3(J),3090,LOCHBUIE ELEMENTARY SCHOOL,5TH,1,1,0,30,36,68,32,47%
3090,KEENESBURG RE-3(J),3090,LOCHBUIE ELEMENTARY SCHOOL,6TH,0,0,1,18,26,45,19,42%
3090,KEENESBURG RE-3(J),3090,LOCHBUIE ELEMENTARY SCHOOL,SCHOOL TOTAL,12,5,16,189,244,466,222,48%
3090,KEENESBURG RE-3(J),4148,HUDSON ELEMENTARY SCHOOL,PK,0,0,0,3,9,12,3,25%
3090,KEENESBURG RE-3(J),4148,HUDSON ELEMENTARY SCHOOL,HALF DAY K,0,1,0,9,16,26,10,38%
3090,KEENESBURG RE-3(J),4148,HUDSON ELEMENTARY SCHOOL,KINDERGARTEN,0,0,2,7,6,15,9,60%
3090,KEENESBURG RE-3(J),4148,HUDSON ELEMENTARY SCHOOL,1ST,0,0,0,16,14,30,16,53%
3090,KEENESBURG RE-3(J),4148,HUDSON ELEMENTARY SCHOOL,2ND,0,0,0,21,21,42,21,50%
3090,KEENESBURG RE-3(J),4148,HUDSON ELEMENTARY SCHOOL,3RD,0,1,1,13,21,36,15,42%
3090,KEENESBURG RE-3(J),4148,HUDSON ELEMENTARY SCHOOL,4TH,0,0,1,19,20,40,20,50%
3090,KEENESBURG RE-3(J),4148,HUDSON ELEMENTARY SCHOOL,5TH,1,0,1,15,30,47,17,36%
3090,KEENESBURG RE-3(J),4148,HUDSON ELEMENTARY SCHOOL,6TH,0,2,0,26,21,49,28,57%
3090,KEENESBURG RE-3(J),4148,HUDSON ELEMENTARY SCHOOL,SCHOOL TOTAL,1,4,5,129,158,297,139,47%
3090,KEENESBURG RE-3(J),4526,HOFF ELEMENTARY SCHOOL,PK,0,0,0,11,18,29,11,38%
3090,KEENESBURG RE-3(J),4526,HOFF ELEMENTARY SCHOOL,HALF DAY K,0,0,0,4,29,33,4,12%
3090,KEENESBURG RE-3(J),4526,HOFF ELEMENTARY SCHOOL,KINDERGARTEN,0,0,0,5,8,13,5,38%
3090,KEENESBURG RE-3(J),4526,HOFF ELEMENTARY SCHOOL,1ST,1,0,0,8,34,43,9,21%
3090,KEENESBURG RE-3(J),4526,HOFF ELEMENTARY SCHOOL,2ND,0,1,0,13,28,42,14,33%
3090,KEENESBURG RE-3(J),4526,HOFF ELEMENTARY SCHOOL,3RD,0,0,0,11,30,41,11,27%
3090,KEENESBURG RE-3(J),4526,HOFF ELEMENTARY SCHOOL,4TH,0,1,0,14,36,51,15,29%
3090,KEENESBURG RE-3(J),4526,HOFF ELEMENTARY SCHOOL,5TH,1,0,0,13,34,48,14,29%
3090,KEENESBURG RE-3(J),4526,HOFF ELEMENTARY SCHOOL,6TH,0,0,0,7,41,48,7,15%
3090,KEENESBURG RE-3(J),4526,HOFF ELEMENTARY SCHOOL,SCHOOL TOTAL,2,2,0,86,258,348,90,26%
3090,KEENESBURG RE-3(J),9347,WELD CENTRAL JUNIOR HIGH SCHOOL,7TH,0,1,0,53,98,152,54,36%
3090,KEENESBURG RE-3(J),9347,WELD CENTRAL JUNIOR HIGH SCHOOL,8TH,1,1,1,53,100,156,56,36%
3090,KEENESBURG RE-3(J),9347,WELD CENTRAL JUNIOR HIGH SCHOOL,SCHOOL TOTAL,1,2,1,106,198,308,110,36%
3090,KEENESBURG RE-3(J),,DISTRICT TOTAL,,24,17,29,692,1387,2149,762,35%
3100,WINDSOR RE-4,0055,GRANDVIEW ELEMENTARY SCHOOL,PK,0,1,0,2,21,24,3,13%
3100,WINDSOR RE-4,0055,GRANDVIEW ELEMENTARY SCHOOL,HALF DAY K,0,0,0,2,23,25,2,8%
3100,WINDSOR RE-4,0055,GRANDVIEW ELEMENTARY SCHOOL,KINDERGARTEN,1,0,1,3,57,62,5,8%
3100,WINDSOR RE-4,0055,GRANDVIEW ELEMENTARY SCHOOL,1ST,0,1,0,13,73,87,14,16%
3100,WINDSOR RE-4,0055,GRANDVIEW ELEMENTARY SCHOOL,2ND,1,3,1,10,73,88,15,17%
3100,WINDSOR RE-4,0055,GRANDVIEW ELEMENTARY SCHOOL,3RD,1,0,0,13,77,91,14,15%
3100,WINDSOR RE-4,0055,GRANDVIEW ELEMENTARY SCHOOL,4TH,0,3,0,10,75,88,13,15%
3100,WINDSOR RE-4,0055,GRANDVIEW ELEMENTARY SCHOOL,5TH,0,1,0,13,57,71,14,20%
3100,WINDSOR RE-4,0055,GRANDVIEW ELEMENTARY SCHOOL,SCHOOL TOTAL,3,9,2,66,456,536,80,15%
3100,WINDSOR RE-4,6750,MOUNTAIN VIEW ELEMENTARY SCHOOL,3RD,3,2,1,15,110,131,21,16%
3100,WINDSOR RE-4,6750,MOUNTAIN VIEW ELEMENTARY SCHOOL,4TH,1,0,0,21,97,119,22,18%
3100,WINDSOR RE-4,6750,MOUNTAIN VIEW ELEMENTARY SCHOOL,5TH,3,4,1,22,113,143,30,21%
3100,WINDSOR RE-4,6750,MOUNTAIN VIEW ELEMENTARY SCHOOL,SCHOOL TOTAL,7,6,2,58,320,393,73,19%
3100,WINDSOR RE-4,7755,SEVERANCE MIDDLE SCHOOL,6TH,0,0,0,15,69,84,15,18%
3100,WINDSOR RE-4,7755,SEVERANCE MIDDLE SCHOOL,7TH,2,4,1,10,76,93,17,18%
3100,WINDSOR RE-4,7755,SEVERANCE MIDDLE SCHOOL,8TH,0,1,0,15,70,86,16,19%
3100,WINDSOR RE-4,7755,SEVERANCE MIDDLE SCHOOL,SCHOOL TOTAL,2,5,1,40,215,263,48,18%
3100,WINDSOR RE-4,7958,SKYVIEW ELEMENTARY SCHOOL,PK,2,1,0,10,29,42,13,31%
3100,WINDSOR RE-4,7958,SKYVIEW ELEMENTARY SCHOOL,HALF DAY K,0,0,0,3,19,22,3,14%
3100,WINDSOR RE-4,7958,SKYVIEW ELEMENTARY SCHOOL,KINDERGARTEN,0,0,0,4,19,23,4,17%
3100,WINDSOR RE-4,7958,SKYVIEW ELEMENTARY SCHOOL,1ST,0,2,0,10,55,67,12,18%
3100,WINDSOR RE-4,7958,SKYVIEW ELEMENTARY SCHOOL,2ND,0,2,1,4,60,67,7,10%
3100,WINDSOR RE-4,7958,SKYVIEW ELEMENTARY SCHOOL,3RD,1,1,0,6,60,68,8,12%
3100,WINDSOR RE-4,7958,SKYVIEW ELEMENTARY SCHOOL,4TH,0,3,1,6,47,57,10,18%
3100,WINDSOR RE-4,7958,SKYVIEW ELEMENTARY SCHOOL,5TH,1,1,1,6,62,71,9,13%
3100,WINDSOR RE-4,7958,SKYVIEW ELEMENTARY SCHOOL,SCHOOL TOTAL,4,10,3,49,351,417,66,16%
3100,WINDSOR RE-4,8886,TOZER ELEMENTARY SCHOOL,PK,0,0,0,15,38,53,15,28%
3100,WINDSOR RE-4,8886,TOZER ELEMENTARY SCHOOL,HALF DAY K,1,0,0,12,47,60,13,22%
3100,WINDSOR RE-4,8886,TOZER ELEMENTARY SCHOOL,KINDERGARTEN,0,0,0,13,61,74,13,18%
3100,WINDSOR RE-4,8886,TOZER ELEMENTARY SCHOOL,1ST,2,3,1,21,115,142,27,19%
3100,WINDSOR RE-4,8886,TOZER ELEMENTARY SCHOOL,2ND,0,0,0,25,104,129,25,19%
3100,WINDSOR RE-4,8886,TOZER ELEMENTARY SCHOOL,SCHOOL TOTAL,3,3,1,86,365,458,93,20%
3100,WINDSOR RE-4,9665,WINDSOR CHARTER ACADEMY,HALF DAY K,1,4,0,1,26,32,6,19%
3100,WINDSOR RE-4,9665,WINDSOR CHARTER ACADEMY,KINDERGARTEN,0,0,0,2,16,18,2,11%
3100,WINDSOR RE-4,9665,WINDSOR CHARTER ACADEMY,1ST,1,1,1,2,46,51,5,10%
3100,WINDSOR RE-4,9665,WINDSOR CHARTER ACADEMY,2ND,2,3,0,6,41,52,11,21%
3100,WINDSOR RE-4,9665,WINDSOR CHARTER ACADEMY,3RD,2,0,1,2,45,50,5,10%
3100,WINDSOR RE-4,9665,WINDSOR CHARTER ACADEMY,4TH,0,3,1,3,43,50,7,14%
3100,WINDSOR RE-4,9665,WINDSOR CHARTER ACADEMY,5TH,0,0,0,3,48,51,3,6%
3100,WINDSOR RE-4,9665,WINDSOR CHARTER ACADEMY,6TH,1,0,3,2,40,46,6,13%
3100,WINDSOR RE-4,9665,WINDSOR CHARTER ACADEMY,7TH,0,1,0,2,40,43,3,7%
3100,WINDSOR RE-4,9665,WINDSOR CHARTER ACADEMY,8TH,1,1,0,1,15,18,3,17%
3100,WINDSOR RE-4,9665,WINDSOR CHARTER ACADEMY,SCHOOL TOTAL,8,13,6,24,360,411,51,12%
3100,WINDSOR RE-4,9670,WINDSOR MIDDLE SCHOOL,6TH,1,4,0,20,154,179,25,14%
3100,WINDSOR RE-4,9670,WINDSOR MIDDLE SCHOOL,7TH,1,2,3,22,149,177,28,16%
3100,WINDSOR RE-4,9670,WINDSOR MIDDLE SCHOOL,8TH,3,4,3,17,150,177,27,15%
3100,WINDSOR RE-4,9670,WINDSOR MIDDLE SCHOOL,SCHOOL TOTAL,5,10,6,59,453,533,80,15%
3100,WINDSOR RE-4,9672,WINDSOR HIGH SCHOOL,9TH,3,4,2,32,254,295,41,14%
3100,WINDSOR RE-4,9672,WINDSOR HIGH SCHOOL,10TH,2,5,4,36,234,281,47,17%
3100,WINDSOR RE-4,9672,WINDSOR HIGH SCHOOL,11TH,1,8,2,30,212,253,41,16%
3100,WINDSOR RE-4,9672,WINDSOR HIGH SCHOOL,12TH,2,4,0,23,213,242,29,12%
3100,WINDSOR RE-4,9672,WINDSOR HIGH SCHOOL,SCHOOL TOTAL,8,21,8,121,913,1071,158,15%
3100,WINDSOR RE-4,,DISTRICT TOTAL,,40,77,29,503,3433,4082,649,16%
3110,JOHNSTOWN-MILLIKEN RE-5J,4785,KNOWLEDGE QUEST ACADEMY,HALF DAY K,0,1,1,2,37,41,4,10%
3110,JOHNSTOWN-MILLIKEN RE-5J,4785,KNOWLEDGE QUEST ACADEMY,KINDERGARTEN,0,0,0,1,4,5,1,20%
3110,JOHNSTOWN-MILLIKEN RE-5J,4785,KNOWLEDGE QUEST ACADEMY,1ST,1,1,0,5,39,46,7,15%
3110,JOHNSTOWN-MILLIKEN RE-5J,4785,KNOWLEDGE QUEST ACADEMY,2ND,0,1,1,8,38,48,10,21%
3110,JOHNSTOWN-MILLIKEN RE-5J,4785,KNOWLEDGE QUEST ACADEMY,3RD,0,1,1,5,41,48,7,15%
3110,JOHNSTOWN-MILLIKEN RE-5J,4785,KNOWLEDGE QUEST ACADEMY,4TH,0,0,2,6,23,31,8,26%
3110,JOHNSTOWN-MILLIKEN RE-5J,4785,KNOWLEDGE QUEST ACADEMY,5TH,0,0,0,11,36,47,11,23%
3110,JOHNSTOWN-MILLIKEN RE-5J,4785,KNOWLEDGE QUEST ACADEMY,6TH,1,0,1,9,26,37,11,30%
3110,JOHNSTOWN-MILLIKEN RE-5J,4785,KNOWLEDGE QUEST ACADEMY,7TH,0,0,0,8,23,31,8,26%
3110,JOHNSTOWN-MILLIKEN RE-5J,4785,KNOWLEDGE QUEST ACADEMY,8TH,0,0,1,5,17,23,6,26%
3110,JOHNSTOWN-MILLIKEN RE-5J,4785,KNOWLEDGE QUEST ACADEMY,SCHOOL TOTAL,2,4,7,60,284,357,73,20%
3110,JOHNSTOWN-MILLIKEN RE-5J,5078,LETFORD ELEMENTARY SCHOOL,PK,0,0,0,12,18,30,12,40%
3110,JOHNSTOWN-MILLIKEN RE-5J,5078,LETFORD ELEMENTARY SCHOOL,HALF DAY K,0,0,1,17,38,56,18,32%
3110,JOHNSTOWN-MILLIKEN RE-5J,5078,LETFORD ELEMENTARY SCHOOL,KINDERGARTEN,0,0,0,3,2,5,3,60%
3110,JOHNSTOWN-MILLIKEN RE-5J,5078,LETFORD ELEMENTARY SCHOOL,1ST,0,0,0,19,41,60,19,32%
3110,JOHNSTOWN-MILLIKEN RE-5J,5078,LETFORD ELEMENTARY SCHOOL,2ND,0,0,0,28,40,68,28,41%
3110,JOHNSTOWN-MILLIKEN RE-5J,5078,LETFORD ELEMENTARY SCHOOL,3RD,0,0,0,19,39,58,19,33%
3110,JOHNSTOWN-MILLIKEN RE-5J,5078,LETFORD ELEMENTARY SCHOOL,4TH,0,0,0,18,49,67,18,27%
3110,JOHNSTOWN-MILLIKEN RE-5J,5078,LETFORD ELEMENTARY SCHOOL,5TH,0,0,0,19,52,71,19,27%
3110,JOHNSTOWN-MILLIKEN RE-5J,5078,LETFORD ELEMENTARY SCHOOL,SCHOOL TOTAL,0,0,1,135,279,415,136,33%
3110,JOHNSTOWN-MILLIKEN RE-5J,5896,MILLIKEN ELEMENTARY SCHOOL,PK,0,2,2,38,57,99,42,42%
3110,JOHNSTOWN-MILLIKEN RE-5J,5896,MILLIKEN ELEMENTARY SCHOOL,HALF DAY K,0,0,0,48,38,86,48,56%
3110,JOHNSTOWN-MILLIKEN RE-5J,5896,MILLIKEN ELEMENTARY SCHOOL,KINDERGARTEN,0,0,0,8,1,9,8,89%
3110,JOHNSTOWN-MILLIKEN RE-5J,5896,MILLIKEN ELEMENTARY SCHOOL,1ST,0,0,0,25,51,76,25,33%
3110,JOHNSTOWN-MILLIKEN RE-5J,5896,MILLIKEN ELEMENTARY SCHOOL,2ND,0,1,0,40,57,98,41,42%
3110,JOHNSTOWN-MILLIKEN RE-5J,5896,MILLIKEN ELEMENTARY SCHOOL,3RD,0,0,0,31,35,66,31,47%
3110,JOHNSTOWN-MILLIKEN RE-5J,5896,MILLIKEN ELEMENTARY SCHOOL,4TH,0,0,0,27,36,63,27,43%
3110,JOHNSTOWN-MILLIKEN RE-5J,5896,MILLIKEN ELEMENTARY SCHOOL,5TH,0,0,0,32,31,63,32,51%
3110,JOHNSTOWN-MILLIKEN RE-5J,5896,MILLIKEN ELEMENTARY SCHOOL,SCHOOL TOTAL,0,3,2,249,306,560,254,45%
3110,JOHNSTOWN-MILLIKEN RE-5J,5902,MILLIKEN MIDDLE SCHOOL,6TH,1,1,2,73,125,202,77,38%
3110,JOHNSTOWN-MILLIKEN RE-5J,5902,MILLIKEN MIDDLE SCHOOL,7TH,0,2,0,68,127,197,70,36%
3110,JOHNSTOWN-MILLIKEN RE-5J,5902,MILLIKEN MIDDLE SCHOOL,8TH,1,0,1,64,133,199,66,33%
3110,JOHNSTOWN-MILLIKEN RE-5J,5902,MILLIKEN MIDDLE SCHOOL,SCHOOL TOTAL,2,3,3,205,385,598,213,36%
3110,JOHNSTOWN-MILLIKEN RE-5J,6963,PIONEER RIDGE ELEMENTARY SCHOOL,HALF DAY K,0,1,0,8,56,65,9,14%
3110,JOHNSTOWN-MILLIKEN RE-5J,6963,PIONEER RIDGE ELEMENTARY SCHOOL,KINDERGARTEN,0,0,0,3,6,9,3,33%
3110,JOHNSTOWN-MILLIKEN RE-5J,6963,PIONEER RIDGE ELEMENTARY SCHOOL,1ST,0,2,2,8,84,96,12,13%
3110,JOHNSTOWN-MILLIKEN RE-5J,6963,PIONEER RIDGE ELEMENTARY SCHOOL,2ND,0,0,0,13,63,76,13,17%
3110,JOHNSTOWN-MILLIKEN RE-5J,6963,PIONEER RIDGE ELEMENTARY SCHOOL,3RD,0,0,1,14,60,75,15,20%
3110,JOHNSTOWN-MILLIKEN RE-5J,6963,PIONEER RIDGE ELEMENTARY SCHOOL,4TH,0,0,0,16,63,79,16,20%
3110,JOHNSTOWN-MILLIKEN RE-5J,6963,PIONEER RIDGE ELEMENTARY SCHOOL,5TH,0,1,3,20,55,79,24,30%
3110,JOHNSTOWN-MILLIKEN RE-5J,6963,PIONEER RIDGE ELEMENTARY SCHOOL,SCHOOL TOTAL,0,4,6,82,387,479,92,19%
3110,JOHNSTOWN-MILLIKEN RE-5J,7490,ROOSEVELT HIGH SCHOOL,9TH,0,1,3,66,134,204,70,34%
3110,JOHNSTOWN-MILLIKEN RE-5J,7490,ROOSEVELT HIGH SCHOOL,10TH,0,0,5,67,133,205,72,35%
3110,JOHNSTOWN-MILLIKEN RE-5J,7490,ROOSEVELT HIGH SCHOOL,11TH,0,2,2,60,95,159,64,40%
3110,JOHNSTOWN-MILLIKEN RE-5J,7490,ROOSEVELT HIGH SCHOOL,12TH,0,1,1,46,111,159,48,30%
3110,JOHNSTOWN-MILLIKEN RE-5J,7490,ROOSEVELT HIGH SCHOOL,SCHOOL TOTAL,0,4,11,239,473,727,254,35%
3110,JOHNSTOWN-MILLIKEN RE-5J,,DISTRICT TOTAL,,4,18,30,970,2114,3136,1022,33%
3120,GREELEY 6,0052,HEIMAN ELEMENTARY SCHOOL,PK,0,0,0,10,21,31,10,32%
3120,GREELEY 6,0052,HEIMAN ELEMENTARY SCHOOL,HALF DAY K,1,1,0,39,76,117,41,35%
3120,GREELEY 6,0052,HEIMAN ELEMENTARY SCHOOL,1ST,1,2,1,47,69,120,51,43%
3120,GREELEY 6,0052,HEIMAN ELEMENTARY SCHOOL,2ND,0,1,0,46,62,109,47,43%
3120,GREELEY 6,0052,HEIMAN ELEMENTARY SCHOOL,3RD,0,1,2,50,66,119,53,45%
3120,GREELEY 6,0052,HEIMAN ELEMENTARY SCHOOL,4TH,0,0,2,46,78,126,48,38%
3120,GREELEY 6,0052,HEIMAN ELEMENTARY SCHOOL,5TH,0,2,1,46,58,107,49,46%
3120,GREELEY 6,0052,HEIMAN ELEMENTARY SCHOOL,SCHOOL TOTAL,2,7,6,284,430,729,299,41%
3120,GREELEY 6,0053,WINOGRAD K-8 ELEMENTARY SCHOOL,PK,0,0,1,15,21,37,16,43%
3120,GREELEY 6,0053,WINOGRAD K-8 ELEMENTARY SCHOOL,HALF DAY K,0,0,1,20,21,42,21,50%
3120,GREELEY 6,0053,WINOGRAD K-8 ELEMENTARY SCHOOL,KINDERGARTEN,0,0,0,9,4,13,9,69%
3120,GREELEY 6,0053,WINOGRAD K-8 ELEMENTARY SCHOOL,1ST,0,0,1,29,25,55,30,55%
3120,GREELEY 6,0053,WINOGRAD K-8 ELEMENTARY SCHOOL,2ND,0,0,0,27,24,51,27,53%
3120,GREELEY 6,0053,WINOGRAD K-8 ELEMENTARY SCHOOL,3RD,0,1,1,21,23,46,23,50%
3120,GREELEY 6,0053,WINOGRAD K-8 ELEMENTARY SCHOOL,4TH,0,0,0,30,23,53,30,57%
3120,GREELEY 6,0053,WINOGRAD K-8 ELEMENTARY SCHOOL,5TH,0,1,0,22,25,48,23,48%
3120,GREELEY 6,0053,WINOGRAD K-8 ELEMENTARY SCHOOL,6TH,0,0,1,25,37,63,26,41%
3120,GREELEY 6,0053,WINOGRAD K-8 ELEMENTARY SCHOOL,7TH,0,2,2,20,28,52,24,46%
3120,GREELEY 6,0053,WINOGRAD K-8 ELEMENTARY SCHOOL,8TH,0,1,0,16,27,44,17,39%
3120,GREELEY 6,0053,WINOGRAD K-8 ELEMENTARY SCHOOL,SCHOOL TOTAL,0,5,7,234,258,504,246,49%
3120,GREELEY 6,0054,ROMERO ELEMENTARY SCHOOL,PK,0,0,1,23,35,59,24,41%
3120,GREELEY 6,0054,ROMERO ELEMENTARY SCHOOL,KINDERGARTEN,0,0,2,80,22,104,82,79%
3120,GREELEY 6,0054,ROMERO ELEMENTARY SCHOOL,1ST,0,0,0,78,14,92,78,85%
3120,GREELEY 6,0054,ROMERO ELEMENTARY SCHOOL,2ND,0,0,1,74,11,86,75,87%
3120,GREELEY 6,0054,ROMERO ELEMENTARY SCHOOL,3RD,0,0,1,64,10,75,65,87%
3120,GREELEY 6,0054,ROMERO ELEMENTARY SCHOOL,4TH,0,0,0,75,10,85,75,88%
3120,GREELEY 6,0054,ROMERO ELEMENTARY SCHOOL,5TH,0,0,1,64,10,75,65,87%
3120,GREELEY 6,0054,ROMERO ELEMENTARY SCHOOL,SCHOOL TOTAL,0,0,6,458,112,576,464,81%
3120,GREELEY 6,0988,BRENTWOOD MIDDLE SCHOOL,6TH,1,2,3,134,81,221,140,63%
3120,GREELEY 6,0988,BRENTWOOD MIDDLE SCHOOL,7TH,1,2,3,148,59,213,154,72%
3120,GREELEY 6,0988,BRENTWOOD MIDDLE SCHOOL,8TH,0,2,4,108,63,177,114,64%
3120,GREELEY 6,0988,BRENTWOOD MIDDLE SCHOOL,SCHOOL TOTAL,2,6,10,390,203,611,408,67%
3120,GREELEY 6,1228,CAMERON ELEMENTARY SCHOOL,PK,0,0,0,11,19,30,11,37%
3120,GREELEY 6,1228,CAMERON ELEMENTARY SCHOOL,KINDERGARTEN,0,0,1,39,23,63,40,63%
3120,GREELEY 6,1228,CAMERON ELEMENTARY SCHOOL,1ST,0,0,3,46,16,65,49,75%
3120,GREELEY 6,1228,CAMERON ELEMENTARY SCHOOL,2ND,0,0,2,37,14,53,39,74%
3120,GREELEY 6,1228,CAMERON ELEMENTARY SCHOOL,3RD,0,0,2,42,17,61,44,72%
3120,GREELEY 6,1228,CAMERON ELEMENTARY SCHOOL,4TH,0,0,3,37,5,45,40,89%
3120,GREELEY 6,1228,CAMERON ELEMENTARY SCHOOL,5TH,0,0,8,38,15,61,46,75%
3120,GREELEY 6,1228,CAMERON ELEMENTARY SCHOOL,SCHOOL TOTAL,0,0,19,250,109,378,269,71%
3120,GREELEY 6,1384,CENTENNIAL ELEMENTARY SCHOOL,PK,0,1,0,40,20,61,41,67%
3120,GREELEY 6,1384,CENTENNIAL ELEMENTARY SCHOOL,KINDERGARTEN,6,7,4,79,27,123,96,78%
3120,GREELEY 6,1384,CENTENNIAL ELEMENTARY SCHOOL,1ST,1,7,5,83,27,123,96,78%
3120,GREELEY 6,1384,CENTENNIAL ELEMENTARY SCHOOL,2ND,0,1,2,68,11,82,71,87%
3120,GREELEY 6,1384,CENTENNIAL ELEMENTARY SCHOOL,3RD,2,6,0,72,13,93,80,86%
3120,GREELEY 6,1384,CENTENNIAL ELEMENTARY SCHOOL,4TH,1,5,2,88,13,109,96,88%
3120,GREELEY 6,1384,CENTENNIAL ELEMENTARY SCHOOL,5TH,2,5,3,63,13,86,73,85%
3120,GREELEY 6,1384,CENTENNIAL ELEMENTARY SCHOOL,SCHOOL TOTAL,12,32,16,493,124,677,553,82%
3120,GREELEY 6,1500,CHAPPELOW K-8 MAGNET SCHOOL,HALF DAY K,0,1,0,13,52,66,14,21%
3120,GREELEY 6,1500,CHAPPELOW K-8 MAGNET SCHOOL,1ST,0,0,1,24,43,68,25,37%
3120,GREELEY 6,1500,CHAPPELOW K-8 MAGNET SCHOOL,2ND,0,1,0,26,43,70,27,39%
3120,GREELEY 6,1500,CHAPPELOW K-8 MAGNET SCHOOL,3RD,0,1,0,28,41,70,29,41%
3120,GREELEY 6,1500,CHAPPELOW K-8 MAGNET SCHOOL,4TH,2,0,0,27,48,77,29,38%
3120,GREELEY 6,1500,CHAPPELOW K-8 MAGNET SCHOOL,5TH,2,1,0,24,51,78,27,35%
3120,GREELEY 6,1500,CHAPPELOW K-8 MAGNET SCHOOL,6TH,1,1,1,27,40,70,30,43%
3120,GREELEY 6,1500,CHAPPELOW K-8 MAGNET SCHOOL,7TH,2,0,0,28,45,75,30,40%
3120,GREELEY 6,1500,CHAPPELOW K-8 MAGNET SCHOOL,8TH,0,0,0,33,30,63,33,52%
3120,GREELEY 6,1500,CHAPPELOW K-8 MAGNET SCHOOL,SCHOOL TOTAL,7,5,2,230,393,637,244,38%
3120,GREELEY 6,1780,COLORADO HIGH SCHOOL OF GREELEY,9TH,0,0,0,2,0,2,2,100%
3120,GREELEY 6,1780,COLORADO HIGH SCHOOL OF GREELEY,10TH,1,0,0,10,8,19,11,58%
3120,GREELEY 6,1780,COLORADO HIGH SCHOOL OF GREELEY,11TH,1,0,0,41,2,44,42,95%
3120,GREELEY 6,1780,COLORADO HIGH SCHOOL OF GREELEY,12TH,0,0,2,29,19,50,31,62%
3120,GREELEY 6,1780,COLORADO HIGH SCHOOL OF GREELEY,SCHOOL TOTAL,2,0,2,82,29,115,86,75%
3120,GREELEY 6,1875,FRONTIER CHARTER ACADEMY,HALF DAY K,0,0,0,4,79,83,4,5%
3120,GREELEY 6,1875,FRONTIER CHARTER ACADEMY,1ST,0,2,1,10,70,83,13,16%
3120,GREELEY 6,1875,FRONTIER CHARTER ACADEMY,2ND,0,0,1,8,79,88,9,10%
3120,GREELEY 6,1875,FRONTIER CHARTER ACADEMY,3RD,0,0,1,14,73,88,15,17%
3120,GREELEY 6,1875,FRONTIER CHARTER ACADEMY,4TH,1,2,2,10,72,87,15,17%
3120,GREELEY 6,1875,FRONTIER CHARTER ACADEMY,5TH,1,2,0,11,73,87,14,16%
3120,GREELEY 6,1875,FRONTIER CHARTER ACADEMY,6TH,2,0,2,28,74,106,32,30%
3120,GREELEY 6,1875,FRONTIER CHARTER ACADEMY,7TH,0,3,1,17,82,103,21,20%
3120,GREELEY 6,1875,FRONTIER CHARTER ACADEMY,8TH,1,1,1,19,77,99,22,22%
3120,GREELEY 6,1875,FRONTIER CHARTER ACADEMY,9TH,0,3,3,16,71,93,22,24%
3120,GREELEY 6,1875,FRONTIER CHARTER ACADEMY,10TH,0,1,0,11,62,74,12,16%
3120,GREELEY 6,1875,FRONTIER CHARTER ACADEMY,11TH,0,2,4,8,44,58,14,24%
3120,GREELEY 6,1875,FRONTIER CHARTER ACADEMY,12TH,0,0,0,8,51,59,8,14%
3120,GREELEY 6,1875,FRONTIER CHARTER ACADEMY,SCHOOL TOTAL,5,16,16,164,907,1108,201,18%
3120,GREELEY 6,2222,DOS RIOS ELEMENTARY SCHOOL,KINDERGARTEN,1,0,0,63,40,104,64,62%
3120,GREELEY 6,2222,DOS RIOS ELEMENTARY SCHOOL,1ST,2,0,3,59,32,96,64,67%
3120,GREELEY 6,2222,DOS RIOS ELEMENTARY SCHOOL,2ND,1,0,1,55,34,91,57,63%
3120,GREELEY 6,2222,DOS RIOS ELEMENTARY SCHOOL,3RD,0,1,1,38,21,61,40,66%
3120,GREELEY 6,2222,DOS RIOS ELEMENTARY SCHOOL,4TH,2,0,1,81,16,100,84,84%
3120,GREELEY 6,2222,DOS RIOS ELEMENTARY SCHOOL,5TH,0,0,0,60,23,83,60,72%
3120,GREELEY 6,2222,DOS RIOS ELEMENTARY SCHOOL,SCHOOL TOTAL,6,1,6,356,166,535,369,69%
3120,GREELEY 6,2414,EAST MEMORIAL ELEMENTARY SCHOOL,PK,1,0,0,23,30,54,24,44%
3120,GREELEY 6,2414,EAST MEMORIAL ELEMENTARY SCHOOL,KINDERGARTEN,0,0,1,59,11,71,60,85%
3120,GREELEY 6,2414,EAST MEMORIAL ELEMENTARY SCHOOL,1ST,0,1,0,61,11,73,62,85%
3120,GREELEY 6,2414,EAST MEMORIAL ELEMENTARY SCHOOL,2ND,0,0,0,86,7,93,86,92%
3120,GREELEY 6,2414,EAST MEMORIAL ELEMENTARY SCHOOL,3RD,0,0,0,59,1,60,59,98%
3120,GREELEY 6,2414,EAST MEMORIAL ELEMENTARY SCHOOL,4TH,1,0,0,69,9,79,70,89%
3120,GREELEY 6,2414,EAST MEMORIAL ELEMENTARY SCHOOL,5TH,1,0,0,67,3,71,68,96%
3120,GREELEY 6,2414,EAST MEMORIAL ELEMENTARY SCHOOL,SCHOOL TOTAL,3,1,1,424,72,501,429,86%
3120,GREELEY 6,2850,UNIVERSITY SCHOOLS,HALF DAY K,1,1,1,12,49,64,15,23%
3120,GREELEY 6,2850,UNIVERSITY SCHOOLS,1ST,0,2,1,18,45,66,21,32%
3120,GREELEY 6,2850,UNIVERSITY SCHOOLS,2ND,0,2,1,22,41,66,25,38%
3120,GREELEY 6,2850,UNIVERSITY SCHOOLS,3RD,3,1,2,21,46,73,27,37%
3120,GREELEY 6,2850,UNIVERSITY SCHOOLS,4TH,2,2,2,14,53,73,20,27%
3120,GREELEY 6,2850,UNIVERSITY SCHOOLS,5TH,1,6,2,22,43,74,31,42%
3120,GREELEY 6,2850,UNIVERSITY SCHOOLS,6TH,1,1,2,17,68,89,21,24%
3120,GREELEY 6,2850,UNIVERSITY SCHOOLS,7TH,3,3,4,29,53,92,39,42%
3120,GREELEY 6,2850,UNIVERSITY SCHOOLS,8TH,2,3,1,27,57,90,33,37%
3120,GREELEY 6,2850,UNIVERSITY SCHOOLS,9TH,2,1,3,40,75,121,46,38%
3120,GREELEY 6,2850,UNIVERSITY SCHOOLS,10TH,2,2,0,21,64,89,25,28%
3120,GREELEY 6,2850,UNIVERSITY SCHOOLS,11TH,0,3,1,17,72,93,21,23%
3120,GREELEY 6,2850,UNIVERSITY SCHOOLS,12TH,0,2,2,20,57,81,24,30%
3120,GREELEY 6,2850,UNIVERSITY SCHOOLS,SCHOOL TOTAL,17,29,22,280,723,1071,348,32%
3120,GREELEY 6,3162,FRANKLIN MIDDLE SCHOOL,6TH,1,1,1,108,38,149,111,74%
3120,GREELEY 6,3162,FRANKLIN MIDDLE SCHOOL,7TH,3,1,1,103,43,151,108,72%
3120,GREELEY 6,3162,FRANKLIN MIDDLE SCHOOL,8TH,2,0,2,100,36,140,104,74%
3120,GREELEY 6,3162,FRANKLIN MIDDLE SCHOOL,SCHOOL TOTAL,6,2,4,311,117,440,323,73%
3120,GREELEY 6,3610,GREELEY CENTRAL HIGH SCHOOL,9TH,3,2,8,230,118,361,243,67%
3120,GREELEY 6,3610,GREELEY CENTRAL HIGH SCHOOL,10TH,1,6,9,185,170,371,201,54%
3120,GREELEY 6,3610,GREELEY CENTRAL HIGH SCHOOL,11TH,0,3,14,204,150,371,221,60%
3120,GREELEY 6,3610,GREELEY CENTRAL HIGH SCHOOL,12TH,2,2,5,153,150,312,162,52%
3120,GREELEY 6,3610,GREELEY CENTRAL HIGH SCHOOL,SCHOOL TOTAL,6,13,36,772,588,1415,827,58%
3120,GREELEY 6,3614,GREELEY WEST HIGH SCHOOL,9TH,2,3,7,194,189,395,206,52%
3120,GREELEY 6,3614,GREELEY WEST HIGH SCHOOL,10TH,3,8,7,191,179,388,209,54%
3120,GREELEY 6,3614,GREELEY WEST HIGH SCHOOL,11TH,1,13,6,168,182,370,188,51%
3120,GREELEY 6,3614,GREELEY WEST HIGH SCHOOL,12TH,4,3,5,123,176,311,135,43%
3120,GREELEY 6,3614,GREELEY WEST HIGH SCHOOL,SCHOOL TOTAL,10,27,25,676,726,1464,738,50%
3120,GREELEY 6,3880,HEATH MIDDLE SCHOOL,6TH,16,5,5,131,123,280,157,56%
3120,GREELEY 6,3880,HEATH MIDDLE SCHOOL,7TH,15,4,6,116,128,269,141,52%
3120,GREELEY 6,3880,HEATH MIDDLE SCHOOL,8TH,10,4,5,120,115,254,139,55%
3120,GREELEY 6,3880,HEATH MIDDLE SCHOOL,SCHOOL TOTAL,41,13,16,367,366,803,437,54%
3120,GREELEY 6,4356,JACKSON ELEMENTARY SCHOOL,PK,0,0,1,18,12,31,19,61%
3120,GREELEY 6,4356,JACKSON ELEMENTARY SCHOOL,KINDERGARTEN,0,3,1,44,24,72,48,67%
3120,GREELEY 6,4356,JACKSON ELEMENTARY SCHOOL,1ST,0,1,1,52,25,79,54,68%
3120,GREELEY 6,4356,JACKSON ELEMENTARY SCHOOL,2ND,0,0,2,65,14,81,67,83%
3120,GREELEY 6,4356,JACKSON ELEMENTARY SCHOOL,3RD,0,0,1,48,23,72,49,68%
3120,GREELEY 6,4356,JACKSON ELEMENTARY SCHOOL,4TH,2,2,1,39,20,64,44,69%
3120,GREELEY 6,4356,JACKSON ELEMENTARY SCHOOL,5TH,1,1,0,52,21,75,54,72%
3120,GREELEY 6,4356,JACKSON ELEMENTARY SCHOOL,SCHOOL TOTAL,3,7,7,318,139,474,335,71%
3120,GREELEY 6,4438,JOHN EVANS MIDDLE SCHOOL,6TH,1,3,5,178,49,236,187,79%
3120,GREELEY 6,4438,JOHN EVANS MIDDLE SCHOOL,7TH,4,4,7,128,35,178,143,80%
3120,GREELEY 6,4438,JOHN EVANS MIDDLE SCHOOL,8TH,1,2,7,142,30,182,152,84%
3120,GREELEY 6,4438,JOHN EVANS MIDDLE SCHOOL,SCHOOL TOTAL,6,9,19,448,114,596,482,81%
3120,GREELEY 6,5199,JEFFERSON ELEMENTARY SCHOOL,PK,0,0,1,20,8,29,21,72%
3120,GREELEY 6,5199,JEFFERSON ELEMENTARY SCHOOL,KINDERGARTEN,1,0,1,68,12,82,70,85%
3120,GREELEY 6,5199,JEFFERSON ELEMENTARY SCHOOL,1ST,0,0,0,59,4,63,59,94%
3120,GREELEY 6,5199,JEFFERSON ELEMENTARY SCHOOL,2ND,0,0,0,63,9,72,63,88%
3120,GREELEY 6,5199,JEFFERSON ELEMENTARY SCHOOL,3RD,0,0,0,58,4,62,58,94%
3120,GREELEY 6,5199,JEFFERSON ELEMENTARY SCHOOL,4TH,0,0,0,54,5,59,54,92%
3120,GREELEY 6,5199,JEFFERSON ELEMENTARY SCHOOL,5TH,0,0,0,58,2,60,58,97%
3120,GREELEY 6,5199,JEFFERSON ELEMENTARY SCHOOL,SCHOOL TOTAL,1,0,2,380,44,427,383,90%
3120,GREELEY 6,5412,MADISON ELEMENTARY SCHOOL,KINDERGARTEN,0,0,1,62,8,71,63,89%
3120,GREELEY 6,5412,MADISON ELEMENTARY SCHOOL,1ST,0,0,1,90,12,103,91,88%
3120,GREELEY 6,5412,MADISON ELEMENTARY SCHOOL,2ND,0,2,1,78,5,86,81,94%
3120,GREELEY 6,5412,MADISON ELEMENTARY SCHOOL,3RD,1,0,1,75,15,92,77,84%
3120,GREELEY 6,5412,MADISON ELEMENTARY SCHOOL,4TH,1,0,1,54,3,59,56,95%
3120,GREELEY 6,5412,MADISON ELEMENTARY SCHOOL,5TH,1,0,0,83,6,90,84,93%
3120,GREELEY 6,5412,MADISON ELEMENTARY SCHOOL,SCHOOL TOTAL,3,2,5,442,49,501,452,90%
3120,GREELEY 6,5552,MAPLEWOOD MIDDLE SCHOOL,6TH,0,1,3,88,37,129,92,71%
3120,GREELEY 6,5552,MAPLEWOOD MIDDLE SCHOOL,7TH,2,0,3,82,53,140,87,62%
3120,GREELEY 6,5552,MAPLEWOOD MIDDLE SCHOOL,8TH,3,2,3,67,38,113,75,66%
3120,GREELEY 6,5552,MAPLEWOOD MIDDLE SCHOOL,SCHOOL TOTAL,5,3,9,237,128,382,254,66%
3120,GREELEY 6,5660,MCAULIFFE ELEMENTARY SCHOOL,PK,0,0,0,7,25,32,7,22%
3120,GREELEY 6,5660,MCAULIFFE ELEMENTARY SCHOOL,HALF DAY K,0,1,1,12,61,75,14,19%
3120,GREELEY 6,5660,MCAULIFFE ELEMENTARY SCHOOL,1ST,0,3,0,31,60,94,34,36%
3120,GREELEY 6,5660,MCAULIFFE ELEMENTARY SCHOOL,2ND,0,2,0,21,65,88,23,26%
3120,GREELEY 6,5660,MCAULIFFE ELEMENTARY SCHOOL,3RD,0,3,1,23,67,94,27,29%
3120,GREELEY 6,5660,MCAULIFFE ELEMENTARY SCHOOL,4TH,0,2,0,18,64,84,20,24%
3120,GREELEY 6,5660,MCAULIFFE ELEMENTARY SCHOOL,5TH,0,4,0,21,62,87,25,29%
3120,GREELEY 6,5660,MCAULIFFE ELEMENTARY SCHOOL,SCHOOL TOTAL,0,15,2,133,404,554,150,27%
3120,GREELEY 6,5752,MEEKER ELEMENTARY SCHOOL,PK,0,2,0,30,82,114,32,28%
3120,GREELEY 6,5752,MEEKER ELEMENTARY SCHOOL,HALF DAY K,0,1,1,18,47,67,20,30%
3120,GREELEY 6,5752,MEEKER ELEMENTARY SCHOOL,KINDERGARTEN,0,1,0,7,12,20,8,40%
3120,GREELEY 6,5752,MEEKER ELEMENTARY SCHOOL,1ST,0,0,4,23,59,86,27,31%
3120,GREELEY 6,5752,MEEKER ELEMENTARY SCHOOL,2ND,0,0,1,30,42,73,31,42%
3120,GREELEY 6,5752,MEEKER ELEMENTARY SCHOOL,3RD,1,0,5,28,61,95,34,36%
3120,GREELEY 6,5752,MEEKER ELEMENTARY SCHOOL,4TH,0,1,2,22,54,79,25,32%
3120,GREELEY 6,5752,MEEKER ELEMENTARY SCHOOL,5TH,3,0,2,30,43,78,35,45%
3120,GREELEY 6,5752,MEEKER ELEMENTARY SCHOOL,SCHOOL TOTAL,4,5,15,188,400,612,212,35%
3120,GREELEY 6,5985,MONFORT ELEMENTARY SCHOOL,PK,0,1,0,12,18,31,13,42%
3120,GREELEY 6,5985,MONFORT ELEMENTARY SCHOOL,HALF DAY K,0,1,0,24,85,110,25,23%
3120,GREELEY 6,5985,MONFORT ELEMENTARY SCHOOL,1ST,0,1,0,24,69,94,25,27%
3120,GREELEY 6,5985,MONFORT ELEMENTARY SCHOOL,2ND,0,1,1,25,88,115,27,23%
3120,GREELEY 6,5985,MONFORT ELEMENTARY SCHOOL,3RD,1,1,1,22,66,91,25,27%
3120,GREELEY 6,5985,MONFORT ELEMENTARY SCHOOL,4TH,2,3,1,30,56,92,36,39%
3120,GREELEY 6,5985,MONFORT ELEMENTARY SCHOOL,5TH,0,2,0,24,67,93,26,28%
3120,GREELEY 6,5985,MONFORT ELEMENTARY SCHOOL,SCHOOL TOTAL,3,10,3,161,449,626,177,28%
3120,GREELEY 6,6364,NORTHRIDGE HIGH SCHOOL,9TH,3,5,0,187,75,270,195,72%
3120,GREELEY 6,6364,NORTHRIDGE HIGH SCHOOL,10TH,3,2,6,170,95,276,181,66%
3120,GREELEY 6,6364,NORTHRIDGE HIGH SCHOOL,11TH,0,1,8,189,102,300,198,66%
3120,GREELEY 6,6364,NORTHRIDGE HIGH SCHOOL,12TH,5,2,2,132,103,244,141,58%
3120,GREELEY 6,6364,NORTHRIDGE HIGH SCHOOL,SCHOOL TOTAL,11,10,16,678,375,1090,715,66%
3120,GREELEY 6,6774,MARTINEZ ELEMENTARY SCHOOL,HALF DAY K,0,0,0,1,0,1,1,100%
3120,GREELEY 6,6774,MARTINEZ ELEMENTARY SCHOOL,KINDERGARTEN,0,0,2,75,24,101,77,76%
3120,GREELEY 6,6774,MARTINEZ ELEMENTARY SCHOOL,1ST,0,0,3,91,5,99,94,95%
3120,GREELEY 6,6774,MARTINEZ ELEMENTARY SCHOOL,2ND,0,0,0,96,3,99,96,97%
3120,GREELEY 6,6774,MARTINEZ ELEMENTARY SCHOOL,3RD,0,0,1,86,5,92,87,95%
3120,GREELEY 6,6774,MARTINEZ ELEMENTARY SCHOOL,4TH,0,0,0,79,4,83,79,95%
3120,GREELEY 6,6774,MARTINEZ ELEMENTARY SCHOOL,5TH,0,0,2,76,1,79,78,99%
3120,GREELEY 6,6774,MARTINEZ ELEMENTARY SCHOOL,SCHOOL TOTAL,0,0,8,504,42,554,512,92%
3120,GREELEY 6,7700,SCOTT ELEMENTARY SCHOOL,PK,0,0,0,9,79,88,9,10%
3120,GREELEY 6,7700,SCOTT ELEMENTARY SCHOOL,HALF DAY K,0,0,0,7,37,44,7,16%
3120,GREELEY 6,7700,SCOTT ELEMENTARY SCHOOL,KINDERGARTEN,0,0,0,18,28,46,18,39%
3120,GREELEY 6,7700,SCOTT ELEMENTARY SCHOOL,1ST,1,1,1,33,28,64,36,56%
3120,GREELEY 6,7700,SCOTT ELEMENTARY SCHOOL,2ND,0,0,1,47,28,76,48,63%
3120,GREELEY 6,7700,SCOTT ELEMENTARY SCHOOL,3RD,1,2,3,49,27,82,55,67%
3120,GREELEY 6,7700,SCOTT ELEMENTARY SCHOOL,4TH,0,0,0,35,37,72,35,49%
3120,GREELEY 6,7700,SCOTT ELEMENTARY SCHOOL,5TH,1,2,1,45,25,74,49,66%
3120,GREELEY 6,7700,SCOTT ELEMENTARY SCHOOL,SCHOOL TOTAL,3,5,6,243,289,546,257,47%
3120,GREELEY 6,7814,SHAWSHEEN ELEMENTARY SCHOOL,HALF DAY K,0,0,0,24,35,59,24,41%
3120,GREELEY 6,7814,SHAWSHEEN ELEMENTARY SCHOOL,KINDERGARTEN,1,0,1,4,8,14,6,43%
3120,GREELEY 6,7814,SHAWSHEEN ELEMENTARY SCHOOL,1ST,1,1,2,36,56,96,40,42%
3120,GREELEY 6,7814,SHAWSHEEN ELEMENTARY SCHOOL,2ND,0,3,1,45,39,88,49,56%
3120,GREELEY 6,7814,SHAWSHEEN ELEMENTARY SCHOOL,3RD,2,1,1,35,38,77,39,51%
3120,GREELEY 6,7814,SHAWSHEEN ELEMENTARY SCHOOL,4TH,2,1,1,36,42,82,40,49%
3120,GREELEY 6,7814,SHAWSHEEN ELEMENTARY SCHOOL,5TH,0,2,1,31,43,77,34,44%
3120,GREELEY 6,7814,SHAWSHEEN ELEMENTARY SCHOOL,SCHOOL TOTAL,6,8,7,211,261,493,232,47%
3120,GREELEY 6,8890,TRADEMARK LEARNING CENTER,9TH,1,0,0,14,10,25,15,60%
3120,GREELEY 6,8890,TRADEMARK LEARNING CENTER,10TH,0,0,2,31,15,48,33,69%
3120,GREELEY 6,8890,TRADEMARK LEARNING CENTER,11TH,0,0,0,48,14,62,48,77%
3120,GREELEY 6,8890,TRADEMARK LEARNING CENTER,12TH,1,1,2,134,36,174,138,79%
3120,GREELEY 6,8890,TRADEMARK LEARNING CENTER,SCHOOL TOTAL,2,1,4,227,75,309,234,76%
3120,GREELEY 6,8965,UNION COLONY PREPARATORY SCHOOL,6TH,1,4,1,21,45,72,27,38%
3120,GREELEY 6,8965,UNION COLONY PREPARATORY SCHOOL,7TH,1,2,0,13,54,70,16,23%
3120,GREELEY 6,8965,UNION COLONY PREPARATORY SCHOOL,8TH,0,2,1,13,53,69,16,23%
3120,GREELEY 6,8965,UNION COLONY PREPARATORY SCHOOL,9TH,0,0,0,15,42,57,15,26%
3120,GREELEY 6,8965,UNION COLONY PREPARATORY SCHOOL,10TH,0,0,0,7,37,44,7,16%
3120,GREELEY 6,8965,UNION COLONY PREPARATORY SCHOOL,11TH,0,2,1,7,29,39,10,26%
3120,GREELEY 6,8965,UNION COLONY PREPARATORY SCHOOL,12TH,0,1,0,6,31,38,7,18%
3120,GREELEY 6,8965,UNION COLONY PREPARATORY SCHOOL,SCHOOL TOTAL,2,11,3,82,291,389,98,25%
3120,GREELEY 6,,DISTRICT TOTAL,,168,243,300,10023,8383,19117,10734,56%
3130,PLATTE VALLEY RE-7,4670,PLATTE VALLEY HIGH SCHOOL,9TH,0,0,1,25,77,103,26,25%
3130,PLATTE VALLEY RE-7,4670,PLATTE VALLEY HIGH SCHOOL,10TH,0,0,1,24,67,92,25,27%
3130,PLATTE VALLEY RE-7,4670,PLATTE VALLEY HIGH SCHOOL,11TH,1,0,1,21,60,83,23,28%
3130,PLATTE VALLEY RE-7,4670,PLATTE VALLEY HIGH SCHOOL,12TH,1,1,0,11,57,70,13,19%
3130,PLATTE VALLEY RE-7,4670,PLATTE VALLEY HIGH SCHOOL,SCHOOL TOTAL,2,1,3,81,261,348,87,25%
3130,PLATTE VALLEY RE-7,7052,PLATTE VALLEY ELEMENTARY SCHOOL,KINDERGARTEN,0,0,0,25,50,75,25,33%
3130,PLATTE VALLEY RE-7,7052,PLATTE VALLEY ELEMENTARY SCHOOL,1ST,0,1,0,21,52,74,22,30%
3130,PLATTE VALLEY RE-7,7052,PLATTE VALLEY ELEMENTARY SCHOOL,2ND,1,0,0,26,60,87,27,31%
3130,PLATTE VALLEY RE-7,7052,PLATTE VALLEY ELEMENTARY SCHOOL,3RD,0,0,0,23,71,94,23,24%
3130,PLATTE VALLEY RE-7,7052,PLATTE VALLEY ELEMENTARY SCHOOL,4TH,0,0,0,23,60,83,23,28%
3130,PLATTE VALLEY RE-7,7052,PLATTE VALLEY ELEMENTARY SCHOOL,5TH,0,0,0,24,71,95,24,25%
3130,PLATTE VALLEY RE-7,7052,PLATTE VALLEY ELEMENTARY SCHOOL,SCHOOL TOTAL,1,1,0,142,364,508,144,28%
3130,PLATTE VALLEY RE-7,7054,PLATTE VALLEY MIDDLE SCHOOL,6TH,0,0,0,30,61,91,30,33%
3130,PLATTE VALLEY RE-7,7054,PLATTE VALLEY MIDDLE SCHOOL,7TH,0,0,0,28,73,101,28,28%
3130,PLATTE VALLEY RE-7,7054,PLATTE VALLEY MIDDLE SCHOOL,8TH,0,0,0,24,50,74,24,32%
3130,PLATTE VALLEY RE-7,7054,PLATTE VALLEY MIDDLE SCHOOL,SCHOOL TOTAL,0,0,0,82,184,266,82,31%
3130,PLATTE VALLEY RE-7,,DISTRICT TOTAL,,3,2,3,305,809,1122,313,28%
3140,WELD COUNTY S/D RE-8,3066,FORT LUPTON MIDDLE SCHOOL,6TH,1,2,2,104,58,167,109,65%
3140,WELD COUNTY S/D RE-8,3066,FORT LUPTON MIDDLE SCHOOL,7TH,0,1,0,101,58,160,102,64%
3140,WELD COUNTY S/D RE-8,3066,FORT LUPTON MIDDLE SCHOOL,8TH,1,0,4,104,51,160,109,68%
3140,WELD COUNTY S/D RE-8,3066,FORT LUPTON MIDDLE SCHOOL,SCHOOL TOTAL,2,3,6,309,167,487,320,66%
3140,WELD COUNTY S/D RE-8,3070,FORT LUPTON HIGH SCHOOL,9TH,1,1,2,108,48,160,112,70%
3140,WELD COUNTY S/D RE-8,3070,FORT LUPTON HIGH SCHOOL,10TH,1,0,0,100,53,154,101,66%
3140,WELD COUNTY S/D RE-8,3070,FORT LUPTON HIGH SCHOOL,11TH,1,1,1,72,64,139,75,54%
3140,WELD COUNTY S/D RE-8,3070,FORT LUPTON HIGH SCHOOL,12TH,0,3,2,117,64,186,122,66%
3140,WELD COUNTY S/D RE-8,3070,FORT LUPTON HIGH SCHOOL,SCHOOL TOTAL,3,5,5,397,229,639,410,64%
3140,WELD COUNTY S/D RE-8,5050,LEO WILLIAM BUTLER ELEMENTARY SCHOOL,PK,0,0,2,57,20,79,59,75%
3140,WELD COUNTY S/D RE-8,5050,LEO WILLIAM BUTLER ELEMENTARY SCHOOL,KINDERGARTEN,1,2,1,59,30,93,63,68%
3140,WELD COUNTY S/D RE-8,5050,LEO WILLIAM BUTLER ELEMENTARY SCHOOL,1ST,0,2,3,58,40,103,63,61%
3140,WELD COUNTY S/D RE-8,5050,LEO WILLIAM BUTLER ELEMENTARY SCHOOL,2ND,0,0,0,44,29,73,44,60%
3140,WELD COUNTY S/D RE-8,5050,LEO WILLIAM BUTLER ELEMENTARY SCHOOL,3RD,0,0,1,65,31,97,66,68%
3140,WELD COUNTY S/D RE-8,5050,LEO WILLIAM BUTLER ELEMENTARY SCHOOL,4TH,0,3,0,72,30,105,75,71%
3140,WELD COUNTY S/D RE-8,5050,LEO WILLIAM BUTLER ELEMENTARY SCHOOL,5TH,0,3,0,62,19,84,65,77%
3140,WELD COUNTY S/D RE-8,5050,LEO WILLIAM BUTLER ELEMENTARY SCHOOL,SCHOOL TOTAL,1,10,7,417,199,634,435,69%
3140,WELD COUNTY S/D RE-8,8930,TWOMBLY ELEMENTARY SCHOOL,PK,1,0,1,95,26,123,97,79%
3140,WELD COUNTY S/D RE-8,8930,TWOMBLY ELEMENTARY SCHOOL,KINDERGARTEN,1,0,0,68,40,109,69,63%
3140,WELD COUNTY S/D RE-8,8930,TWOMBLY ELEMENTARY SCHOOL,1ST,0,0,0,65,32,97,65,67%
3140,WELD COUNTY S/D RE-8,8930,TWOMBLY ELEMENTARY SCHOOL,2ND,0,1,0,52,31,84,53,63%
3140,WELD COUNTY S/D RE-8,8930,TWOMBLY ELEMENTARY SCHOOL,3RD,0,1,0,50,32,83,51,61%
3140,WELD COUNTY S/D RE-8,8930,TWOMBLY ELEMENTARY SCHOOL,4TH,0,1,1,48,29,79,50,63%
3140,WELD COUNTY S/D RE-8,8930,TWOMBLY ELEMENTARY SCHOOL,5TH,0,1,0,64,23,88,65,74%
3140,WELD COUNTY S/D RE-8,8930,TWOMBLY ELEMENTARY SCHOOL,SCHOOL TOTAL,2,4,2,442,213,663,450,68%
3140,WELD COUNTY S/D RE-8,,DISTRICT TOTAL,,8,22,20,1565,808,2423,1615,67%
3145,AULT-HIGHLAND RE-9,3958,HIGHLAND ELEMENTARY SCHOOL,KINDERGARTEN,0,2,0,19,46,67,21,31%
3145,AULT-HIGHLAND RE-9,3958,HIGHLAND ELEMENTARY SCHOOL,1ST,0,0,0,24,41,65,24,37%
3145,AULT-HIGHLAND RE-9,3958,HIGHLAND ELEMENTARY SCHOOL,2ND,0,1,0,28,30,59,29,49%
3145,AULT-HIGHLAND RE-9,3958,HIGHLAND ELEMENTARY SCHOOL,3RD,1,0,0,30,37,68,31,46%
3145,AULT-HIGHLAND RE-9,3958,HIGHLAND ELEMENTARY SCHOOL,4TH,0,0,1,19,26,46,20,43%
3145,AULT-HIGHLAND RE-9,3958,HIGHLAND ELEMENTARY SCHOOL,5TH,1,0,0,20,40,61,21,34%
3145,AULT-HIGHLAND RE-9,3958,HIGHLAND ELEMENTARY SCHOOL,SCHOOL TOTAL,2,3,1,140,220,366,146,40%
3145,AULT-HIGHLAND RE-9,3961,HIGHLAND MIDDLE SCHOOL,6TH,0,0,2,22,43,67,24,36%
3145,AULT-HIGHLAND RE-9,3961,HIGHLAND MIDDLE SCHOOL,7TH,0,1,1,17,33,52,19,37%
3145,AULT-HIGHLAND RE-9,3961,HIGHLAND MIDDLE SCHOOL,8TH,0,0,0,19,49,68,19,28%
3145,AULT-HIGHLAND RE-9,3961,HIGHLAND MIDDLE SCHOOL,SCHOOL TOTAL,0,1,3,58,125,187,62,33%
3145,AULT-HIGHLAND RE-9,3962,HIGHLAND HIGH SCHOOL,9TH,0,1,1,18,45,65,20,31%
3145,AULT-HIGHLAND RE-9,3962,HIGHLAND HIGH SCHOOL,10TH,2,0,0,19,36,57,21,37%
3145,AULT-HIGHLAND RE-9,3962,HIGHLAND HIGH SCHOOL,11TH,1,1,0,23,51,76,25,33%
3145,AULT-HIGHLAND RE-9,3962,HIGHLAND HIGH SCHOOL,12TH,2,0,0,21,42,65,23,35%
3145,AULT-HIGHLAND RE-9,3962,HIGHLAND HIGH SCHOOL,SCHOOL TOTAL,5,2,1,81,174,263,89,34%
3145,AULT-HIGHLAND RE-9,,DISTRICT TOTAL,,7,6,5,279,519,816,297,36%
3146,BRIGGSDALE RE-10,1008,BRIGGSDALE ELEMENTARY SCHOOL,PK,0,2,0,0,12,14,2,14%
3146,BRIGGSDALE RE-10,1008,BRIGGSDALE ELEMENTARY SCHOOL,KINDERGARTEN,0,0,1,0,11,12,1,8%
3146,BRIGGSDALE RE-10,1008,BRIGGSDALE ELEMENTARY SCHOOL,1ST,0,0,0,1,8,9,1,11%
3146,BRIGGSDALE RE-10,1008,BRIGGSDALE ELEMENTARY SCHOOL,2ND,0,0,0,0,13,13,0,0%
3146,BRIGGSDALE RE-10,1008,BRIGGSDALE ELEMENTARY SCHOOL,3RD,0,0,0,0,9,9,0,0%
3146,BRIGGSDALE RE-10,1008,BRIGGSDALE ELEMENTARY SCHOOL,4TH,0,0,0,0,13,13,0,0%
3146,BRIGGSDALE RE-10,1008,BRIGGSDALE ELEMENTARY SCHOOL,5TH,0,1,0,1,4,6,2,33%
3146,BRIGGSDALE RE-10,1008,BRIGGSDALE ELEMENTARY SCHOOL,SCHOOL TOTAL,0,3,1,2,70,76,6,8%
3146,BRIGGSDALE RE-10,1012,BRIGGSDALE UNDIVIDED HIGH SCHOOL,6TH,0,0,0,1,12,13,1,8%
3146,BRIGGSDALE RE-10,1012,BRIGGSDALE UNDIVIDED HIGH SCHOOL,7TH,0,1,0,6,6,13,7,54%
3146,BRIGGSDALE RE-10,1012,BRIGGSDALE UNDIVIDED HIGH SCHOOL,8TH,0,0,0,1,13,14,1,7%
3146,BRIGGSDALE RE-10,1012,BRIGGSDALE UNDIVIDED HIGH SCHOOL,9TH,0,0,0,0,8,8,0,0%
3146,BRIGGSDALE RE-10,1012,BRIGGSDALE UNDIVIDED HIGH SCHOOL,10TH,0,1,0,3,14,18,4,22%
3146,BRIGGSDALE RE-10,1012,BRIGGSDALE UNDIVIDED HIGH SCHOOL,11TH,0,0,0,2,7,9,2,22%
3146,BRIGGSDALE RE-10,1012,BRIGGSDALE UNDIVIDED HIGH SCHOOL,12TH,0,0,0,0,10,10,0,0%
3146,BRIGGSDALE RE-10,1012,BRIGGSDALE UNDIVIDED HIGH SCHOOL,SCHOOL TOTAL,0,2,0,13,70,85,15,18%
3146,BRIGGSDALE RE-10,,DISTRICT TOTAL,,0,5,1,15,140,161,21,13%
3147,PRAIRIE RE-11,7154,PRAIRIE ELEMENTARY SCHOOL,PK,0,0,1,1,8,10,2,20%
3147,PRAIRIE RE-11,7154,PRAIRIE ELEMENTARY SCHOOL,HALF DAY K,0,0,0,1,7,8,1,13%
3147,PRAIRIE RE-11,7154,PRAIRIE ELEMENTARY SCHOOL,1ST,0,0,0,0,12,12,0,0%
3147,PRAIRIE RE-11,7154,PRAIRIE ELEMENTARY SCHOOL,2ND,0,0,0,1,14,15,1,7%
3147,PRAIRIE RE-11,7154,PRAIRIE ELEMENTARY SCHOOL,3RD,0,0,1,0,10,11,1,9%
3147,PRAIRIE RE-11,7154,PRAIRIE ELEMENTARY SCHOOL,4TH,0,0,0,0,13,13,0,0%
3147,PRAIRIE RE-11,7154,PRAIRIE ELEMENTARY SCHOOL,5TH,0,0,0,1,12,13,1,8%
3147,PRAIRIE RE-11,7154,PRAIRIE ELEMENTARY SCHOOL,6TH,1,0,0,0,9,10,1,10%
3147,PRAIRIE RE-11,7154,PRAIRIE ELEMENTARY SCHOOL,SCHOOL TOTAL,1,0,2,4,85,92,7,8%
3147,PRAIRIE RE-11,7156,PRAIRIE JUNIOR-SENIOR HIGH SCHOOL,7TH,0,0,2,1,11,14,3,21%
3147,PRAIRIE RE-11,7156,PRAIRIE JUNIOR-SENIOR HIGH SCHOOL,8TH,1,0,1,0,12,14,2,14%
3147,PRAIRIE RE-11,7156,PRAIRIE JUNIOR-SENIOR HIGH SCHOOL,9TH,0,0,0,1,15,16,1,6%
3147,PRAIRIE RE-11,7156,PRAIRIE JUNIOR-SENIOR HIGH SCHOOL,10TH,0,0,1,0,12,13,1,8%
3147,PRAIRIE RE-11,7156,PRAIRIE JUNIOR-SENIOR HIGH SCHOOL,11TH,1,0,0,0,11,12,1,8%
3147,PRAIRIE RE-11,7156,PRAIRIE JUNIOR-SENIOR HIGH SCHOOL,12TH,0,0,0,1,5,6,1,17%
3147,PRAIRIE RE-11,7156,PRAIRIE JUNIOR-SENIOR HIGH SCHOOL,SCHOOL TOTAL,2,0,4,3,66,75,9,12%
3147,PRAIRIE RE-11,,DISTRICT TOTAL,,3,0,6,7,151,167,16,10%
3148,PAWNEE RE-12,3672,PAWNEE ELEMENTARY SCHOOL,KINDERGARTEN,0,0,1,1,4,6,2,33%
3148,PAWNEE RE-12,3672,PAWNEE ELEMENTARY SCHOOL,1ST,0,0,0,1,2,3,1,33%
3148,PAWNEE RE-12,3672,PAWNEE ELEMENTARY SCHOOL,2ND,0,0,0,0,7,7,0,0%
3148,PAWNEE RE-12,3672,PAWNEE ELEMENTARY SCHOOL,3RD,0,0,0,0,7,7,0,0%
3148,PAWNEE RE-12,3672,PAWNEE ELEMENTARY SCHOOL,4TH,0,0,0,0,7,7,0,0%
3148,PAWNEE RE-12,3672,PAWNEE ELEMENTARY SCHOOL,5TH,0,0,0,1,8,9,1,11%
3148,PAWNEE RE-12,3672,PAWNEE ELEMENTARY SCHOOL,6TH,0,0,0,0,4,4,0,0%
3148,PAWNEE RE-12,3672,PAWNEE ELEMENTARY SCHOOL,SCHOOL TOTAL,0,0,1,3,39,43,4,9%
3148,PAWNEE RE-12,6812,PAWNEE JUNIOR-SENIOR HIGH SCHOOL,7TH,0,0,1,0,8,9,1,11%
3148,PAWNEE RE-12,6812,PAWNEE JUNIOR-SENIOR HIGH SCHOOL,8TH,0,0,0,0,6,6,0,0%
3148,PAWNEE RE-12,6812,PAWNEE JUNIOR-SENIOR HIGH SCHOOL,9TH,0,0,0,1,8,9,1,11%
3148,PAWNEE RE-12,6812,PAWNEE JUNIOR-SENIOR HIGH SCHOOL,10TH,0,0,0,0,8,8,0,0%
3148,PAWNEE RE-12,6812,PAWNEE JUNIOR-SENIOR HIGH SCHOOL,11TH,0,0,0,1,5,6,1,17%
3148,PAWNEE RE-12,6812,PAWNEE JUNIOR-SENIOR HIGH SCHOOL,12TH,0,0,0,0,11,11,0,0%
3148,PAWNEE RE-12,6812,PAWNEE JUNIOR-SENIOR HIGH SCHOOL,SCHOOL TOTAL,0,0,1,2,46,49,3,6%
3148,PAWNEE RE-12,,DISTRICT TOTAL,,0,0,2,5,85,92,7,8%
3200,YUMA 1,5221,LITTLE INDIANS PRESCHOOL,PK,0,0,0,29,20,49,29,59%
3200,YUMA 1,5221,LITTLE INDIANS PRESCHOOL,SCHOOL TOTAL,0,0,0,29,20,49,29,59%
3200,YUMA 1,9791,YUMA MIDDLE SCHOOL,7TH,1,0,0,24,33,58,25,43%
3200,YUMA 1,9791,YUMA MIDDLE SCHOOL,8TH,0,1,1,28,38,68,30,44%
3200,YUMA 1,9791,YUMA MIDDLE SCHOOL,SCHOOL TOTAL,1,1,1,52,71,126,55,44%
3200,YUMA 1,9795,KENNETH P MORRIS ELEMENTARY SCHOOL,KINDERGARTEN,0,1,0,40,24,65,41,63%
3200,YUMA 1,9795,KENNETH P MORRIS ELEMENTARY SCHOOL,1ST,0,0,0,31,34,65,31,48%
3200,YUMA 1,9795,KENNETH P MORRIS ELEMENTARY SCHOOL,2ND,0,0,0,34,25,59,34,58%
3200,YUMA 1,9795,KENNETH P MORRIS ELEMENTARY SCHOOL,3RD,0,0,0,32,30,62,32,52%
3200,YUMA 1,9795,KENNETH P MORRIS ELEMENTARY SCHOOL,4TH,0,0,1,37,19,57,38,67%
3200,YUMA 1,9795,KENNETH P MORRIS ELEMENTARY SCHOOL,5TH,0,1,1,22,28,52,24,46%
3200,YUMA 1,9795,KENNETH P MORRIS ELEMENTARY SCHOOL,6TH,0,1,0,28,30,59,29,49%
3200,YUMA 1,9795,KENNETH P MORRIS ELEMENTARY SCHOOL,SCHOOL TOTAL,0,3,2,224,190,419,229,55%
3200,YUMA 1,9799,YUMA HIGH SCHOOL,9TH,0,0,0,29,31,60,29,48%
3200,YUMA 1,9799,YUMA HIGH SCHOOL,10TH,0,0,0,22,31,53,22,42%
3200,YUMA 1,9799,YUMA HIGH SCHOOL,11TH,0,0,0,25,35,60,25,42%
3200,YUMA 1,9799,YUMA HIGH SCHOOL,12TH,2,0,0,15,39,56,17,30%
3200,YUMA 1,9799,YUMA HIGH SCHOOL,SCHOOL TOTAL,2,0,0,91,136,229,93,41%
3200,YUMA 1,,DISTRICT TOTAL,,3,4,3,396,417,823,406,49%
3210,WRAY RD-2,9725,WRAY ELEMENTARY SCHOOL,PK,0,0,1,11,38,50,12,24%
3210,WRAY RD-2,9725,WRAY ELEMENTARY SCHOOL,KINDERGARTEN,0,1,0,14,45,60,15,25%
3210,WRAY RD-2,9725,WRAY ELEMENTARY SCHOOL,1ST,0,0,1,10,45,56,11,20%
3210,WRAY RD-2,9725,WRAY ELEMENTARY SCHOOL,2ND,0,0,0,11,33,44,11,25%
3210,WRAY RD-2,9725,WRAY ELEMENTARY SCHOOL,3RD,0,2,1,10,45,58,13,22%
3210,WRAY RD-2,9725,WRAY ELEMENTARY SCHOOL,4TH,0,0,0,13,32,45,13,29%
3210,WRAY RD-2,9725,WRAY ELEMENTARY SCHOOL,SCHOOL TOTAL,0,3,3,69,238,313,75,24%
3210,WRAY RD-2,9729,BUCHANAN MIDDLE SCHOOL,5TH,0,0,0,8,35,43,8,19%
3210,WRAY RD-2,9729,BUCHANAN MIDDLE SCHOOL,6TH,0,0,0,16,34,50,16,32%
3210,WRAY RD-2,9729,BUCHANAN MIDDLE SCHOOL,7TH,0,0,1,15,42,58,16,28%
3210,WRAY RD-2,9729,BUCHANAN MIDDLE SCHOOL,8TH,0,0,0,15,29,44,15,34%
3210,WRAY RD-2,9729,BUCHANAN MIDDLE SCHOOL,SCHOOL TOTAL,0,0,1,54,140,195,55,28%
3210,WRAY RD-2,9733,WRAY HIGH SCHOOL,9TH,0,0,0,8,49,57,8,14%
3210,WRAY RD-2,9733,WRAY HIGH SCHOOL,10TH,0,0,0,7,36,43,7,16%
3210,WRAY RD-2,9733,WRAY HIGH SCHOOL,11TH,0,1,0,11,43,55,12,22%
3210,WRAY RD-2,9733,WRAY HIGH SCHOOL,12TH,0,0,0,7,32,39,7,18%
3210,WRAY RD-2,9733,WRAY HIGH SCHOOL,SCHOOL TOTAL,0,1,0,33,160,194,34,18%
3210,WRAY RD-2,,DISTRICT TOTAL,,0,4,4,156,538,702,164,23%
3220,IDALIA RJ-3,4227,IDALIA ELEMENTARY SCHOOL,PK,1,0,0,9,19,29,10,34%
3220,IDALIA RJ-3,4227,IDALIA ELEMENTARY SCHOOL,KINDERGARTEN,1,0,0,4,9,14,5,36%
3220,IDALIA RJ-3,4227,IDALIA ELEMENTARY SCHOOL,1ST,1,0,0,3,8,12,4,33%
3220,IDALIA RJ-3,4227,IDALIA ELEMENTARY SCHOOL,2ND,0,0,0,0,9,9,0,0%
3220,IDALIA RJ-3,4227,IDALIA ELEMENTARY SCHOOL,3RD,1,0,0,4,9,14,5,36%
3220,IDALIA RJ-3,4227,IDALIA ELEMENTARY SCHOOL,4TH,1,0,0,3,7,11,4,36%
3220,IDALIA RJ-3,4227,IDALIA ELEMENTARY SCHOOL,5TH,0,0,0,3,4,7,3,43%
3220,IDALIA RJ-3,4227,IDALIA ELEMENTARY SCHOOL,6TH,0,0,0,1,8,9,1,11%
3220,IDALIA RJ-3,4227,IDALIA ELEMENTARY SCHOOL,SCHOOL TOTAL,5,0,0,27,73,105,32,30%
3220,IDALIA RJ-3,4231,IDALIA JUNIOR-SENIOR HIGH SCHOOL,7TH,0,0,0,2,7,9,2,22%
3220,IDALIA RJ-3,4231,IDALIA JUNIOR-SENIOR HIGH SCHOOL,8TH,0,0,0,3,2,5,3,60%
3220,IDALIA RJ-3,4231,IDALIA JUNIOR-SENIOR HIGH SCHOOL,9TH,0,0,0,0,11,11,0,0%
3220,IDALIA RJ-3,4231,IDALIA JUNIOR-SENIOR HIGH SCHOOL,10TH,0,0,0,0,10,10,0,0%
3220,IDALIA RJ-3,4231,IDALIA JUNIOR-SENIOR HIGH SCHOOL,11TH,0,0,1,1,8,10,2,20%
3220,IDALIA RJ-3,4231,IDALIA JUNIOR-SENIOR HIGH SCHOOL,12TH,0,0,0,1,11,12,1,8%
3220,IDALIA RJ-3,4231,IDALIA JUNIOR-SENIOR HIGH SCHOOL,SCHOOL TOTAL,0,0,1,7,49,57,8,14%
3220,IDALIA RJ-3,,DISTRICT TOTAL,,5,0,1,34,122,162,40,25%
3230,LIBERTY J-4,5119,LIBERTY ELEMENTARY SCHOOL,PK,0,0,0,0,5,5,0,0%
3230,LIBERTY J-4,5119,LIBERTY ELEMENTARY SCHOOL,KINDERGARTEN,0,0,0,0,6,6,0,0%
3230,LIBERTY J-4,5119,LIBERTY ELEMENTARY SCHOOL,1ST,0,0,0,0,8,8,0,0%
3230,LIBERTY J-4,5119,LIBERTY ELEMENTARY SCHOOL,2ND,0,0,0,0,4,4,0,0%
3230,LIBERTY J-4,5119,LIBERTY ELEMENTARY SCHOOL,3RD,0,0,0,0,8,8,0,0%
3230,LIBERTY J-4,5119,LIBERTY ELEMENTARY SCHOOL,4TH,0,0,0,0,3,3,0,0%
3230,LIBERTY J-4,5119,LIBERTY ELEMENTARY SCHOOL,5TH,0,0,0,0,5,5,0,0%
3230,LIBERTY J-4,5119,LIBERTY ELEMENTARY SCHOOL,6TH,0,0,0,0,9,9,0,0%
3230,LIBERTY J-4,5119,LIBERTY ELEMENTARY SCHOOL,SCHOOL TOTAL,0,0,0,0,48,48,0,0%
3230,LIBERTY J-4,5123,LIBERTY JUNIOR-SENIOR HIGH SCHOOL,7TH,0,0,0,0,4,4,0,0%
3230,LIBERTY J-4,5123,LIBERTY JUNIOR-SENIOR HIGH SCHOOL,8TH,0,0,0,0,8,8,0,0%
3230,LIBERTY J-4,5123,LIBERTY JUNIOR-SENIOR HIGH SCHOOL,9TH,0,0,0,0,7,7,0,0%
3230,LIBERTY J-4,5123,LIBERTY JUNIOR-SENIOR HIGH SCHOOL,10TH,0,0,0,0,5,5,0,0%
3230,LIBERTY J-4,5123,LIBERTY JUNIOR-SENIOR HIGH SCHOOL,11TH,1,0,0,0,9,10,1,10%
3230,LIBERTY J-4,5123,LIBERTY JUNIOR-SENIOR HIGH SCHOOL,12TH,0,0,0,0,7,7,0,0%
3230,LIBERTY J-4,5123,LIBERTY JUNIOR-SENIOR HIGH SCHOOL,SCHOOL TOTAL,1,0,0,0,40,41,1,2%
3230,LIBERTY J-4,,DISTRICT TOTAL,,1,0,0,0,88,89,1,1%
8001,CHARTER SCHOOL INSTITUTE,0075,ANIMAS HIGH SCHOOL,9TH,2,0,1,10,60,73,13,18%
8001,CHARTER SCHOOL INSTITUTE,0075,ANIMAS HIGH SCHOOL,SCHOOL TOTAL,2,0,1,10,60,73,13,18%
8001,CHARTER SCHOOL INSTITUTE,0653,STONE CREEK SCHOOL,HALF DAY K,0,0,0,0,1,1,0,0%
8001,CHARTER SCHOOL INSTITUTE,0653,STONE CREEK SCHOOL,KINDERGARTEN,0,0,0,6,28,34,6,18%
8001,CHARTER SCHOOL INSTITUTE,0653,STONE CREEK SCHOOL,1ST,0,2,0,2,18,22,4,18%
8001,CHARTER SCHOOL INSTITUTE,0653,STONE CREEK SCHOOL,2ND,0,0,0,1,22,23,1,4%
8001,CHARTER SCHOOL INSTITUTE,0653,STONE CREEK SCHOOL,3RD,0,1,0,2,30,33,3,9%
8001,CHARTER SCHOOL INSTITUTE,0653,STONE CREEK SCHOOL,4TH,0,1,0,4,13,18,5,28%
8001,CHARTER SCHOOL INSTITUTE,0653,STONE CREEK SCHOOL,5TH,0,0,0,4,19,23,4,17%
8001,CHARTER SCHOOL INSTITUTE,0653,STONE CREEK SCHOOL,6TH,0,0,0,1,18,19,1,5%
8001,CHARTER SCHOOL INSTITUTE,0653,STONE CREEK SCHOOL,7TH,0,0,0,2,12,14,2,14%
8001,CHARTER SCHOOL INSTITUTE,0653,STONE CREEK SCHOOL,8TH,0,1,0,5,10,16,6,38%
8001,CHARTER SCHOOL INSTITUTE,0653,STONE CREEK SCHOOL,SCHOOL TOTAL,0,5,0,27,171,203,32,16%
8001,CHARTER SCHOOL INSTITUTE,0654,THE PINNACLE CHARTER SCHOOL ELEMENTARY,HALF DAY K,2,5,0,55,22,84,62,74%
8001,CHARTER SCHOOL INSTITUTE,0654,THE PINNACLE CHARTER SCHOOL ELEMENTARY,KINDERGARTEN,2,4,1,24,35,66,31,47%
8001,CHARTER SCHOOL INSTITUTE,0654,THE PINNACLE CHARTER SCHOOL ELEMENTARY,1ST,6,9,3,88,59,165,106,64%
8001,CHARTER SCHOOL INSTITUTE,0654,THE PINNACLE CHARTER SCHOOL ELEMENTARY,2ND,1,10,5,72,61,149,88,59%
8001,CHARTER SCHOOL INSTITUTE,0654,THE PINNACLE CHARTER SCHOOL ELEMENTARY,3RD,2,7,9,83,60,161,101,63%
8001,CHARTER SCHOOL INSTITUTE,0654,THE PINNACLE CHARTER SCHOOL ELEMENTARY,4TH,1,12,3,83,67,166,99,60%
8001,CHARTER SCHOOL INSTITUTE,0654,THE PINNACLE CHARTER SCHOOL ELEMENTARY,5TH,1,11,2,86,68,168,100,60%
8001,CHARTER SCHOOL INSTITUTE,0654,THE PINNACLE CHARTER SCHOOL ELEMENTARY,SCHOOL TOTAL,15,58,23,491,372,959,587,61%
8001,CHARTER SCHOOL INSTITUTE,0655,HIGH POINT ACADEMY,PK,0,2,37,15,24,78,54,69%
8001,CHARTER SCHOOL INSTITUTE,0655,HIGH POINT ACADEMY,HALF DAY K,0,0,2,2,11,15,4,27%
8001,CHARTER SCHOOL INSTITUTE,0655,HIGH POINT ACADEMY,KINDERGARTEN,2,4,10,13,9,38,29,76%
8001,CHARTER SCHOOL INSTITUTE,0655,HIGH POINT ACADEMY,1ST,0,3,15,11,21,50,29,58%
8001,CHARTER SCHOOL INSTITUTE,0655,HIGH POINT ACADEMY,2ND,0,0,14,16,19,49,30,61%
8001,CHARTER SCHOOL INSTITUTE,0655,HIGH POINT ACADEMY,3RD,0,3,14,18,17,52,35,67%
8001,CHARTER SCHOOL INSTITUTE,0655,HIGH POINT ACADEMY,4TH,0,4,23,14,15,56,41,73%
8001,CHARTER SCHOOL INSTITUTE,0655,HIGH POINT ACADEMY,5TH,0,2,9,7,7,25,18,72%
8001,CHARTER SCHOOL INSTITUTE,0655,HIGH POINT ACADEMY,6TH,2,3,10,14,16,45,29,64%
8001,CHARTER SCHOOL INSTITUTE,0655,HIGH POINT ACADEMY,7TH,1,0,10,9,6,26,20,77%
8001,CHARTER SCHOOL INSTITUTE,0655,HIGH POINT ACADEMY,8TH,0,5,8,5,6,24,18,75%
8001,CHARTER SCHOOL INSTITUTE,0655,HIGH POINT ACADEMY,SCHOOL TOTAL,5,26,152,124,151,458,307,67%
8001,CHARTER SCHOOL INSTITUTE,0656,COLORADO DISTANCE & ELECTRONIC LEARNING ACADEMY,KINDERGARTEN,0,0,1,2,14,17,3,18%
8001,CHARTER SCHOOL INSTITUTE,0656,COLORADO DISTANCE & ELECTRONIC LEARNING ACADEMY,1ST,0,0,0,3,9,12,3,25%
8001,CHARTER SCHOOL INSTITUTE,0656,COLORADO DISTANCE & ELECTRONIC LEARNING ACADEMY,2ND,0,0,3,5,15,23,8,35%
8001,CHARTER SCHOOL INSTITUTE,0656,COLORADO DISTANCE & ELECTRONIC LEARNING ACADEMY,3RD,1,1,2,3,12,19,7,37%
8001,CHARTER SCHOOL INSTITUTE,0656,COLORADO DISTANCE & ELECTRONIC LEARNING ACADEMY,4TH,0,0,0,6,18,24,6,25%
8001,CHARTER SCHOOL INSTITUTE,0656,COLORADO DISTANCE & ELECTRONIC LEARNING ACADEMY,5TH,0,1,1,2,22,26,4,15%
8001,CHARTER SCHOOL INSTITUTE,0656,COLORADO DISTANCE & ELECTRONIC LEARNING ACADEMY,6TH,1,0,4,1,19,25,6,24%
8001,CHARTER SCHOOL INSTITUTE,0656,COLORADO DISTANCE & ELECTRONIC LEARNING ACADEMY,7TH,1,1,3,5,27,37,10,27%
8001,CHARTER SCHOOL INSTITUTE,0656,COLORADO DISTANCE & ELECTRONIC LEARNING ACADEMY,8TH,0,1,1,12,35,49,14,29%
8001,CHARTER SCHOOL INSTITUTE,0656,COLORADO DISTANCE & ELECTRONIC LEARNING ACADEMY,9TH,6,0,1,30,68,105,37,35%
8001,CHARTER SCHOOL INSTITUTE,0656,COLORADO DISTANCE & ELECTRONIC LEARNING ACADEMY,10TH,0,1,3,10,31,45,14,31%
8001,CHARTER SCHOOL INSTITUTE,0656,COLORADO DISTANCE & ELECTRONIC LEARNING ACADEMY,11TH,0,2,2,7,28,39,11,28%
8001,CHARTER SCHOOL INSTITUTE,0656,COLORADO DISTANCE & ELECTRONIC LEARNING ACADEMY,12TH,0,0,1,7,22,30,8,27%
8001,CHARTER SCHOOL INSTITUTE,0656,COLORADO DISTANCE & ELECTRONIC LEARNING ACADEMY,SCHOOL TOTAL,9,7,22,93,320,451,131,29%
8001,CHARTER SCHOOL INSTITUTE,0657,T.R. PAUL ACADEMY OF ARTS & KNOWLEDGE,KINDERGARTEN,3,8,3,10,67,91,24,26%
8001,CHARTER SCHOOL INSTITUTE,0657,T.R. PAUL ACADEMY OF ARTS & KNOWLEDGE,1ST,0,9,3,3,53,68,15,22%
8001,CHARTER SCHOOL INSTITUTE,0657,T.R. PAUL ACADEMY OF ARTS & KNOWLEDGE,2ND,1,6,3,6,46,62,16,26%
8001,CHARTER SCHOOL INSTITUTE,0657,T.R. PAUL ACADEMY OF ARTS & KNOWLEDGE,3RD,1,7,3,12,48,71,23,32%
8001,CHARTER SCHOOL INSTITUTE,0657,T.R. PAUL ACADEMY OF ARTS & KNOWLEDGE,4TH,0,3,1,7,33,44,11,25%
8001,CHARTER SCHOOL INSTITUTE,0657,T.R. PAUL ACADEMY OF ARTS & KNOWLEDGE,5TH,0,0,0,1,24,25,1,4%
8001,CHARTER SCHOOL INSTITUTE,0657,T.R. PAUL ACADEMY OF ARTS & KNOWLEDGE,6TH,0,0,1,1,6,8,2,25%
8001,CHARTER SCHOOL INSTITUTE,0657,T.R. PAUL ACADEMY OF ARTS & KNOWLEDGE,7TH,0,0,0,2,5,7,2,29%
8001,CHARTER SCHOOL INSTITUTE,0657,T.R. PAUL ACADEMY OF ARTS & KNOWLEDGE,8TH,0,0,1,2,5,8,3,38%
8001,CHARTER SCHOOL INSTITUTE,0657,T.R. PAUL ACADEMY OF ARTS & KNOWLEDGE,SCHOOL TOTAL,5,33,15,44,287,384,97,25%
8001,CHARTER SCHOOL INSTITUTE,1279,CAPROCK ACADEMY,HALF DAY K,0,1,1,0,35,37,2,5%
8001,CHARTER SCHOOL INSTITUTE,1279,CAPROCK ACADEMY,KINDERGARTEN,0,0,1,1,16,18,2,11%
8001,CHARTER SCHOOL INSTITUTE,1279,CAPROCK ACADEMY,1ST,0,1,2,5,46,54,8,15%
8001,CHARTER SCHOOL INSTITUTE,1279,CAPROCK ACADEMY,2ND,0,1,1,1,52,55,3,5%
8001,CHARTER SCHOOL INSTITUTE,1279,CAPROCK ACADEMY,3RD,0,0,3,8,36,47,11,23%
8001,CHARTER SCHOOL INSTITUTE,1279,CAPROCK ACADEMY,4TH,0,1,1,3,49,54,5,9%
8001,CHARTER SCHOOL INSTITUTE,1279,CAPROCK ACADEMY,5TH,1,1,0,2,38,42,4,10%
8001,CHARTER SCHOOL INSTITUTE,1279,CAPROCK ACADEMY,6TH,0,0,0,0,26,26,0,0%
8001,CHARTER SCHOOL INSTITUTE,1279,CAPROCK ACADEMY,7TH,0,0,0,0,17,17,0,0%
8001,CHARTER SCHOOL INSTITUTE,1279,CAPROCK ACADEMY,8TH,0,0,0,0,27,27,0,0%
8001,CHARTER SCHOOL INSTITUTE,1279,CAPROCK ACADEMY,9TH,0,0,0,3,12,15,3,20%
8001,CHARTER SCHOOL INSTITUTE,1279,CAPROCK ACADEMY,SCHOOL TOTAL,1,5,9,23,354,392,38,10%
8001,CHARTER SCHOOL INSTITUTE,1376,CESAR CHAVEZ ACADEMY - NORTH,KINDERGARTEN,0,1,1,13,8,23,15,65%
8001,CHARTER SCHOOL INSTITUTE,1376,CESAR CHAVEZ ACADEMY - NORTH,1ST,0,0,3,27,8,38,30,79%
8001,CHARTER SCHOOL INSTITUTE,1376,CESAR CHAVEZ ACADEMY - NORTH,2ND,0,1,2,18,7,28,21,75%
8001,CHARTER SCHOOL INSTITUTE,1376,CESAR CHAVEZ ACADEMY - NORTH,3RD,0,0,2,20,5,27,22,81%
8001,CHARTER SCHOOL INSTITUTE,1376,CESAR CHAVEZ ACADEMY - NORTH,4TH,0,1,3,23,12,39,27,69%
8001,CHARTER SCHOOL INSTITUTE,1376,CESAR CHAVEZ ACADEMY - NORTH,5TH,0,0,3,11,6,20,14,70%
8001,CHARTER SCHOOL INSTITUTE,1376,CESAR CHAVEZ ACADEMY - NORTH,6TH,0,0,5,20,6,31,25,81%
8001,CHARTER SCHOOL INSTITUTE,1376,CESAR CHAVEZ ACADEMY - NORTH,7TH,0,0,2,9,1,12,11,92%
8001,CHARTER SCHOOL INSTITUTE,1376,CESAR CHAVEZ ACADEMY - NORTH,8TH,0,0,2,5,1,8,7,88%
8001,CHARTER SCHOOL INSTITUTE,1376,CESAR CHAVEZ ACADEMY - NORTH,SCHOOL TOTAL,0,3,23,146,54,226,172,76%
8001,CHARTER SCHOOL INSTITUTE,1791,COLORADO SPRINGS CHARTER ACADEMY,HALF DAY K,0,0,1,3,20,24,4,17%
8001,CHARTER SCHOOL INSTITUTE,1791,COLORADO SPRINGS CHARTER ACADEMY,KINDERGARTEN,1,1,0,1,18,21,3,14%
8001,CHARTER SCHOOL INSTITUTE,1791,COLORADO SPRINGS CHARTER ACADEMY,1ST,0,0,1,6,41,48,7,15%
8001,CHARTER SCHOOL INSTITUTE,1791,COLORADO SPRINGS CHARTER ACADEMY,2ND,1,0,4,7,34,46,12,26%
8001,CHARTER SCHOOL INSTITUTE,1791,COLORADO SPRINGS CHARTER ACADEMY,3RD,0,1,3,10,36,50,14,28%
8001,CHARTER SCHOOL INSTITUTE,1791,COLORADO SPRINGS CHARTER ACADEMY,4TH,0,2,0,5,39,46,7,15%
8001,CHARTER SCHOOL INSTITUTE,1791,COLORADO SPRINGS CHARTER ACADEMY,5TH,1,0,1,4,39,45,6,13%
8001,CHARTER SCHOOL INSTITUTE,1791,COLORADO SPRINGS CHARTER ACADEMY,6TH,0,0,3,6,20,29,9,31%
8001,CHARTER SCHOOL INSTITUTE,1791,COLORADO SPRINGS CHARTER ACADEMY,7TH,0,1,2,6,26,35,9,26%
8001,CHARTER SCHOOL INSTITUTE,1791,COLORADO SPRINGS CHARTER ACADEMY,8TH,0,0,2,4,12,18,6,33%
8001,CHARTER SCHOOL INSTITUTE,1791,COLORADO SPRINGS CHARTER ACADEMY,SCHOOL TOTAL,3,5,17,52,285,362,77,21%
8001,CHARTER SCHOOL INSTITUTE,1795,COLORADO SPRINGS EARLY COLLEGES,9TH,1,5,10,15,56,87,31,36%
8001,CHARTER SCHOOL INSTITUTE,1795,COLORADO SPRINGS EARLY COLLEGES,10TH,0,4,17,15,61,97,36,37%
8001,CHARTER SCHOOL INSTITUTE,1795,COLORADO SPRINGS EARLY COLLEGES,11TH,0,3,21,20,91,135,44,33%
8001,CHARTER SCHOOL INSTITUTE,1795,COLORADO SPRINGS EARLY COLLEGES,12TH,1,3,10,12,127,153,26,17%
8001,CHARTER SCHOOL INSTITUTE,1795,COLORADO SPRINGS EARLY COLLEGES,SCHOOL TOTAL,2,15,58,62,335,472,137,29%
8001,CHARTER SCHOOL INSTITUTE,2837,EARLY COLLEGE HIGH SCHOOL AT ARVADA,9TH,2,1,2,11,17,33,16,48%
8001,CHARTER SCHOOL INSTITUTE,2837,EARLY COLLEGE HIGH SCHOOL AT ARVADA,10TH,1,0,2,14,30,47,17,36%
8001,CHARTER SCHOOL INSTITUTE,2837,EARLY COLLEGE HIGH SCHOOL AT ARVADA,11TH,0,0,0,3,18,21,3,14%
8001,CHARTER SCHOOL INSTITUTE,2837,EARLY COLLEGE HIGH SCHOOL AT ARVADA,SCHOOL TOTAL,3,1,4,28,65,101,36,36%
8001,CHARTER SCHOOL INSTITUTE,3387,GOAL GED PREP,10TH,0,0,0,1,0,1,1,100%
8001,CHARTER SCHOOL INSTITUTE,3387,GOAL GED PREP,11TH,0,0,1,0,0,1,1,100%
8001,CHARTER SCHOOL INSTITUTE,3387,GOAL GED PREP,12TH,1,0,1,3,0,5,5,100%
8001,CHARTER SCHOOL INSTITUTE,3387,GOAL GED PREP,SCHOOL TOTAL,1,0,2,4,0,7,7,100%
8001,CHARTER SCHOOL INSTITUTE,3475,GOAL ACADEMY,9TH,0,1,1,22,23,47,24,51%
8001,CHARTER SCHOOL INSTITUTE,3475,GOAL ACADEMY,10TH,2,0,4,53,38,97,59,61%
8001,CHARTER SCHOOL INSTITUTE,3475,GOAL ACADEMY,11TH,1,0,9,100,49,159,110,69%
8001,CHARTER SCHOOL INSTITUTE,3475,GOAL ACADEMY,12TH,3,0,20,148,123,294,171,58%
8001,CHARTER SCHOOL INSTITUTE,3475,GOAL ACADEMY,SCHOOL TOTAL,6,1,34,323,233,597,364,61%
8001,CHARTER SCHOOL INSTITUTE,6913,THE PINNACLE CHARTER SCHOOL MIDDLE,6TH,2,12,5,104,50,173,123,71%
8001,CHARTER SCHOOL INSTITUTE,6913,THE PINNACLE CHARTER SCHOOL MIDDLE,7TH,1,10,9,90,63,173,110,64%
8001,CHARTER SCHOOL INSTITUTE,6913,THE PINNACLE CHARTER SCHOOL MIDDLE,8TH,0,12,6,97,57,172,115,67%
8001,CHARTER SCHOOL INSTITUTE,6913,THE PINNACLE CHARTER SCHOOL MIDDLE,SCHOOL TOTAL,3,34,20,291,170,518,348,67%
8001,CHARTER SCHOOL INSTITUTE,6914,THE PINNACLE CHARTER SCHOOL HIGH,9TH,1,8,3,58,28,98,70,71%
8001,CHARTER SCHOOL INSTITUTE,6914,THE PINNACLE CHARTER SCHOOL HIGH,10TH,0,5,3,43,42,93,51,55%
8001,CHARTER SCHOOL INSTITUTE,6914,THE PINNACLE CHARTER SCHOOL HIGH,11TH,0,2,2,41,28,73,45,62%
8001,CHARTER SCHOOL INSTITUTE,6914,THE PINNACLE CHARTER SCHOOL HIGH,12TH,1,2,2,42,23,70,47,67%
8001,CHARTER SCHOOL INSTITUTE,6914,THE PINNACLE CHARTER SCHOOL HIGH,SCHOOL TOTAL,2,17,10,184,121,334,213,64%
8001,CHARTER SCHOOL INSTITUTE,7278,RICARDO FLORES MAGON ACADEMY,KINDERGARTEN,0,2,2,66,2,72,70,97%
8001,CHARTER SCHOOL INSTITUTE,7278,RICARDO FLORES MAGON ACADEMY,1ST,0,2,2,44,3,51,48,94%
8001,CHARTER SCHOOL INSTITUTE,7278,RICARDO FLORES MAGON ACADEMY,2ND,0,1,0,35,0,36,36,100%
8001,CHARTER SCHOOL INSTITUTE,7278,RICARDO FLORES MAGON ACADEMY,3RD,0,0,0,22,0,22,22,100%
8001,CHARTER SCHOOL INSTITUTE,7278,RICARDO FLORES MAGON ACADEMY,4TH,0,1,1,20,0,22,22,100%
8001,CHARTER SCHOOL INSTITUTE,7278,RICARDO FLORES MAGON ACADEMY,SCHOOL TOTAL,0,6,5,187,5,203,198,98%
8001,CHARTER SCHOOL INSTITUTE,7512,ROSS MONTESSORI SCHOOL,KINDERGARTEN,0,1,0,15,19,35,16,46%
8001,CHARTER SCHOOL INSTITUTE,7512,ROSS MONTESSORI SCHOOL,1ST,0,0,0,8,27,35,8,23%
8001,CHARTER SCHOOL INSTITUTE,7512,ROSS MONTESSORI SCHOOL,2ND,1,1,0,2,24,28,4,14%
8001,CHARTER SCHOOL INSTITUTE,7512,ROSS MONTESSORI SCHOOL,3RD,0,0,0,4,28,32,4,13%
8001,CHARTER SCHOOL INSTITUTE,7512,ROSS MONTESSORI SCHOOL,4TH,0,1,0,5,19,25,6,24%
8001,CHARTER SCHOOL INSTITUTE,7512,ROSS MONTESSORI SCHOOL,5TH,1,1,1,4,10,17,7,41%
8001,CHARTER SCHOOL INSTITUTE,7512,ROSS MONTESSORI SCHOOL,6TH,0,0,0,2,10,12,2,17%
8001,CHARTER SCHOOL INSTITUTE,7512,ROSS MONTESSORI SCHOOL,7TH,2,0,0,3,4,9,5,56%
8001,CHARTER SCHOOL INSTITUTE,7512,ROSS MONTESSORI SCHOOL,8TH,1,0,0,1,1,3,2,67%
8001,CHARTER SCHOOL INSTITUTE,7512,ROSS MONTESSORI SCHOOL,SCHOOL TOTAL,5,4,1,44,142,196,54,28%
8001,CHARTER SCHOOL INSTITUTE,8825,THOMAS MACLAREN STATE CHARTER SCHOOL,6TH,0,0,1,4,16,21,5,24%
8001,CHARTER SCHOOL INSTITUTE,8825,THOMAS MACLAREN STATE CHARTER SCHOOL,7TH,0,0,2,1,14,17,3,18%
8001,CHARTER SCHOOL INSTITUTE,8825,THOMAS MACLAREN STATE CHARTER SCHOOL,8TH,0,1,2,3,13,19,6,32%
8001,CHARTER SCHOOL INSTITUTE,8825,THOMAS MACLAREN STATE CHARTER SCHOOL,9TH,2,1,2,4,11,20,9,45%
8001,CHARTER SCHOOL INSTITUTE,8825,THOMAS MACLAREN STATE CHARTER SCHOOL,SCHOOL TOTAL,2,2,7,12,54,77,23,30%
8001,CHARTER SCHOOL INSTITUTE,8929,PIKES PEAK PREP,HALF DAY K,0,0,0,0,1,1,0,0%
8001,CHARTER SCHOOL INSTITUTE,8929,PIKES PEAK PREP,KINDERGARTEN,0,1,10,8,8,27,19,70%
8001,CHARTER SCHOOL INSTITUTE,8929,PIKES PEAK PREP,1ST,0,0,10,4,11,25,14,56%
8001,CHARTER SCHOOL INSTITUTE,8929,PIKES PEAK PREP,2ND,1,2,3,5,12,23,11,48%
8001,CHARTER SCHOOL INSTITUTE,8929,PIKES PEAK PREP,3RD,1,1,8,5,13,28,15,54%
8001,CHARTER SCHOOL INSTITUTE,8929,PIKES PEAK PREP,4TH,0,0,6,6,15,27,12,44%
8001,CHARTER SCHOOL INSTITUTE,8929,PIKES PEAK PREP,5TH,1,2,9,6,5,23,18,78%
8001,CHARTER SCHOOL INSTITUTE,8929,PIKES PEAK PREP,6TH,1,2,9,6,14,32,18,56%
8001,CHARTER SCHOOL INSTITUTE,8929,PIKES PEAK PREP,7TH,3,3,9,3,9,27,18,67%
8001,CHARTER SCHOOL INSTITUTE,8929,PIKES PEAK PREP,8TH,0,1,7,4,14,26,12,46%
8001,CHARTER SCHOOL INSTITUTE,8929,PIKES PEAK PREP,9TH,0,0,4,5,11,20,9,45%
8001,CHARTER SCHOOL INSTITUTE,8929,PIKES PEAK PREP,10TH,0,0,6,3,3,12,9,75%
8001,CHARTER SCHOOL INSTITUTE,8929,PIKES PEAK PREP,11TH,0,0,1,0,6,7,1,14%
8001,CHARTER SCHOOL INSTITUTE,8929,PIKES PEAK PREP,12TH,0,0,2,1,5,8,3,38%
8001,CHARTER SCHOOL INSTITUTE,8929,PIKES PEAK PREP,SCHOOL TOTAL,7,12,84,56,127,286,159,56%
8001,CHARTER SCHOOL INSTITUTE,9051,THE VANGUARD SCHOOL (MIDDLE),7TH,0,6,7,9,53,75,22,29%
8001,CHARTER SCHOOL INSTITUTE,9051,THE VANGUARD SCHOOL (MIDDLE),8TH,2,5,7,8,42,64,22,34%
8001,CHARTER SCHOOL INSTITUTE,9051,THE VANGUARD SCHOOL (MIDDLE),SCHOOL TOTAL,2,11,14,17,95,139,44,32%
8001,CHARTER SCHOOL INSTITUTE,9057,THE VANGUARD SCHOOL (HIGH),9TH,0,3,1,7,42,53,11,21%
8001,CHARTER SCHOOL INSTITUTE,9057,THE VANGUARD SCHOOL (HIGH),10TH,1,2,3,7,26,39,13,33%
8001,CHARTER SCHOOL INSTITUTE,9057,THE VANGUARD SCHOOL (HIGH),11TH,0,2,0,1,19,22,3,14%
8001,CHARTER SCHOOL INSTITUTE,9057,THE VANGUARD SCHOOL (HIGH),12TH,2,2,1,4,20,29,9,31%
8001,CHARTER SCHOOL INSTITUTE,9057,THE VANGUARD SCHOOL (HIGH),SCHOOL TOTAL,3,9,5,19,107,143,36,25%
8001,CHARTER SCHOOL INSTITUTE,,DISTRICT TOTAL,,76,254,506,2237,3508,6581,3073,47%
9030,MOUNTAIN BOCES,6134,YAMPAH MOUNTAIN SCHOOL,9TH,0,0,0,2,1,3,2,67%
9030,MOUNTAIN BOCES,6134,YAMPAH MOUNTAIN SCHOOL,10TH,0,0,0,7,27,34,7,21%
9030,MOUNTAIN BOCES,6134,YAMPAH MOUNTAIN SCHOOL,11TH,0,0,0,12,14,26,12,46%
9030,MOUNTAIN BOCES,6134,YAMPAH MOUNTAIN SCHOOL,12TH,0,0,0,11,17,28,11,39%
9030,MOUNTAIN BOCES,6134,YAMPAH MOUNTAIN SCHOOL,SCHOOL TOTAL,0,0,0,32,59,91,32,35%
9030,MOUNTAIN BOCES,6136,MOUNTAIN BOCES DAY TREATMENT CENTER,5TH,0,0,0,0,1,1,0,0%
9030,MOUNTAIN BOCES,6136,MOUNTAIN BOCES DAY TREATMENT CENTER,6TH,0,0,0,0,3,3,0,0%
9030,MOUNTAIN BOCES,6136,MOUNTAIN BOCES DAY TREATMENT CENTER,7TH,0,0,0,2,3,5,2,40%
9030,MOUNTAIN BOCES,6136,MOUNTAIN BOCES DAY TREATMENT CENTER,8TH,0,0,0,1,4,5,1,20%
9030,MOUNTAIN BOCES,6136,MOUNTAIN BOCES DAY TREATMENT CENTER,9TH,0,0,0,0,1,1,0,0%
9030,MOUNTAIN BOCES,6136,MOUNTAIN BOCES DAY TREATMENT CENTER,10TH,0,0,0,2,4,6,2,33%
9030,MOUNTAIN BOCES,6136,MOUNTAIN BOCES DAY TREATMENT CENTER,11TH,0,0,0,1,3,4,1,25%
9030,MOUNTAIN BOCES,6136,MOUNTAIN BOCES DAY TREATMENT CENTER,12TH,0,0,0,1,0,1,1,100%
9030,MOUNTAIN BOCES,6136,MOUNTAIN BOCES DAY TREATMENT CENTER,SCHOOL TOTAL,0,0,0,7,19,26,7,27%
9030,MOUNTAIN BOCES,8389,SUMMIT COUNTY DOR PROGRAM,12TH,0,0,0,13,12,25,13,52%
9030,MOUNTAIN BOCES,8389,SUMMIT COUNTY DOR PROGRAM,SCHOOL TOTAL,0,0,0,13,12,25,13,52%
9030,MOUNTAIN BOCES,9797,YAMPAH TEEN PARENT PROGRAM,9TH,0,0,0,3,0,3,3,100%
9030,MOUNTAIN BOCES,9797,YAMPAH TEEN PARENT PROGRAM,10TH,0,0,0,3,0,3,3,100%
9030,MOUNTAIN BOCES,9797,YAMPAH TEEN PARENT PROGRAM,11TH,0,0,0,4,1,5,4,80%
9030,MOUNTAIN BOCES,9797,YAMPAH TEEN PARENT PROGRAM,12TH,0,0,0,13,2,15,13,87%
9030,MOUNTAIN BOCES,9797,YAMPAH TEEN PARENT PROGRAM,SCHOOL TOTAL,0,0,0,23,3,26,23,88%
9030,MOUNTAIN BOCES,,BOCES TOTAL,,0,0,0,75,93,168,75,45%
9095,NORTHWEST COLO BOCES,9787,YAMPA VALLEY HIGH SCHOOL,9TH,0,0,0,0,1,1,0,0%
9095,NORTHWEST COLO BOCES,9787,YAMPA VALLEY HIGH SCHOOL,10TH,0,0,1,0,8,9,1,11%
9095,NORTHWEST COLO BOCES,9787,YAMPA VALLEY HIGH SCHOOL,11TH,0,0,0,0,7,7,0,0%
9095,NORTHWEST COLO BOCES,9787,YAMPA VALLEY HIGH SCHOOL,12TH,0,0,0,0,9,9,0,0%
9095,NORTHWEST COLO BOCES,9787,YAMPA VALLEY HIGH SCHOOL,SCHOOL TOTAL,0,0,1,0,25,26,1,4%
9095,NORTHWEST COLO BOCES,,BOCES TOTAL,,0,0,1,0,25,26,1,4%
9130,EXPEDITIONARY BOCES,2840,EXPEDITIONARY LEARNING SCHOOL,KINDERGARTEN,0,3,2,1,18,24,6,25%
9130,EXPEDITIONARY BOCES,2840,EXPEDITIONARY LEARNING SCHOOL,1ST,0,0,1,3,20,24,4,17%
9130,EXPEDITIONARY BOCES,2840,EXPEDITIONARY LEARNING SCHOOL,2ND,1,2,1,1,19,24,5,21%
9130,EXPEDITIONARY BOCES,2840,EXPEDITIONARY LEARNING SCHOOL,3RD,0,2,0,1,21,24,3,13%
9130,EXPEDITIONARY BOCES,2840,EXPEDITIONARY LEARNING SCHOOL,4TH,0,2,3,5,15,25,10,40%
9130,EXPEDITIONARY BOCES,2840,EXPEDITIONARY LEARNING SCHOOL,5TH,0,0,1,0,22,23,1,4%
9130,EXPEDITIONARY BOCES,2840,EXPEDITIONARY LEARNING SCHOOL,6TH,1,1,3,1,25,31,6,19%
9130,EXPEDITIONARY BOCES,2840,EXPEDITIONARY LEARNING SCHOOL,7TH,0,5,1,2,23,31,8,26%
9130,EXPEDITIONARY BOCES,2840,EXPEDITIONARY LEARNING SCHOOL,8TH,0,3,7,2,23,35,12,34%
9130,EXPEDITIONARY BOCES,2840,EXPEDITIONARY LEARNING SCHOOL,9TH,1,2,2,1,23,29,6,21%
9130,EXPEDITIONARY BOCES,2840,EXPEDITIONARY LEARNING SCHOOL,10TH,0,1,0,4,23,28,5,18%
9130,EXPEDITIONARY BOCES,2840,EXPEDITIONARY LEARNING SCHOOL,11TH,0,0,0,3,24,27,3,11%
9130,EXPEDITIONARY BOCES,2840,EXPEDITIONARY LEARNING SCHOOL,12TH,0,1,2,3,20,26,6,23%
9130,EXPEDITIONARY BOCES,2840,EXPEDITIONARY LEARNING SCHOOL,SCHOOL TOTAL,3,22,23,27,276,351,75,21%
9130,EXPEDITIONARY BOCES,,BOCES TOTAL,,3,22,23,27,276,351,75,21%
,,,COLORADO DETENTION CENTERS,,9,1,49,81,107,247,140,57%
,,,STATE TOTAL,,9604,30820,49413,237797,504734,832368,327634,39%
